Aarau	AG
Baden	None
Bar-Rossi	ZH
Basel	BS
Bern	BE
Binningen	BL
Buchs	SG
El-Lokal	ZH
Elgg	ZH
Esse-Musicbar	ZH
Flawil	SG
Frick	AG
Grindelwald	BE
ISC-Club	BE
Klosters	GR
Kloten	ZH
Kulturfabrik-Kofmehl	SO
Lebewohlfabrik	ZH
Liebefeld	BE
Luzern	LU
Mokka	Taizz Governorate
Palais-des-Congrès	Île-de-France
Parterre-One	Overste
Pontresina	GR
Reussbühl	LU
Seuzach	ZH
Solothurn	SO
Theater-am-Gleis	ZH
Wengen	BE
Winterthur	ZH
X-tra	ZH
Zug	ZG
Zürich	ZH
null	None
