Aarau	Aarau
Baden	None
Bar-Rossi	Zürich
Basel	Basel
Bern	Bern
Binningen	Binningen
Buchs	Buchs
El-Lokal	Zürich
Elgg	Elgg
Esse-Musicbar	Winterthur
Flawil	Flawil
Frick	Frick
Grindelwald	Grindelwald
ISC-Club	Bern
Klosters	Klosters-Serneus
Kloten	Kloten
Kulturfabrik-Kofmehl	Solothurn
Lebewohlfabrik	Zürich
Liebefeld	Liebefeld
Luzern	Lucerne
Mokka	Mocha
Palais-des-Congrès	Paris
Parterre-One	Almelo
Pontresina	Pontresina
Reussbühl	None
Seuzach	Seuzach
Solothurn	Solothurn
Theater-am-Gleis	Winterthur
Wengen	Lauterbrunnen
Winterthur	Winterthur
X-tra	Zürich
Zug	Zug
Zürich	Zürich
null	None
