	[]
20-21 Uhr Tanzkurs Bailar Casino	[]
5 In Love	['traditional swing']
Aaron Abernathy	[]
Aaron Diehl	[]
Aaron Wegmann	[]
Adam Taubitz	[]
Adhd	[]
Adrian Mears	[]
Afrika Mkhize	[]
After-Party mit Greem	[]
Agata Wilewska	[]
Ai Yamamura	[]
Akinobu Ono	[]
Al Comet	[]
Albert Hartkamp	[]
Alcides Toirac	[]
Alek Fester	[]
Alessandro Giannelli	[]
Alessandro d'Episcopo	[]
Alessio Pianelli	[]
Alex Hendriksen	[]
Alex Hendriksen Quartet	[]
Alex Huber	[]
Alexander Boeschoten	[]
Alexander Boldachev	[]
Alexander Neustroev	[]
Alexander Seidel	[]
Alexandra Ivanova	[]
Alexandre Beuchat	[]
Alexandre Cunha	[]
Alexey Lavrentyev	[]
Alfatec	['italian punk']
Alfred Zimmerlin	[]
Ali Salvioni	[]
Alice Phoebe Lou	[]
Amik Guerra	[]
Amélie Chemin	[]
Andi Czech	[]
Andi Pupato	[]
Andre Bader	[]
Andrea Beccaro	[]
Andrea Grimm	[]
Andrea Kollé	[]
Andrea Manzoni	[]
Andrea Manzoni Trio	[]
Andrea Nydegger	[]
Andrea Suter	[]
Andrea Wiesli	[]
Andreas Böhlen	[]
Andreas Janke	[]
Andreas Jost	[]
Andreas Liebig	[]
Andreas Schaerer	[]
Andreas Tschopp	[]
Andrei Ionita	[]
André Siqueira	[]
Andy Scherrer	[]
Angélique Kidjo	['world', 'world christmas']
Ann Malcolm	[]
Anna Trauffer	[]
Annette Kappeler	[]
Annette Labusch	[]
Annika Francke	[]
Anton Sword & The We Ours	[]
Antonello Messina	[]
Arabrot	['norwegian metal', 'norwegian rock']
Arend Grosfeld	[]
Ariane Haering	[]
Ariel Rossi	[]
Arkady Shilkloper	[]
Arnaud Surrel	[]
Arnulf Ballhorn	[]
Arturo Arglos	[]
Arturo Stable	['deep latin jazz']
Asa Konishi Jankowska	[]
Asaf Avidan	['israeli rock']
Asher Selector	[]
Asian Dub Foundation Soundsystem	[]
Astrid Fuellemann	[]
Attic	['electronicore', 'post-post-hardcore', 'post-screamo']
Attila Fekete	[]
Audio 88 & Yassin	[]
Aurora Nealand	[]
Aurore Baal	[]
Avi Wogderess Vasa	[]
Axel Wolf	[]
Ayanda Sikade	[]
Bacchus	[]
Backtrack	['alternative emo', 'chaotic hardcore', 'hardcore', 'melodic hardcore', 'straight edge']
Band of Horses	['chamber pop', 'folk-pop', 'indie folk', 'indie pop', 'indie rock', 'indietronica', 'neo mellow', 'stomp and holler']
Bane	['chaotic hardcore', 'christian hardcore', 'emo', 'hardcore', 'mathcore', 'melodic hardcore', 'metalcore', 'straight edge']
Barbez	['dark cabaret', 'laboratorio', 'steampunk']
Barcella	['french folk pop', 'french rock']
Beat Schneider	[]
Beatrice Voellmy	[]
Beatriz Blanco	[]
Belisa Mang	[]
Bellhound Choir	[]
Ben Zahler	[]
Benedikt Reising	[]
Benedikt Wieland	[]
Benjamin Brodbeck	[]
Benjamin Schmid	['violin']
Benni Kammerer	[]
Benno Kaiser	[]
Benny Omerszell	[]
Bernd Reiter	[]
Bernhard Affolter	[]
Bernhard Egger	[]
Bernhard Hörler	[]
Bernhoft	['norwegian indie', 'norwegian pop', 'norwegian rock']
Berthold Seliger	[]
Beto Sápio	[]
Billy Martin	[]
Black Milk & The Nat Turner	[]
Blackout Problems	[]
Bo Wiget	[]
Boglárka Pecze	[]
Bolschoi Don Kosakenchor	[]
Boulevard Des Airs	['french pop', 'french reggae', 'french rock']
Brainstorm	['p funk']
Breakdown Of Sanity	['death core', 'melodic metalcore', 'metalcore', 'post-screamo', 'rap metal', 'screamo']
Brumes d'automne	[]
Bruno Jundt	[]
Bänz Oester	[]
Bê Betina Ignacio	[]
Bê Ignacio	[]
C.A.R	['alternative rock', 'chamber pop', 'freak folk', 'indie folk', 'indie pop', 'indie rock', 'lo-fi', 'neo-psychedelic', 'noise pop', 'preverb', 'stomp and holler']
Candy Dulfer	['jazz christmas', 'smooth jazz']
Carbon Airways	[]
Carlo Niederhauser	[]
Carolin Widmann	['violin']
Cato Nordby	[]
Cecile Mc Lorin Salvant Quintet	[]
Chamito	[]
Charlotte Quadt	[]
Chelsey Schill	[]
Chrigu Müller	[]
Chris Ayer	[]
Chris Jaeger	[]
Chris Linder	[]
Chris Norz	[]
Chris Wood	[]
Christian Dilier	[]
Christian Kuntner	[]
Christian Weber	['pop house']
Christina Martin	[]
Christoph Bösch	[]
Christoph Grab	[]
Christoph Kaufmann	[]
Christoph Merki	[]
Christoph Ràcz	[]
Christoph Schepperle	[]
Christoph Stiefel	[]
Christoph Utzinger	[]
Christy Doran	[]
Chuck Prophet	['alternative country', 'alternative roots rock', 'new americana', 'outlaw country', 'pub rock', 'roots rock', 'texas country']
Church Of Misery	['doom metal', 'drone metal', 'j-metal', 'post-doom metal', 'psychedelic doom', 'retro metal', 'sludge metal', 'stoner metal', 'stoner rock']
Cinzia Catania	[]
Civil Civic	[]
Claude Meier	[]
Claudio Filippini	[]
Clemens Schepperle	[]
Cloud Rat	['power violence']
Coely	['belgian rock']
Corinne Huber	[]
Costi Topalidis	[]
Creeper	[]
Crew Peligrosos	['colombian rock']
Csongor Szanto	[]
Cunninlynguists	['abstract hip hop', 'alternative hip hop', 'hardcore hip hop', 'hip hop', 'pop rap', 'underground rap']
Cäcilia Chmel	[]
Cécile Mansuy	[]
Cécile McLorin Salvant	['vocal jazz']
Céline Pasche	[]
D-Fyne	[]
DJ Deivi	[]
DJ Super Sam	[]
DJs Burak Yeter	[]
DJs Dot	[]
DJs Gilles Peterson	[]
DJs Haitian Star	[]
DJs Lee Gamble	[]
DJs Nando	[]
Da'le	[]
Daminic Montandon	[]
Damir Imamovic	[]
Damir Imamovic Sevdah Takht	[]
Dan Wilde	[]
Daniel Bentz	[]
Daniel Disler	[]
Daniel Haefliger	[]
Daniel Meller	[]
Daniel Schenker	[]
Daniel Winshall	[]
Daniel Woodtli	[]
Daniel Zisman	[]
Daniela Müller	[]
Darkhaus	['neue deutsche harte']
Darkside	['downtempo']
Dave Harrington	[]
Dave Samuels	[]
Dave Samuels' Caribbean Jazz Project	[]
David Heizmann	[]
David Kilowsky	[]
David Meier	[]
David Murray	['avant-garde jazz', 'contemporary post-bop', 'free improvisation', 'free jazz', 'jazz']
David Murray Infinity Quartet feat. Saul Williams	[]
David Sanborn & Bob James Group feat. Steve Gadd	[]
DavidGuetta	[]
Deafkid	['vapor pop']
Dean Blunt	['escape room', 'fluxwork', 'freak folk', 'indie r&b', 'outsider house', 'vaporwave']
Deba	[]
Deez Nuts	['hardcore', 'metalcore']
Defeater	['alternative emo', 'anthem emo', 'chaotic hardcore', 'melodic hardcore', 'metalcore', 'pop punk', 'progressive post-hardcore', 'screamo']
Dejan Terzic	[]
Diadji Seydi	[]
Diego Baroni	[]
Dieter Hubov	[]
Dieter Ilg	[]
Dieter Thomas Kuhn & Band	[]
Dillon	['bass trap', 'big room', 'brostep', 'deep big room', 'edm', 'electro house', 'electronic trap', 'house', 'moombahton', 'tropical house']
Dimitri Ashkenazy	[]
Dirk Börner	[]
Djam Rekk Sound DJ-Kollektiv	[]
Domenic Landolf	[]
Dominic Hauser	[]
Dominic Landolt	[]
Dominik Grossenbacher	[]
Dominik Schürmann	[]
Dominique Girod	[]
Donat Fisch	[]
Doodlebug	['bass trip']
Dorotop DJ Set	[]
Dream Theater	['album rock', 'alternative metal', 'hard rock', 'metal', 'neo classical metal', 'power metal', 'progressive metal', 'progressive rock', 'rock']
Drum'n'bass	[]
Dubioza Kolektiv	['yugoslav rock']
Dylan Perron et Élixir de Gumbo	[]
Edicson Ruiz	[]
Edmauro de Oira	[]
Edmundo Carneiro	[]
Eduardo Machado	[]
Eduardo Machado Trio	[]
Edward Rushton	[]
Egyptian Hip Hop	['deep gothic post-punk']
Eiko Furusawa	[]
Einar Stray Orchestra	['norwegian indie', 'norwegian pop']
Elena González	[]
Elias Bernet	[]
Elisabeth Göring	[]
Elisabeth Waldmeier	[]
Elmar Frey	[]
Elyas Khan	[]
Emanuel Heitz	[]
Emanuel Küenzi	[]
Emanuel Künzi	[]
Emanuel Rütsche	[]
Emanuel Schmelzer	[]
Emanuele Jannibelli	[]
Endo Anaconda	[]
Eric Alexander	['contemporary post-bop', 'hard bop']
Erich Bieri	[]
Erich Fischer	[]
Erich Möschler	[]
Eriko Wakita	[]
Ernst Buscagne	[]
Erwin Bieri	[]
Esteban "Chamito" Reyes	[]
Esther Hoppe	[]
Esther Nydegger	[]
Eva Boesch	[]
Eveleen Olsen	[]
Ewa Grzywna-Groblewska	[]
Fabian Gisler	[]
Fabian Gubser	[]
Fabian Heynen	[]
Fabian Kristmann	[]
Fabio Di Càsola	[]
Family Atlantica	[]
Family of the Year	['folk christmas', 'folk-pop', 'indie christmas', 'indie folk', 'indie pop', 'shimmer pop', 'stomp and holler']
Feadz	['destroy techno', 'filter house']
Felix Gubser	[]
Felix Klaus	[]
Felix Kübler	[]
Felix Renggli	[]
Felix-Andreas Genner	[]
Fernando Rast	[]
Filip Micha Saffray	[]
Flavio Mezzodi	[]
Flo Dauner	[]
Flo Reichle	[]
Florian Favre	[]
Florian Hoesl	[]
Florian Krause	[]
Florian Läuchli	[]
Florian Walser	[]
Flurin Cuonz	[]
Fran Lorkovic	[]
Frances	['indie anthem-folk', 'pop']
Franziska Bruecker	[]
Franziska Brücker	[]
Françoise Matile	[]
Frauenarzt	['deep german hip hop', 'german hip hop']
Frauke Tometten Molino	[]
Fred Bürki	[]
Fridolin Blumer	[]
Frits Landesbergen	[]
Gabriel Dalvit	[]
Gabriel Walter	[]
Gabriela Friedli	[]
Ganesh Geymeier	[]
Gauthier Toux	[]
Geert Dedapper	[]
Gemelli Diversi	['italian arena pop', 'italian hip hop', 'italian pop']
Gen Wüst	[]
Gerilja	['vegan straight edge']
Get Well Soon	['german indie', 'german pop']
Gianna Nannini	['italian arena pop', 'italian pop']
Gianni Pontillo	[]
Gil Reis	[]
Gilberto Gil	['bossa nova', 'forro', 'mpb', 'pagode', 'samba', 'world christmas']
Gilles Apap	['violin']
Giora Feidman	['klezmer']
Giorgia Milanesi	[]
Giorgio Mandolesi	[]
Glenn Ferris	['jazz brass']
Gletscher Fezzer	[]
Go Go Berlin	['danish pop']
Goldfrapp	['alternative dance', 'big beat', 'dance pop', 'electroclash', 'electronic', 'indie christmas', 'indietronica', 'new rave', 'new wave pop', 'pop christmas', 'pop rock', 'synthpop', 'trip hop']
Goran Kovacevic	[]
Grave Miasma	['black death', 'voidgaze']
Great Black Waters	[]
Grégoire Maret	[]
Gérard Wyss	[]
Haemi Haemmerli	[]
Haika Lübcke	[]
Hannes Fankhauser	[]
Hannes Giger	[]
Hans Agreda	[]
Hans-Peter Pfammatter	[]
Hassan Shakur	[]
Heart In Hand	['deep melodic metalcore']
Heartical Sound	[]
Heidrun Wirth-Metzler	[]
Heinrich Mätzener	[]
Heinz Holliger	['choral', 'classical', 'classical flute', 'classical performance', 'harpsichord', 'orchestral']
Helena Rüegg	[]
Helga Varadi	[]
Helmut Kagerer	[]
Hendrix Ackle	[]
Hooverphonic	['downtempo', 'electronic', 'nu jazz', 'trip hop']
Idan Raichel	['israeli rock', 'mizrahi']
Igor Morosow	[]
Ildikó Sajgó	[]
Indias Indois	[]
Indira Koch	[]
Ingvo Clauder	[]
Inka Kuchler	[]
Irene Klein	[]
Irene Schindele	[]
Irie Révoltés	['deep german pop rock', 'french reggae', 'german hip hop', 'reggae fusion']
Irina Georgieva	[]
Isa Kurz	[]
Isaac Duarte	[]
Isaiah Thompson	[]
Ivan Mihajlovic	[]
Jacques Widmer	[]
Jamie Lidell	['funk', 'soul']
Jan Grüter	[]
Jane Achtman	[]
Jared Silverstein	[]
Jaribu Shahid	[]
Jasmina Matijevic	[]
Jay Messerli	[]
Jeanne Roth	[]
Jedediah Allen	[]
Jenny Chi	[]
Jenny Högström	[]
Jo-El Sonnier & T. Graham Brown & Band	[]
JoachimGarraud	[]
Jochen Rueckert	[]
Joe Jackson	['album rock', 'art rock', 'classic rock', 'dance rock', 'folk', 'folk rock', 'mellow gold', 'new romantic', 'new wave', 'new wave pop', 'permanent wave', 'power pop', 'pub rock', 'rock', 'roots rock', 'singer-songwriter', 'soft rock', 'synthpop']
Joel Allison	[]
Joel Reiff	[]
Johannes Gutfleisch	[]
John Garcia	['psychedelic doom', 'retro metal', 'stoner metal', 'stoner rock']
John Medeski	[]
John Michael Bradford	[]
John Scofield	['bebop', 'blues-rock', 'contemporary jazz', 'contemporary post-bop', 'cool jazz', 'gypsy jazz', 'jazz', 'jazz blues', 'jazz christmas', 'jazz funk', 'jazz fusion', 'modern blues', 'soul jazz']
John Scofield & Medesky-Martin-Wood	[]
Jojo Kunz	[]
Jon Cowherd	[]
Jonas Brügger	[]
Jonas Gross	[]
Jonas Labhart	[]
Jonas Ruther	[]
Jonas Tschanz	[]
Jonathan Sells	[]
Jorge Leysan Demestre	[]
Jorge Rossy	[]
Jorge-Luís Gonzalez	[]
Josiane Kneuss	[]
Jugendchor Hamrahilö	[]
Julia Bauer	[]
Julia Marion	[]
Julian Sartorius	[]
Junko Takayama	[]
Justin Peake	[]
Jürg Dähler	[]
Jürg Gasser	[]
Jürg Käser	[]
Jürg Maag	[]
Jürg Ramspeck	[]
Kalle Kalima	[]
Kanna	[]
Kate Macoboy	[]
Katharina Busch	[]
Katharina Kühne	[]
Katharina Weissenbacher	[]
Kathrin Hartmann	[]
Katia Braunschweiler	[]
Katia Labèque	[]
Katja Fuchs	[]
Katryn Hasler	[]
Keith Sterling Brewer Band	[]
Kendrick Scott	['contemporary jazz']
Kenneth Dahl Knudsen	[]
Kensington	['dutch pop', 'dutch rock']
Kery James	['francoton', 'french hip hop', 'french pop', 'french reggae', 'trap francais']
King Gizzard & The Lizard Wizard	['alt-indie rock', 'australian alternative rock', 'deep australian indie', 'freak folk', 'garage rock', 'neo-psychedelic']
Klaus Dickbauer	[]
Klaus-Dieter Brandt	[]
Kornelia Bruggman	[]
Kristian Bezuidenhout	['classical performance']
Kurt Schlup	[]
Kvelertak	['black thrash', 'norwegian indie', 'norwegian metal', 'norwegian rock', 'sludge metal', 'stoner metal', 'stoner rock']
Laia Masramon	[]
Lander Gyselinck	[]
Lars Carl Schmid	[]
Lawrence Leathers	[]
Leonardo Salazar	[]
Les Soeurs Boulay	['quebecois']
Leticia Kahraman	[]
Letzte Instanz	['medieval rock', 'neue deutsche harte']
Levin Deger	[]
Lianne La Havas	['deep indie r&b', 'indie r&b', 'neo mellow', 'neo soul', 'soul']
Lilly Martin	[]
Lionel Friedli	[]
Little Lion Sound & Agent N	[]
Lizandro Paredes	[]
Lluis Ribalta	[]
Loco Escrito	[]
London Grammar	['indie r&b', 'indietronica', 'metropopolis', 'neo mellow', 'pop', 'shimmer pop', 'tropical house']
Lorenz Beyeler	[]
Lorenzo Tucci	[]
Los Banditos	['surf music']
Louis Laury	[]
Luca Curcio	[]
Luca Leombruni	[]
Lucien Dubuis	[]
Luigi Archetti	[]
Luis Cruz	[]
Luk Kipfer	[]
Luk Schulthess	[]
Lukas Fässler	[]
Lukas Mantel	[]
Lukas Schlumpf	[]
Lukas Wiese	[]
Luke Winslow King	['alternative country', 'country blues', 'deep new americana', 'michigan indie', 'modern blues', 'new americana', 'piedmont blues']
Luzius Schuler	[]
Mace Mitchell	[]
Madeleine Lienhard	[]
Magatte N'diaye	[]
Mai Lan	[]
Maja Hermann	[]
Maki Wiederkehr	[]
Manu Hagmann	[]
Manuel Blanco Gómez-Limón	[]
Manuel Delago	[]
Marc Almond	['dance rock', 'new romantic', 'new wave', 'new wave pop', 'synthpop']
Marc Kakon	[]
Marc Reinhard	[]
Marc Storace	[]
Marc Stucki	[]
Marc Unternährer	[]
Marcel Jeker	[]
Marcel Riesen	[]
Marco Andrey	[]
Marco Bartoli	[]
Maren Böll	[]
Marianne Racine-Granvik	[]
Marielle Labèque	[]
Marija Wüthrich-Savicevic	[]
Mario Biondi	['italian arena pop', 'italian jazz', 'italian pop']
Mario Hänni	[]
Mario Söldi	[]
Mario von Holten	[]
Mark Berube	[]
Mark Tenger	[]
Markus Eichenberger	[]
Markus Fürst	[]
Markus Lauterburg	[]
Markus Schmidt	[]
Markus Schmied	[]
Marlon Roudette	['german pop rock']
Martin Frutiger	[]
Martin Günthardt	[]
Martin Hässler	[]
Martin Jaggi	[]
Martin Rabensteiner	[]
Martina Anselmo	[]
Marysol Schalit	[]
Master-Abschlussrezital Florin Grüter	[]
Mathias Harter	[]
Mathieu Friz	[]
Matt Graf	[]
Matt Simons	['deep tropical house', 'neo mellow', 'singer-songwriter', 'tropical house']
Matthias Rácz	[]
Matthieu Camilleri	[]
Matthieu Michel	[]
Maurice Steger	[]
Mauro Martins	[]
Mavis Staples	['country blues', 'funk', 'jazz blues', 'memphis soul', 'modern blues', 'new orleans blues', 'roots rock', 'soul', 'soul blues', 'soul christmas', 'southern soul']
Max Asselborn	[]
Max Sonnleitner	[]
Maxence Sibille	[]
Maximilian Hecker	['folk christmas', 'melancholia']
Maya Avraham	['israeli rock', 'mizrahi']
Melissa Aldana	[]
Menwar	['sega']
Messer Chups & Zombirella	[]
Mich Gerber	['new tribe']
Micha Held	[]
Michael Baumann	[]
Michael Büttler	[]
Michael Erni	[]
Michael Gregorio	[]
Michael Reid	[]
Michael Schenker	['album rock', 'blues-rock', 'glam metal', 'hard rock', 'metal', 'nwobhm', 'rock']
Michael von Schönermark	[]
Michel Godard	[]
Michel Rouilly	[]
Michi Finger	[]
Michiko Hirayama	[]
Mihai Cocea	[]
Mija Läuchli	[]
Mike & the Mechanics	['album rock', 'dance rock', 'mellow gold', 'new romantic', 'new wave', 'new wave pop', 'soft rock']
Mikheil Sheshaberidze	[]
Mirel Wagner	['finnish pop']
Mischa Greull	[]
Misha Alperin	[]
Monte Carlo	[]
Monty Alexander	['cool jazz', 'soul jazz', 'stride']
Monty Alexander's Triple Treat	[]
Moose Jackson	['jazz blues', 'jazz christmas', 'jump blues']
Mounawar	[]
Mélanie Adami	[]
Ménilmontant	[]
N.I.K.O	[]
Nasheet Waits	[]
Nat Su	['vocaloid']
Natascha Albash	[]
Neck Deep	['alternative emo', 'anthem emo', 'emo', 'pixie', 'pop punk', 'screamo']
Necros Christos	['black death', 'black thrash', 'voidgaze']
Negura Bunget	['atmospheric black metal', 'avantgarde metal', 'black metal', 'blackgaze', 'doom metal', 'folk metal', 'neofolk', 'pagan black metal', 'post-metal', 'slavic metal', 'symphonic black metal', 'viking metal', 'voidgaze']
Nelson Freiere	[]
Nena	['dance rock', 'europop', 'german pop', 'new romantic', 'new wave', 'new wave pop']
Nenad Kovacic	[]
Nici Struchen	[]
Nico Schulthess	[]
Nicolas Altstaedt	['deep cello']
Nicolas Jaar	['alternative dance', 'downtempo', 'electronic', 'indie r&b', 'indietronica', 'microhouse', 'minimal techno', 'new rave', 'trip hop']
Nicolas Stocker	[]
Nicolas Struchen	[]
Nicole Johänntgen	[]
Niklaus Kost	[]
Nils Mönkemeyer	[]
Norbert Brasser	[]
Norbert Pfammatter	[]
Ohlê Gagneux	[]
Oli Kehrli	[]
Oli Kuster	[]
Olivier Hutman	[]
Omri Hason	[]
Or Pellet	[]
Or Pellet Santos	[]
Or Potratz	[]
Or Steidle	[]
Orchestre Miniature In The Park	[]
Orphan Fairytale	['drone psych']
Oscar Feldman	[]
Ossific	[]
Pablo Kornfeld	[]
Pablo Menares	[]
Palenke Soultribe	['colombian rock', 'nu-cumbia']
Pamina Blum	[]
Panteros666	['destroy techno']
Paticia Samaniego	[]
Patrice Moret	[]
Patrick Bruel	['chanson', 'francoton', 'french pop']
Pau Lligadas	[]
Paul & Gabriel	[]
Paul Sikivie	[]
Penguins By Choice	[]
Pepe	['banda', 'grupera', 'latin', 'latin pop', 'mariachi', 'norteno', 'ranchera', 'regional mexican']
Peter Dahm	[]
Peter Gottstein	[]
Peter K Frey	[]
Peter McGuire	[]
Peter Meier	[]
Peter Schärli	[]
Peter Vögeli	[]
Petra Ackermann	[]
Petrit Ceku	['classical guitar']
Petter U. Johansen	[]
Pezzo	[]
Philipp Moll	[]
Philippe Litzler	[]
Pierre Favre	[]
Pilar Fontalba	[]
Prince Keman	[]
Puerta Sur	[]
Pär Näsbom	[]
Quique Sinesi	['folklore argentino']
R	['dance pop', 'dwn trap', 'hip hop', 'hip pop', 'pop', 'pop christmas', 'pop rap', 'r&b', 'rap', 'soul christmas', 'southern hip hop', 'urban contemporary']
Rafael Scheiwiller	[]
Rahel Binetti	[]
Rahel Sohn	[]
Raimund Wiederkehr	[]
Rainald Grebe	['kabarett', 'liedermacher']
Ralf Norgel	[]
Ralph Sonderegger	[]
Raly Scheuing	[]
Ramon Landolt	[]
Ramon Ziegler	[]
Rangleklods	['danish indie', 'danish pop']
Raphael	['funk', 'indie r&b', 'memphis soul', 'neo soul', 'r&b', 'soul', 'soul blues', 'urban contemporary']
Raphael Loher	[]
Raphael Wallfisch	['cello']
Rea Claudia Kost	[]
Rease Nydegger	[]
Rebecca Spiteri	[]
Regula Konrad	[]
Relentless	[]
Renate Scheurer	[]
René Oswald	[]
René Tanner	[]
Richard Decker	[]
Rico Baumann	[]
Rihanna	['dance pop', 'pop', 'pop christmas', 'r&b', 'soul christmas', 'urban contemporary']
Rob Cambre	[]
Robert Kubiszyn	[]
Roberto Koch	[]
Roby Lakatos	[]
Rod Williams	[]
Roger Glaus	[]
Rokia Traoré	['afrobeat', 'mande pop', 'new tribe', 'world']
Roland Sauter	[]
Rolf Lyssy	[]
Roman Groner	[]
Roman Nowka	[]
Ronny Spiegel	[]
Ruben Rodriguez	[]
Rudolf Bamert	[]
Rudy Rotta	['power blues-rock', 'texas blues']
Rupert Charlesworth	[]
Russell Malone	['deep jazz guitar', 'jazz christmas']
Ruth Killius	[]
Sabaton	['metal', 'power metal', 'swedish metal']
Sabine Ercklentz	[]
Sabine Erdmann	[]
Sabine Poyé Morel	[]
Saint Motel	['folk-pop', 'indie pop', 'indie poptimism', 'indietronica', 'la indie', 'shimmer pop']
Salome Buser	[]
Sam Burckhardt	[]
Samuel Castro Bastos	[]
Samuel Dühsler	[]
Sandra Weiss	[]
Sandro Heule	[]
Sandy Patton	[]
Sara Franchini	[]
Sarah Buechi	[]
Sascha Litschi	[]
Saskia Hein	[]
Saturnalia Temple	['black sludge']
Saul Williams	['abstract hip hop', 'alternative hip hop']
Schifer Schafer	[]
Schoolly D	['east coast hip hop', 'electro', 'gangster rap', 'hardcore hip hop', 'hip hop', 'old school hip hop', 'rap']
Scott Matthews	['chamber pop', 'indie folk']
Sebadoh	['alternative pop', 'alternative rock', 'anti-folk', 'dance-punk', 'dream pop', 'experimental rock', 'freak folk', 'gbvfi', 'grunge', 'indie rock', 'jangle pop', 'lo-fi', 'math rock', 'neo-psychedelic', 'noise pop', 'noise rock', 'post-hardcore', 'post-punk', 'power pop', 'shoegaze', 'slow core', 'space rock', 'twee pop', 'uk post-punk']
Sebastien Fulgido	[]
Sebastien Gagneux	[]
Selah Sue	['soul']
Selina Cuonz	[]
Serafina Rufer	[]
Seraina Perrenoud	[]
Seraphim von Werra	[]
Serenity	[]
Sergej Nakariakov	[]
Sergey Mushtakoff	[]
Sergey Starostin	[]
Serious Black	['neo classical metal', 'neo-trad metal']
Seung-Yeun Huh	[]
Severin Jenny	[]
Shadows Fall	['alternative metal', 'christian metal', 'groove metal', 'industrial metal', 'melodic death metal', 'melodic metalcore', 'metal', 'metalcore', 'nu metal', 'rap metal', 'rap rock']
Shantel & Bucovina Club Orkestar	[]
Sharon Prushansky	[]
Sigi Nikitscher	[]
Silcan Jeger	[]
Silla	['underground rap']
Silvan Schmid	[]
Silvia Jost	[]
Silviya Savova-Hartkamp	[]
Simon Berz	[]
Simon Borer	[]
Simon Boss	[]
Simon Fuchs	[]
Simon Vögeli	[]
Simone Keller	[]
Slayer	['alternative metal', 'death metal', 'groove metal', 'hard rock', 'metal', 'nu metal', 'rap metal', 'rap rock', 'rock', 'speed metal', 'thrash metal']
Snoop Dogg	['g funk', 'gangster rap', 'hip hop', 'pop christmas', 'pop rap', 'rap', 'southern hip hop', 'west coast rap']
Sonia Borisova	[]
Souls Revival	[]
Stahlmann	['medieval rock', 'neue deutsche harte']
Stefan Gabele	[]
Stefan Kahle	[]
Stefan Pavelka	[]
Stefan Schroff	[]
Stefanie Hess	[]
Stella Doufexis	[]
Stepe Diener	[]
Stephan Athanas	[]
Stephan Kurmann	[]
Stephan Thelen	[]
Stephanie Pfeffer	[]
Stevie Cochran	[]
Stray From The Path	['christian hardcore', 'death core', 'mathcore', 'melodic metalcore', 'metalcore', 'rap metal', 'screamo']
Stéphane Fromageot	[]
Suguru Ito	[]
Sukarma	[]
Sun-Young Nam	[]
Supanova Sound	[]
Sven Angelo Mindeci	[]
Tamar Halperin	[]
Tamriko Kordzaia	[]
Tar Queen	[]
Taras Berchtold	[]
Tausend Löwen unter Feinden	[]
The Acacia Strain	['christian hardcore', 'death core', 'djent', 'mathcore', 'melodic metalcore', 'metalcore', 'rap metal', 'screamo']
The Creepshow	['horror punk', 'psychobilly']
The Delta Saints	['alternative roots rock', 'electric blues', 'modern blues']
The Exploding Boy	['deep gothic post-punk']
The Gate	['christian alternative rock', 'christian hardcore', 'christian metal', 'christian rock', 'melodic metalcore', 'metalcore', 'post-screamo', 'screamo']
The Natural Dub Cluster	[]
The Outside Track	['celtic', 'irish folk', 'jig and reel']
The Pharcyde	['alternative hip hop', 'dirty south rap', 'hardcore hip hop', 'hip hop', 'pop rap', 'rap', 'southern hip hop', 'turntablism', 'west coast rap']
Thilo Muster	[]
Thomas Azier	[]
Thomas Dürst	[]
Thomas Gasser	[]
Thomas Hauser	[]
Thomas Koran	[]
Thomas Michael Allen	[]
Thomas Silvestri	[]
Thomas Zehetmair	['violin']
Tinu Heiniger	[]
Tobias Preisig	[]
Tom Copson	[]
Tom Tafel	[]
Tomas Gallart	[]
Tommaso Scannapieco	[]
Toni Bechtold	[]
Tony Renold	[]
Toshiko Sakakibara	[]
Tracer	['deep melodic hard rock']
Truls Mork	['classical performance', 'orchestral', 'violin']
Tsering Purtag	[]
Unearth	['alternative metal', 'christian hardcore', 'christian metal', 'death core', 'groove metal', 'melodic death metal', 'melodic metalcore', 'metalcore', 'nu metal']
Urs Brunner	[]
Urs Höchle	[]
Urs Müller	[]
Urs Stirnimann	[]
Urs Vögeli	[]
Ursula Hauser	[]
Valentin von Fischer	[]
Valer Sabadus	[]
Valeria Zangger	[]
Valerio Zanolli	[]
Valery Sokolov	[]
Van Morrison	['album rock', 'blues-rock', 'classic rock', 'folk', 'folk rock', 'folk-pop', 'mellow gold', 'neo mellow', 'rock', 'roots rock', 'singer-songwriter', 'soft rock', 'soul']
Vera Kappeler	[]
Verena Zauner	[]
Viktor Nyberg	[]
Vilde Frang	['classical performance', 'violin']
Vince Cherico	[]
Vincent Glanzmann	[]
Vincent Membrez	[]
Vincent Ruiz del Portal	[]
Vinícius Melo	[]
Vlad Weverbergh	[]
Volker Biesenbender	[]
WSTR	['alternative emo', 'anthem emo', 'pixie', 'pop punk']
Walter Baumgartner	[]
Walter Hotz	[]
War of Ages	['christian hardcore', 'christian metal', 'melodic metalcore', 'metalcore', 'screamo']
Warwick Richard	[]
Weak Fishes	[]
Wege Wüthrich	[]
Weird Omen	[]
Werner Ammann	[]
Werner Hasler	[]
Werner Siegenthaler	[]
Werner Van Mechelen	[]
Werner und Company	[]
Wintersleep	['canadian indie']
Withered Hand	['scottish rock']
Wolfgang Dauner	['kraut rock']
Wolfgang Zwiauer	[]
Woodkid	['chamber pop']
Woodpigeon	[]
Worldly Savages	[]
Xaver Rüegg	[]
Y'urs	[]
Yak	[]
Yeree Suh	[]
Yogev Glusman	[]
Yoro Massa	[]
Yosvany Quintero	[]
Yulianna Avdeeva	[]
Yung Lean & The Sad Boys	[]
Yury Revich	[]
Yza Ya	[]
Zaz	['french pop']
Ziggy Tschigi Moser	[]
Zosch	[]
Zéphyr Combo	[]
dance animation by Alexander Martinez	[]
works by Johannes Dickbauer	[]
Årabrot	['norwegian metal', 'norwegian rock']
Åsa Dornbusch	[]
