	None
&	pop
& MORE TBC	None
& many SURPRISE & SPECIAL GUESTS	None
& more	deep freestyle
& more TBA	None
0000  0100  MAHMOOD	None
0000  0100 DJ Olafson	None
0000  0100 STEPH COLE	None
0000  0200	None
0000  0200  Clara	None
0000  0200 FION 2000	None
0000  0530 Av Skardi	None
0000  ANDROO	None
0030  0530 SOFA TEE & HERMES	None
0030  END	None
0030  END  JEANTOUSSAINT & 2000	None
0041 79 58 68 812	None
00h00 à 00h45  Bak XIII	None
00h00 à 00h45  The Atomic Bitchwax	None
0100  0200  ARTMAILLE	None
0100  0200 Cosmic Bastards	None
0100  0300 Gelivan	None
01h25 Ã  02h55  Miss Duckin	None
01h25 à 02h55  Miss Duckin	None
0200  0330 Gelivan	None
0200  0400	None
0200  0400  Daniel Wang	None
0200  0400  Substance aka DJ Pete	None
0200  0400 Anthony Parasole	None
0200  HORASSE & Tissu	None
0200  Soichi Terada	None
0300  Alan Bolumar	None
0330  0500 NDroo	None
0400  0530  Strb	None
0400  0530 OJIE	None
0400  05h30	None
0400  END  Crowdpleaser	None
1204 Genève	None
1300  1400 TBA	None
130BPM	disco
1400  1430 Betty & Ford	None
1400  1500 Kyrill & Redford	None
1430  1500 James Mc Hale	None
14h00 à 14h45  Danila	None
14h00 à 14h45  Floyd Beaumont & The Arkadelphians	None
15 CHF	None
1500  1700 Adriatique	None
1500  1700 Sascha Braemer & Niconé	None
15h00 à 15h45  Max der Zinger	None
15h00 à 15h45  Six Months Of Sun	None
1600  1900 JEAN TOUSSAINT & 2000	None
16h00 à 16h45  Hollyhock	None
16h00 à 16h45  M Fallan	None
1700  1900 Adana Twins	None
1700  1900 Monkey Safari	None
17h00 à 17h45  The Savonnettes	None
17h00 à 17h45  Voice Of Ruin	None
18h00 à 18h45  Colossus Fall	None
18h00 à 18h45  The Chikitas	None
1900  2100 ARTMAILLE	None
1900  2100 Oliver Koletzki	None
1900  2100 TBA	None
19h00 Ã  20h00  Metronome Djs	None
19h00 à 19h45  Ca Va Chier	None
19h00 à 19h45  Wardhill	None
19h00 à 20h00  Metronome Djs	None
2 Many DJs	techno
20 CHF	None
20h  21h30  ABOVE THE CLOUDS	None
20h00 Ã  20h45  Tanua	None
20h00 à 20h45  Gaz	None
20h00 à 20h45  Mumakil	None
20h00 à 20h45  Tanua	None
20h00 à 20h45  Vuyvr	None
20h30  21h30  SLAKBAR	None
20h45 Ã  22h15  Fabian Kozelsky	None
20h45 à 22h15  Fabian Kozelsky	None
2100  2300 Animal Trainer	None
2100  2300 MAHMOOD	None
2100  2300 Nina Kraviz	None
21h00 à 21h45  Incrüst	None
21h00 à 21h45  KessKhtak	None
21h30  22h30  VOLCANO THE BEAR	None
21h30  23h  JONNY SENDER	None
2200  2300 Steph Cole	None
22h00 à 22h45  Elizabeth	None
22h00 à 22h45  Promethee	None
22h15 Ã  23h45  Frother	None
22h15 à 23h45  Frother	None
22h30  01h  Cobeia	None
2300  0000 Daniel Wang	None
2300  0000 David August	None
2300  0000 Kollektiv Turmstrasse	None
2300  0000 SAMD FURIOUS	None
2300  0000 SamD Furious	None
23h  01h  Prins Thomas	None
23h00 à 23h45  Faute de Frappe	None
23h00 à 23h45  SolarFlar VS Rocrar	None
23h45 Ã  01h25  Oxensa	None
23h45 à 01h25  Oxensa	None
24	bachata
2409	None
2509	None
25616  2359 Uhr bis 800 Uhr	None
26616  ab 800 Uhr	None
2Dirty	house music
2floor	None
2nd Opus	None
2nd Room	None
2room	None
2st Room	None
3 LIVE Bands	None
35plis	None
393389470704	None
60s70s brazilian grooves	None
6NOK	None
7th City	None
959er	disco
A  AT	None
A Bordo	None
A Heiniger	disco
A LiveDJJam reinterpreting some of Dumb Units best pieces from the last 10 years	None
A Made Up Sound aka 2562	None
A State of Mind	None
ABGESAGT	None
ABROTHERS  Gayle San Rec & Nachtstrom Schallplatten  AUT	None
ABSÜRDA	None
ADI	house music
AEED LIVE	None
AFROBEAT NIGHT	None
AFTER 5PM  OPEN END	None
AGENT	punk
AJANIX	None
AKA AKA	hip hop
AKN & Ditek	None
AKUSTIK	None
AL NØRD	None
AL SENTO	None
ALAIN ROY & Dirty Larry	None
ALAN LECTOR	None
ALBURT	None
ALLP ch wallis	None
ALON LEVI	None
AMari	None
AN AN	emo
AN JA	None
ANALOG	vapor soul
AND SURPRISE & SPECIAL GUESTS	None
ANDERSEN	None
ANDREAS & MLK	electronica
ANDREJ	None
ANDRES HERNANDEZ	None
ANDREW THE GRAND	None
ANDRI LIVE	None
ANDRI LIVE  Cityfox	None
ANGY DEE	None
ANNA ULLRICH	None
ARCHIMEDE	None
ARIAS	house music
ARTMAILLÉ	None
ASM	None
ASON	None
ASVF b2b Bodom	None
ASkillz	funky breaks
AT	emo
ATA	house music
ATMA	None
AVA ASANTE	None
AXL P	None
AXL P Aleryde	None
Aalbou	None
Aaron Khaleian	None
Abdel Hady	disco
Abel	deep indie r&b
Abilic	disco
Abnormal Boyz	None
Abordo	None
Abou Samra	house music
About Clint	None
Absolutive	None
Abstract	None
Abstrhytmik	None
Accama	None
Achilles Moss	None
Achtung Kinder & DJ Tommy Lexxus	None
Acid Arab	techno
ActFact Records	None
Actamin	None
Acumen	techno
Adam Winston	None
Adana Twins	deep
Adi Nalin	None
Adi Shabat ReFeel	None
Adil Hiani	hip hop
Adimatique	None
Adolpho & Franky	None
Adolpho & Franky and more	None
Adrian Amirail	None
Adrian Bergmann	None
Adrian Martin	disco
Adrian Martin  Miniload  Nordstern	None
Adriano	disco
Adriano Mirabile	hip hop
Adriatique	techno
Adriatique  Diynamic	None
Adry	None
Adva	None
Adva & Purpurea	None
Aeon	death
Afrojack	house music
Afronaught	breakbeat
After Grauer	None
AfterBoat	None
Afterhour guarantee location tbc	None
Afterparty Princess P	None
Agaric	techno
Agent	punk
Air	electronic rock
Ajele	None
Akt	None
Aktarus	None
Aktaruss	None
Alain Szerdahelyi	None
Albee	None
Albi	None
Alburt	None
Alci	classic colombian pop
Alejandro Mosso	techno
Alek X	techno
Alekk & Twitch Jacob	None
Alekk & Twitch Jakob	None
Alessandro Crimi	disco
Alex Anderst	None
Alex Belluscio	None
Alex Celler	techno
Alex Dallas	None
Alex Dallas  Washerman	None
Alex Flatner	techno
Alex G & Fame	rap
Alex Kostik Teknologik Rec	None
Alex Lore	None
Alex Mendes	disco
Alex Price	techno
Alex Pro	None
Alex Schulz	house music
Alex Silver	None
Alex T Rauch	None
Alex Tea	disco
Alexander Vogt	house music
Alexis Cabrera	techno
Alfonso Forte	techno
Algorythmik	electro music
Alice Russell	downtempo
All Day I Dream	None
Alladin K	None
Alle Farben	house music
Allegra Lusini	None
Allemagne	None
Allen D Shac	None
Alma	None
Alma Negra	None
Along with his teammates DJ Spinn and DJ GantMan	None
Alphahouse	None
Alphajet	None
Amaro	reggaeton
Ambient by Heiko	None
Ambienttechno by EFTN	None
Ambivalent	techno
Amelie	disco
Amilcare	romantic
Amine Heitz	None
Amirali	disco
Amsel & Dohle	None
Amsterdam	None
An den Decks	None
An21	house music
Anatopia	None
AndHazel	None
Andaloop	disco
Ander	techno
Andersen	None
Andhazel	None
Andhim	house music
Andre	techno
Andrea Frisina	disco
Andrea Oliva	house music
Andrea Oliva  Nordstern	None
Andrea Pesta	None
Andrea Roma	techno
Andreas Ramos	disco
Andreas Ramos  Rumlaut  Enzo lo Conte	None
Andreas Ramos & Schmerol	disco
Andreas Ramos Baked  Zürich	None
Andrew The Grand	None
AndrewGee	None
Andrey Pushkarev	techno
Andri	deep
Andri  2h Live Set	None
Androgyn	hardcore
André Galluzzi	None
André Hommen	house music
André Marvin	None
Andrés Marcos	None
Andy Catana	techno
Andy Dee	hardcore
Andy Katz	None
Andy Struzek	None
Anemonen	None
Angelica Fravi	None
Angelo B	None
Angerfist	hardcore
Angy Dee	None
Anima	vapor soul
Anima Dj set	None
Animal Trainer	house music
Animal Trainer  hive audio  zürich	None
Animalist	None
Anish	disco
Anja	techno
Anja Schneider	techno
Anna Tur	disco
Anthea	techno
Anthik	house music
Anthony	hollywood
Anthony Megaro	techno
Anthony Shake Shakir	techno
Antik	None
Antix	progressive psytrance
Antja	None
Antoni Bios	techno
Antonio Mazar	None
Aparde	house music
Apollonia	None
Apu	None
Aquarius Heaven	hip hop
Araabmuzik	vapor twitch
Archetype	christian
Archie Hamilton	techno
Argenis Brito	None
Argenis Brito & Dandy Jack	rap
Argy	techno
Ari Onni	None
Ariol & Pawlikowski	None
Arkki	None
Armed Guys	None
Armonica	None
Arnika	None
Arnstroem	None
Aron	acoustic pop
Arth Goldau	disco
Artik	russian pop
Artmaillé	None
Arutani	None
Association Specimen EventBookingLabel	None
Aston Martinez	None
Astroneff	None
Ata	house music
Atila	None
Atish	house music
Atlantiks	None
Attias	None
Attilio	None
Aubrey	disco
Audino	None
Audino Punkt  Zürich	None
Audio Jack	techno
Audio Werner	techno
Audiofly	techno
Audiofly  Get Physical	None
Audiologism	None
Audionatica	techno
Audionatica  Gon Records zh	None
Audiovisual techno set	None
Aulay Fou	disco
Aurora Halal	disco
Autechre	techno
Autonome Essenz	None
Autostrada A2 direzione Lugano	None
Autostrada A9 direzione Como Nord	None
Avem	None
Avesta	house music
Avicii	house music
Avrosse	techno
Azax	None
Azax Syndrom	trance music
Azimute	techno
Azoth	None
Azzuro	None
Aïsha Devi	fluxwork
B E Y O N D	disco
B Gahan	None
BABAJAGA	None
BAD BUG	None
BADBUG  LIVE	None
BANOPROD	None
BAROZ  elektrostubete	None
BASS N SMILE	None
BASSFORSCHER & FACE DESIGN	None
BAUCHAMP	None
BCee	drum and bass
BE	rock
BEATIS & BASSHEAD	None
BEATSPOKE	None
BEDRAN	None
BIEBERS	None
BIGENERIC	None
BILDER vom Club	None
BISCARDONG	None
BJÖRN LOMAR	None
BK	techno
BL	None
BLAIR	house music
BNX	None
BOCUSE	None
BOCUSE & DER PFLANZER	None
BORN  BassOnRepeatNetwork	None
BOTICO & ROSP	None
BOUNCER aka Marcosis	None
BOUND EFFECT	None
BOY8BIT	None
BP Zulauf	None
BPM Project	None
BPitch  UK	None
BREKOWSKY b2b JONNYNES	None
BS	None
BVoice	techno
Baalsaal	None
Baba	house music
Baba & Adhmad Til	None
Bach	classical
Bachstelzen  BERLIN	None
Backspin Boys	None
Backstube	None
Bad Nelson from Losanna	None
Baden	forro
Bagatelle93	None
Baile Musik  BE	None
Baile Musik  DE	None
Bakermat	house music
Balatonbeats	None
Balouk	None
Bambounou	techno
Bang Goes	None
BangFreaky UndersoundDE	None
Banshee	escape room
Bar 2130 Uhr	None
Bar 25	None
Bar25	None
Bar25  Berlin	None
Barac	disco
Barbir	None
Barbir & Nicola Kazimir	None
Barbir Punkt  Zürich	None
Barcelona	acoustic pop
Bardo	rock
Bardo & Salazar	None
Barem	techno
Bari	trap
Baris K	None
Barnt	house music
Baroz	None
Bart Skils	techno
Bas Ibellini	None
Basel	consort
Basel Deep House Youngstars	None
Basenji	aussietronica
Basic Fingers	None
Bassbüro	None
Bassnsmile	None
Basstherapie ZH	None
Basstronauten	techno
Bauchamp	None
Be Svendsen	house music
Beaner	disco
Bear Funk	None
Beatamines	house music
Beatis & Basshead	None
Beats On Demand	None
Beatspoke	None
Beckers	None
Beda	disco
Beda & Lukas	techno
Beda und Marwin	None
Bee Lincoln	techno
Beez & Simo	None
Bella Sarris	None
Bella Sarris tINI & the gang  London	None
Bellomz	None
Ben Ashton xa0	None
Ben Guayas	None
Ben Purple	None
Ben Rau	techno
Ben Rau Fuse  Berlin	None
Ben Westbeech	None
Ben Yoo Suk	None
Beni Berger	None
Benj Hangar11	None
Benja	None
Benjamin	metal
Benjamin Fehr	hip hop
Benjamin Fehr  Catenaccio  Foundsound  Finefood Records  Berlin	None
Benjamin b2b Peter Szanto	None
Benno Blome	house music
Benotmane	house music
Beppe Loda	None
Berber & Pasta	None
Berghain Ostgut	None
Berlin	house music
Bern	None
Betoko	house music
Bfly	None
Bfly Steiner	techno
Bfly Steiner  Nahste Oner	None
Bfly Steiner and friends	None
Biebers	None
Binh	vietnamese pop
Biologic Records  Tel Aviv	None
Bird	indie
Bird  sirion  Bern	None
Bird aka Pat Muvembe	None
Biru	None
Bishop & Goldberg	None
BitTuner	None
Björn Arryhl	None
Björn Lomar	None
Björn Störig	house music
Black Zone Myth Chant	mandible
BlackCat	None
BlackStrobe	electronic rock
Blacksheep	techno
Blair	house music
Blankton & Sammelstelle	None
Blaqq & Whyd	None
Bleepsequence	None
Blondish	house music
Blue Devilz	None
Bo51	None
Boat	emo
Bob Spiegel & Audiotekk	None
Bobby & Steve	rap
Bobmo	techno
Bogota	rock
Bojan Milenkovic	disco
Boloko	None
Bonafide 3000 ISR live Support FEA Soundsytem BE	None
Bonaventure	disco
Bondage DE	None
Bongo Joe Djs	None
Bonjour Ben	None
Bonnie	rock
Bonny & CLyde	None
Bonny & Clyde	None
Bons Vivants Records	None
Bonzzaj	None
Bonzzaj All Stars	None
Bonzzaj Records	None
Boogie Belgique	electro music
Boomjacks	None
Bordeaux	None
Borderline	antiviral pop
Borderline Dominik Eulberg	None
Borderliners Rec	None
Boris	halloween
Boris Brejcha	techno
Boris Dolinski	None
Boris Hilton Artwork	None
Boris Werner	techno
Boris Why	house music
Born Bjorg	techno
Boston Bun B2B Busy P	None
Bottin	disco
Boy 8 Bit	techno
BoyAn	house music
BoyAn  Fery  Diese Jungs brillieren	None
BoyoomConnective	None
Braniquake	None
Branko	house music
Breandan Davey	techno
Brett Jackson	None
Brett Jacobs	techno
Brian Sanhaji	hip hop
Brian Sanhaji Live	None
Britta Arnold	deep
Brodinski	house music
Brokapella	None
BrokenEnglishManchester	None
Brothers in Arms	None
BruderHerz	None
Bruderherz	None
Bruk Boogie Kru	house music
Bruno Chaix	None
Bruno Pronsato	None
Bruno Vice	None
Brussels Regulate	None
Bufiman	house music
Buko	None
Buko & Credo	None
Bunga Bunga	indonesian pop
Bunk3r RecordsSubwoofer Records	None
Bunte Bummler	disco
Burt Cobain	None
Butch	rock
Butterfly	rock
Butterfly feat Ice MC	None
Byzance	None
Bäm Bäm	hip hop
C Forza	None
CCO	disco
CEZAR	techno
CFly	None
CH	None
CH6850 Mendrisio	None
CHIC AND THE TRAMP	None
CHIKAGO	None
CHILLOMANIE	None
CHOREGRAPHY ANDRE MINKUS	None
CHRIS DE REBEL	None
CHRIS LOUD	None
CJ Stone	trance music
CJPHOUS	None
CLARI ANN	None
CLAUDE STAFFIERI	None
CLAUDE TARRELL	None
CLIFF & FABRICE	None
CLOUDBOAT	None
CLUB	electronic rock
CMOS	None
CMOS & Kens	None
CNDR	None
CONSTAR	None
CRAY	trap
CREATOR	hip hop
CRIS P	None
CRYPTEXMARBLE	None
CUT	electronic rock
CYRIL LEGER	None
Cab Drivers	None
Cabinet Records	None
Cadenza	None
Cadenza Lausanne	None
Cafe Singer Dirty Doering	None
Café Gold	None
Caillou	None
Calado	None
Caleb Calloway	hip hop
Call Super	house music
Calvo	house music
Camea	house music
Camiolo	None
Canada	electronic rock
Canson	house music
Cantina Brothers	None
Captain Teis	None
Carl Jack aka Abdomen	None
Carlo Cannone	None
Carlo Ruetz	house music
Caru Brown	None
Casque	None
Castro Moore	None
Catz N Dogz	house music
Centaury	None
Central Rodeo	techno
Cesar Merveille	techno
Cesare vs Disorder	techno
Cesare vs Disorder & Quenum	techno
Cesco	None
Ch	None
Chad Andrew	hip hop
Chad Andrew tINI & the gang  Orlando	None
Chak Besh	None
Chak Besh Katerholzig	None
Chak Besh b2b Svenskj	None
Channel X	house music
Chapkmace	None
Charles Bohmann	None
Charles Meyer	house music
Charles Meyer and Josè Parra	None
Charles Tone	dub
Charlie Gold	None
Chateau Chepere	None
Chaton	None
Cheeky Choice	None
Chic Miniature	None
Chica Paula	techno
Chicago Shlag	None
Chicagos Mad Decent Block Party	None
Chicco Green	None
Chop & Suey	None
Chris Ahn	techno
Chris Air	None
Chris Carrier	techno
Chris De Rebel	None
Chris Dubflow	ambient
Chris Hoever	None
Chris Koegler	None
Chris Lattner Moon Harboour	None
Chris Leon	None
Chris LeÃ²n	None
Chris Leòn	None
Chris Liebing	techno
Chris Loud	None
Chris Milla	techno
Chris Rockwell	techno
Chris Tietjen	disco
Chris Tietjen Cocoon  Frankfurt	None
Chris de Rebel Flügstund  Zürich	None
Chris di Carlo	None
Christian & Raphaël	house music
Christian Burkhardt	techno
Christian Burkhardt live	None
Christian Elefante	None
Christian Schiemann	disco
Christo	house music
Christopher Joseph	None
Christopher Lawrenz	None
Christopher Power ALL NIGHT LONG	None
Christopher Rau	house music
Chronic Fingaz	None
Chuck Poland	None
Chuck Poland  Bernoise  Andy Struzek	None
Cindy	rock
Cinthie	house music
Cipmo	None
Circle	rap
Circle of Love	None
Circumflux	None
Citizen Kain	house music
City Lights	pop
Cityfox	None
Cityfox Ltd	None
Clap Clap	electronic rock
Claptone	house music
Clara	None
Clara 3000	hip hop
Clats	None
Claude Laurier	None
Claudio	orchestral
Claudio & Emre	rap
Claudio Carrera	None
Claudio Loco  Psy Group	None
ClekClekBoom	None
Clem	hip hop
Cleydys Villalon	None
Click Click kassette records BERLIN	None
Clio	german
Clique of Two	None
Clit Eastwood	None
Clit Eastwood & Winona Slider	None
Clive Bean	None
Closer	None
Club 2300 Uhr	None
Club Cheval	disco
Club Q	None
CoMini	None
Cobblestone Jazz	techno
Cobeia	hip hop
Cocktail Garden	None
Cocoon	chanson
CocoonZürich	None
Cocun	None
Code Red	boy band
Coffy Drop	None
Cold Colors	electronic rock
Collynization Soundsystem	None
Colours Audio	None
Come raggiungerci	None
Comini	None
Comini GlückStück ZH	None
Comitissa	None
Commodo	uk garage
Como Damar	None
Concert	classical
Concert et djs	None
Consor	techno
Contexterrior	None
Copenhagen	choral
Copyright	house music
Core Rhythm	None
Corpataux  Roach  Jutzi  Der Dirigent  Eiléma	None
Correspondant	None
Cosi Dee	None
Cosmic  Bern	None
Cosmix	None
Cosmo & Faber	rap
Cosmo & Kramer	rap
Cosmo Color	None
Cosmokolor	house music
Cotton Claw	house music
Counteract	None
Coyu	techno
Craig Richards	house music
Cre8	None
Cris Lange	techno
Cris P	None
Cristian Tamborrini	house music
Crosstown RebelsFR	None
Crossworld Records	None
Crowdpleaser	techno
Crowdpleaser  Turbo Recordings	None
Crux	oi
Cubex	house music
Culoe De Song	house music
Culprit	None
Cutkachi	uk garage
Cyberpunkers	house music
Cécile	None
César Merveille	None
D	rock
D Cosmo	None
D Cosmo & Faber	None
DADO REY	None
DAN KOOK	None
DANIEL BRENNER	None
DANIEL BROESECKE	None
DANIEL MARRONE & Radro	None
DANIMAL	video game music
DARIO DESIENA Visuals	None
DAS	kirtan
DAVID FJORGENSON LIVE	None
DAVID FRAKA	None
DAVID JIMEZ	None
DAVID LA MINE	None
DAY DIN	progressive psytrance
DB	None
DBM	None
DC&KE	None
DE	grupera
DEEJAYS	house music
DEJAN	None
DEJAN  Cityfox	None
DELANO	pop
DELAYED PROJECT	None
DER PFLANZER	None
DExp	None
DFA	None
DFA  San Francisco	None
DFIND	None
DIAZ DJ	None
DIDA	None
DINKY	techno
DIRTY APPLES	None
DISCOTECARIO DOCA	None
DJ	house music
DJ Alex B Hard	None
DJ Alexio	None
DJ Andy Smith	None
DJ Ass	None
DJ Aunt One & Napoleton	None
DJ BK	None
DJ BOOBY	None
DJ Bazooka	None
DJ Big T	hip hop
DJ Bolumar	None
DJ Bone & Sir D Modernist	techno
DJ Cam	downtempo
DJ Chris Wi	None
DJ Civi	None
DJ Coma	None
DJ D	trap
DJ Dano NL	None
DJ Deenasty	None
DJ Diferenz	None
DJ Dub	dub
DJ EPI	None
DJ Emerson	techno
DJ Energy	bubble trance
DJ F	None
DJ FAITH	None
DJ FINE	None
DJ Flow	None
DJ Food	breakbeat
DJ Freezer	None
DJ GantMan	footwork
DJ Geepunkt	None
DJ Giuly	None
DJ Giuly vs Sensenmann	None
DJ Godfather and Jammin Gerald He has the ability to blend elements of house	None
DJ Hotfingerz	None
DJ IM Jdore	None
DJ Insane	None
DJ JEAN BALAISE	None
DJ JOAO DINIS	None
DJ Jamie Lewis	None
DJ Jay Sanders	None
DJ Jesse Jay	None
DJ Joh	hardstyle
DJ Jonny B	None
DJ KOSMICK	None
DJ Kristof	gabba
DJ Krush	downtempo
DJ LAFOLIE ON THE MIX	None
DJ Larson	None
DJ Le Roi	hip hop
DJ Les Filles Affranchies	None
DJ Lynn Jordan	None
DJ Manual  Noromal & Christian Durdek  Fabio Gullone	None
DJ Mastra & DJ Zukie173 Visuals by durchzweich	None
DJ Mastra & Kellerkind	None
DJ Mathematic	None
DJ Milosz	None
DJ MoRFiN	None
DJ Mute	None
DJ Neophyte	gabba
DJ NÃ¼nn	None
DJ Nünn	None
DJ OEL & KAMA	None
DJ Oil	None
DJ Oxyxa	None
DJ PAD	None
DJ POSTMAN	None
DJ PTess	None
DJ Phil	None
DJ Pone	turntablism
DJ REAS	None
DJ RKK	None
DJ Randy	None
DJ Rashad	house music
DJ Rashad has become notorious for making Juke anthems that have made fans outside the world of Chicago mix cds Hes released records on Dancemania	None
DJ Rashad has been instrumental to the creation and evolution of Chicago Juke music and has been lifelong friends with other key players on the scene such as Paul Johnson	None
DJ Rescue	hip hop
DJ Rocca	downtempo
DJ Rush	techno
DJ Ryck	None
DJ SAM	None
DJ SCM	None
DJ SF12 & DJ LYPTIC ONE	None
DJ SNES	None
DJ ST XAVIER	None
DJ Sam	None
DJ Sassy J & DJ Alex Like	None
DJ Scar	None
DJ Show	None
DJ Sotofett	None
DJ Soulchild	None
DJ Spen	house music
DJ Spinn	house music
DJ T  Get Physical	None
DJ TASTY	None
DJ Tiago CORTEZ   DJ FURITEC AKA PASCAL PROSPER	None
DJ Tony Big	None
DJ Tray	None
DJ Volta	None
DJ Voltec	house music
DJ Voltec & DJ Flavius Tadeus	house music
DJ Wenzel Dashington	None
DJ YORE	None
DJ Yellow	techno
DJ ZEST	None
DJ Zest	None
DJ set	None
DJERRY C	None
DJS	new jack swing
DJSet &Trauma Duo	None
DJs	new jack swing
DJs  Acts	None
DJs Ben Danger & Wenzel Dashington	None
DJs Disco Ste	None
DJs Eli Verveine	None
DJs Frits Wentinik	None
DJs Green Velvet  DJ Rush  Monika Kruse  Felix Kröcher  Moonbootica  RaudiveOliver Ho  DIM  Shonky  Xenia Beliayeva  Steve Land aka Randy  Hannah Holland  Dachshund  Agnès  Smilla  Phuture Traxx  TurntableBabes  Ulli & Maesoo  Banga  Beda  Sandro Kühne and others to be confirmed	None
DJs Guyus	None
DJs Lucky Charmz	None
DJs Mooqee	None
DJs Nik	None
DJs OEl & Kama	None
DJs René S	None
DJs Solid & Wenzel Dashington	None
DJs Spectron & Jay Sanders	None
DJs Tape	None
DJs The Dean Soniks	None
DJs Utah Jazz	None
DJs Zombie Disco Squad	None
DK	None
DLM	rock
DM Free	None
DMS vs Miss JayKill	None
DMT	indie dream pop
DMT Synth	None
DMalice	None
DModestino	None
DNox	house music
DOG	indie
DON CREEK  Freaky A	None
DONT DJ	None
DSER	None
DUSTY	soul
DVW	house music
DVW & Marc Feldmann	rap
DVW & Marc Feldmann  Trinidad	rap
DVision  BE	None
DYNAMIC BASTARDS	None
DZANIN	None
Da Bruk Boogie Crew	None
Da Cruz	bossa nova jazz
Da Ron	None
DaTO	malaysian pop
DaTO b2b Senoo	None
Dachshund	techno
Dactylo	None
Daddys Groove	house music
Dagalante	None
Dak  Violeta White	None
Daley Padley	None
Dalibox	hip hop
Damaru	hip hop
Damian Lazarus	techno
Damon aka Nikosss	None
Dan Curtin	techno
Dan Curtin USA	None
Dan Farserelli	deep
Dan Ghenacia	techno
Dan Noel	house music
Dan Welton	house music
Dan Welton and Edgar Jack	None
DanWork	None
Dana van Delden	None
Dancecode	None
Dancehall  Hiphop	None
Dandy & Trony	house music
Dandy Jack	hip hop
Dani Casarano	techno
Dani Castillo algo Mas Duro Barcelone	None
Dani Greco aka DKI	None
Dani König	None
Dani Nydegger	None
Daniel Avery B2B Roman Flügel	None
Daniel Bell	techno
Daniel Branco	None
Daniel Broesecke	None
Daniel DB	house music
Daniel Dreier	techno
Daniel Lao	None
Daniel Marrone	None
Daniel Steinberg	deep
Daniele Cosmo	None
Daniele Crocenzi	None
Daniele Di Martino	house music
Daniele Mastracci	groove room
Danielson	swedish folk pop
Danielson & Norbertto	None
Danielson & norbertto	None
Danielè	None
Daniro	None
Danni B Collage Audio  Melbourne	None
Danny Daze	disco
Danny Faber	techno
Danny Scrilla	None
Danse Noire	None
Danse Noire DJs	None
Dantze	None
Dany Jack	None
Dany Movida	None
Daparec	techno
Daria	techno
Dario Camiolo	None
Dario DAttis	disco
Dario DAttis Official	None
Dario Friberg  Voltec  Flavius Tadeus	None
Dario La Mazza	None
Dario Rival	None
Dario Sorano	techno
Dario Zenker	techno
Darius Syrossian	house music
Dark Headz	hardcore
Darkening	None
Darkstar	fluxwork
Darren Flecta	house music
Darrien	hardcore
Das Balz	None
Das Blenden	None
Das Drehmoment	None
Das Duo	None
Das HOUSE	None
Das Hutwerk	techno
Das Pferd	None
Das Schiff	None
Dauwalder	None
Dauwalder  NEAT	None
Dave Dalux	None
Dave Dinger	None
Dave Eleanor	hip hop
Dave Eleanor dj	None
Dave Hard	None
Dave Joy	None
Dave Multitask	None
Dave Neff	house music
Dave202	trance music
David Armada	disco
David August	house music
David Cruso & Kary	None
David Delgado	hip hop
David Durango	techno
David Faust	house music
David Fernaux	None
David Fraka	None
David Gtronic tINI & the gang	None
David Guetta	pop
David Jimenez	None
David K	house music
David Labeij	techno
David Lamon	None
David Smile b2b Pat KP	None
David Steel	hip hop
David Styloso	None
David Torr	disco
Davide Bomben & Era	None
Davide Bomben & Era Vulgaris	None
Davidovitch	techno
Dax J	techno
De	grupera
De Hofnar	house music
De La Maso	disco
De La Porter	None
De La Porter Skorpionkinder Rec  Cube Resident	None
De La Porter Skorpionkinder RecCube Resident	None
De La Porter Skorpionkinder Records  Cube Resident  Electroradio	None
De La PorterRoom RecSK RecCube Resident	None
De Posada	None
De la Bass	trap
DeWalta	techno
Dead Poets	None
Dean	easy listening
Dean Blunt	mandible
Dean Breda	None
Debal Sommer	house music
Deckmantel DJcollective	None
Dee Nelli	None
Dee Nelli hooojmusic	None
DeeVerso	None
Deecoy	None
Deep Chills	house music
Deep House	None
Deep n Dub	None
DeepTek	None
Deepchild	house music
Deepend	house music
Deeperfect	None
Deepn Dub	None
Deetron	techno
Defend	rock
Definition	hardcore
Dejan	None
Dejan  Cityfox	None
DekaDance	None
DekmantelAmsterdam	None
Deko & Light Timowood TV	None
Delakeyz	house music
Delsin	None
Dement3d	None
Dement3d  CH	None
Demented Are Go	horror punk
Demetrio Giannice	house music
Demir	deep turkish pop
Den Sorte Skole	None
Deneha	house music
Dengue Dengue Dengue	neo-psychedelic
Denny	None
Der Dirigent	None
Der Dritte Raum	techno
Der Effekt	None
Der Held	None
Der Schuft	None
Der Schuft aka Luca de Grandis	None
Der Wandervogel	None
Der Weisse Aya	None
Derek	hip hop
Desolat	None
Detailer & Mc Smart B	None
Detroit	None
Deviant Force	None
Deyan	None
DiDario	None
Did Low	None
Die Dummen Nutten	None
Die Galoppierende Zuversicht	None
Die Goldbrenner	None
Die Grimen	None
Die Grimen & Maty Palc	None
Die Kistenkerle	None
Diego Indigo	None
Diego Krause	hip hop
Diego Vendossa	None
Dieses Mal besucht uns ein Freund aus Berlin  Marco Effe Seine ImpressParty in Berlin spricht für sich Jeweils Mittwochs beschallt er zusammen mit diversen Künstlern aus verschiedenen Genres den weltweit bekannten Watergate Club	None
Dietrich & Strolch	techno
Digitaline	techno
Digitalism	electronic rock
Digitalist	dark psytrance
Dimette	None
Dimitri	house music
Dimitri Monev	techno
Dimlite	abstract beats
Dimlite w Julian Sartorius	None
Dinan	None
Dineo	None
Dinky	techno
Dino Amas	None
Dino Pergola & Gusto	None
Dirk Schönhöfer	None
Dirty Channels	disco
Dirty Flav	None
Dirty Greg	None
Dirty South	house music
Disco	emo
Disco & Tanzstube	None
Disco HalalBerlin	None
Disco Ste	None
Disco mit Mute DrumnBass	None
Disco mit Stil vor Talent	None
DiscoD	None
Disko Dario	None
Diskomurder	None
Ditoska	None
Divided Rec	None
Divinity	None
Divus Berlin	None
Dixon	soundtrack
Dj Adryan Galantucci	None
Dj Alastair Electroradio  Cube	None
Dj Bliss	None
Dj Falcon	house music
Dj Geedubz & Dj Kama	None
Dj Giuly	None
Dj Kama & OEl	None
Dj Kemikal	None
Dj Kent	house music
Dj Keri	None
Dj Klash aka Klashizzle	None
Dj La Luna	None
Dj Magicstorm	None
Dj Never Die	techno
Dj Never Die & NICOB	rap
Dj Nick Harvey	None
Dj Niki	dubsteppe
Dj Noise	None
Dj Phil	None
Dj PorCus	None
Dj Puma	None
Dj RP	None
Dj Raver	None
Dj Reas	None
Dj Robr	None
Dj S20	None
Dj Sam	None
Dj Scream	trap
Dj Skaos all Night long	None
Dj Soulgear	None
Dj Sticka	None
Dj TAG  Tresor  Berlin  TresorBerlin	None
Dj Tony Big	None
Dj Toyo	None
Dj Volta	None
Dj Wutr3e	None
Dj Yan Bruno	None
Dj Zest	None
Djanny	None
Djazzy	disco
Djebali	techno
Djeniz  Waldgeflüster	None
Djerem vs Assym	None
Djerry C	None
Djs	new jack swing
Dododbeatz  Mallow Rec	None
Doeasy Rec	None
Dogukan ires aka Dodolove	None
Dollar Mambo	house music
Doma	hi-nrg
Domenico Dagnelli	None
Domenico Rosa	disco
Dominic	pop
Dominik Auderset	house music
Dominik Eulberg	techno
Dominik Trieb  Suberplastic ag	None
Don Camillo & Peppone	None
Don Ramon	argentine reggae
Don Ramon  Cheeky Choice	None
Don Ramon  Friedas Büxe	None
Don Tetris	None
Don Tetris  subsTANZ be	None
DonDario	house music
Donato Capozzi	techno
Doppelpack	None
Doppelt Gemoppelt	techno
Dorian Paic	techno
Doris Stemmel	None
Dos Secondos	None
Dot	house music
Dottore Monkey Jam  Cube	None
Douala	None
Doublescore  Renesanz Rec & Italo Business	None
Doublewave	house music
DoubtingThomas	techno
Douster	techno
Dr Lektroluv	None
Dr Motte	None
DrPsyche	None
Drauf & Dran	house music
Drea	None
Dready 2	None
Dready2	None
Dream	hip hop
Dreksler&Haerle	None
Dreksler&Haerle live  elektrostubete be	None
Drilon	opm
Dropout Agency	None
Dropout Agency  BE	None
Drumcell	techno
Drumcode	None
Dualism	techno
Dub Tales  Off Mind rec be	None
DubExMachina	None
DubNoir	None
Dubculture  BE	None
Dubfire	techno
Dubfunk	house music
Dubphone	dub
Duckk & Doogood	None
Duell	None
Duff	pop
Dumb Unit  Berlin  Buenos Aires	None
Duo Dumpf	None
DuoRhythm	None
Durdek	None
Durdek & Kubin	None
Durdek & Noromal	None
Dylan Casale	house music
Dynamics	None
Dysonc	None
Dzanin	None
Dzann	None
Dänemark	None
Dürerstuben	house music
E	pop
EGÜ & SIMI	None
ELAY	None
ELECTRONIC FLOOR	None
EM & EM aka Akustik & Martin Baur	None
EM&EM	hip hop
EMETERIA	None
EMMA MYLAN  FIREDOLL	None
EMOK	progressive psytrance
EMRE	turkish pop
ETYPE	None
EXTRASTUNDEN JONATHAN SOLO	None
Earganic	None
East End Dubs	None
East End Dubs Moon Harboour	None
Echo 106	house music
Echoes	meditation
Echonomist Rotary Cocktail	None
Ed Luis	None
Eddie Thoneick	house music
Edgar Jack	techno
Edgar Jack and Marrocco	None
Edison Cabrino	None
Ednaski	techno
Edward	indie
Edward Ean	techno
Eelke Kleijn	house music
Eevy	None
Eff&lle	None
Egü	None
Ehrlich & Redlich	None
Eigenwijs	house music
Ein wachsendes Netzwerk in Sachen Künstler elektronischer Musik Qualität vor Quantität  ein Produkt	None
Einstürzende Neubauten	experimental
Eintakt	None
Einzelkind	techno
Einzig & Faerber	rap
Eisentanz	None
Ekkohaus	techno
Ekserd	disco
El Alusinante	None
El Jesus & ACDJ	None
El Primo	None
El Rey	None
El Rhino	None
El Tigre Sound	None
ElBey	None
Elc	None
Electribe	None
Electric Minority	None
Electrofraise	None
Electromcfly	disco
Electronic	new
ElectronicaBoy	None
Electroradio Crew Alastair & Houserockers	None
Electrosexual	electronic rock
Elektro Guzzi	techno
Elektrobopacek	None
Elektrosized	None
Elevated	None
Elex Morano	None
Eli Verveine	techno
Elle Rêve	None
Ellen Allien	techno
Elliver	None
Elrino	None
Elvis Benait	None
Elvis Cassetta	house music
Elysia Crampton	fluxwork
Em & Em	pagode
Emage	None
Emely	None
Emely& Scum	None
Emendy	rap
Emil Berliner	house music
Emil Teiger	None
Emilie Nana  Reas	None
Eminor	None
Emix	techno
Emmanuel K	None
Emre	turkish
Emre Bektas	None
Emre Bektas b2b Claudio	None
Ena Lind	techno
Endgame	None
EngBang	None
England	rock
Enzo Lo Conte	None
Enzo Pianzola Mauro Capitale	None
Enzo Siragusa	techno
Enzo Siragusa Fuse  London	None
Enzo di Caprio	None
Enzo lo Conte	None
EnzoMrTrendPianzola	None
Ephrem Luechinger	None
Equinox	drumfunk
Erase	riot grrrl
Erasmus & Krieger	None
Eric Borgo	techno
Eric Preston	None
Erik van Drumpt	None
Erol Alkan	hip hop
Ertu & Pushkin	None
Escargot with	None
Eskimo	metalcore
Et Vous	None
Etienne Du Toit	None
Etienne du Toit	None
Etn b2b Matteo Melillo	None
Etruria Beat Showcase	None
Euphoria  CH vs UK	None
Everstone	house music
Everydayz	vapor twitch
Evo & RST	None
Ex Labyrinth	None
Expressions	soul
Extrastunden	None
Extrawelt	house music
Exzentric Showcase by DJ Fergie & Alan Fitzpatrick	None
Ezikiel	techno
Ezikiel  Cadenza extended	None
FABIAN BINKERT	None
FABIO & MOON	progressive psytrance
FABRI MUSIQ	None
FABRi	None
FD	deep liquid bass
FERY	None
FEUERHAKE	progressive psytrance
FICHTRE  Feldermelder	None
FLAVIO	channel pop
FLINKE FINGER	None
FLUX NEBULA	None
FLYING AWAY	None
FRANK BECKERS	None
FRAnk K	None
FREAKY FUNKY BEER DOZE	None
FRED LICCI	None
FREDi Salomon	None
FREEZER	hardcore
FREIBERG elektrostubete bern	None
FREITAG & FREINACHT	None
FRENCH FRIES	techno
FRQNCY	None
Faber	emo
Fabien	None
Fabio Florido	house music
Fabio Gullone	None
Fabio Papa	None
Fabio Riccio	None
Fabio Siverino	None
Fabio Tamborini	None
Fabio Tamborrini	disco
Fabri	None
FabÃ¸	hip hop
Fabø	hip hop
Fact	None
Falda	None
Falling in Love EP	None
False Friends	None
Fantastic Friends  Highgrade  Metroline Limited	None
Fat Sushi	house music
Faul	house music
Faust	classical
Faux Couture	None
Favila & Valentine	None
Feadz	techno
Fedde Le Grand	house music
Federico Molinari	techno
Fedo Mora	None
Feel X	None
Fehlfunktion	None
Feldermelder	None
Felipe & Gusto	None
Felipe Valenzuela	techno
Felix Kröcher	schranz
Felon	house music
Felxibelle	None
Fenomen	hip hop
Feodor	deep opera
Fernando Costantini	techno
Ferrari & Tomasi	None
Feshmint	None
Fever	electronic rock
Fez Momo	None
Fiat Bux	None
Fichtre	None
Fictionizer	None
Figure	rock
Findling	house music
Finn Johannsen	None
Finnebassen	house music
Fion 2000	None
First Claz	None
First Deck	None
Fis	house music
Five Club	rock
Flapjackers	house music
Flash	hip hop
Flavio	channel pop
Flavius Tadeus	None
Flexfab	None
Flexibelle	None
Flieder	None
Flighsh	None
Floating Points	house music
Floor 1	None
Floor 2	hi-nrg
Florian Defunes	None
Florian Kaltstroem	None
Florian Kunicke	None
Florian MSK	None
Florian Schmid	None
Florin	manele
Flowbastard	None
Flowbuster	None
Flux Pavilion	uk garage
Flying Circus	None
Food For Ya Soul	None
Foolik & Pablo Einzig	None
Force of Nature	ambeat
ForecastHUN	None
FormatB	techno
Fourth Kind	None
Frabon	None
FranG	violin
Francesca Lombardo	disco
Francesco Ballato	None
Francesco Mosca	None
Francesco Parla	None
Francesco Tristano	microhouse
Francis Mallo	None
Franck C	None
Franco Bianco	techno
Frango	hip hop
Frango sirion bern	None
Frank C	folk
Frank Sonic	techno
Frank Spirit aka Funk Bastard und Azul Loose Ties	None
Frank Storm	None
Frank Vespari	None
Frank Vespari & Little Victor	None
Frank Vespari b2b Litte Victor	None
Franky	None
Franky Fiction	None
Franky Fourfingers	None
Franz Bianchi	None
Franz Filter	None
François K	house music
Frau Hug & Samsara	None
FreakBoutiqe	None
FreakBoutique	None
Freaky Charly	None
Freaky Charly & Oscar Niczzo	None
Fred Hystère	None
Fred Licci	None
Fred Lilla	big room
Fred Linger	disco
Freddi Hintenaus	None
Freddjset	None
Freddy Verano	house music
Fredi	None
Fredi B	None
Fredi Salomon BunkerLe Local	None
Fredomat	None
Fredomat & Herr Mehr	None
Fredy S	rock
Freedom Fighters	trance music
Freiberg	None
FreiburgDE	None
Freitag 06042012	None
Frenchwork	None
Fresh n Loud  SO	None
Freshmint	None
Fretzki	None
Friday	punk christmas
Friedas Neffe	None
Friede Freude Freitag	None
Friendly Entry 25 CHF	None
FriendlyFire	None
Friends	emo
Fritz Kalkbrenner	house music
Frivolous	techno
Frogoroth	None
Frohlocker	funky breaks
Frontlin	None
Fukuro	None
Fulvio Cala	None
Fulvio Calà	None
Fumiya Tanaka	techno
Fun&Floor is a clubnight which takes place every 2nd saturday of the Month in Hacienda Sierre	None
FunkYaMind	None
FunkinEven	disco
Funky Warmup inkl PingPongRundlauf	None
Funkyamind	None
Fuse  Berlin	None
GARDEN	rock
GD	k-pop
GENER8ION	escape room
GHETTO PO	None
GIL live	None
GIRL	mashup
GL Everest	None
GL Everest and guest	None
GLITTER	rap
GOA FLOOR	None
GOGO MUSIQ	None
GREG & FREAZA aka THE HEAVYHITTERZ	None
GRÜNES BLAU	None
GS	None
GSN BE	None
GaLaBar	hip hop
Gabriel Ananda	techno
Gaggiolo confineCH	None
Gaiser	techno
Gaiser Minus live	None
Gallo	None
Garance	techno
Garance  Reas	None
Garance & diSoul	techno
Garibovic	disco
Gary Beck	techno
Garçon	None
Garçon Sauvage	None
Gaspard de La Montagne	techno
Gatasanta & Art Vega	None
Gayle San	schranz
Geepunkt	None
Gel Abril	techno
Gelivan	downtempo
Gelivan & Yan Sebastian	downtempo
Gemini from Pyra all Stars	None
Geneva	grave wave
Genf	None
Georg Stuby Naturklang  Zürich	None
George Lamell	None
George Morel	disco
Gera	None
Germany	indie dream pop
Geronimo  Flinke Finger	None
Gerry Fresh	None
Get Funky  BE	None
Get Physical	None
Get Physical  NL	None
GetBuzz	None
Ghetto Po	None
Ghetto Po 237CH	None
Ghettophiles	None
Ghettopo	None
Ghost	metal
GhostlyUS	None
Giacomo Lombardo	None
Gianlukino	None
Gianni	None
Gianni & more	None
Gianni Callipari	disco
Gianni Parrini  Rimini  Italia	None
Giardino Unplugged with	None
Gibbz	vapor soul
Gibraltar Vacuum	None
Gibraltar Vacuum live	None
Gill & Gill	None
Gilles Peterson Worldwide Festival Talent Search 2009	None
Gin Tonic Soundsystem	None
Gio Amenkov	None
Giorgia Angiuli	techno
Giorgio Maulini	techno
Giovanni Verrina & Germano Ventura Aka Howl Ensemble	rap
Girl	mashup
Giulia Paradiso	hardcore
Giuly	hardcore
Giuseppe Visciano	techno
Giusi Consoli	None
Giusy S	None
Gleichschritt	None
Gleichschritt esance  grundton ZURICH	None
Gobbit	None
Goetzlich	None
Gogo	jazz
Goldfinger Brothers	hip hop
Goldfrapp	electronic rock
Goldoni	None
Gomorra	techno
Goose	children's music
Gordan Starr	hip hop
Gorgon City	house music
Graf Olaf	None
Graf Olaf & Karl Gustav  Rina Lou  Thom Mayr	None
Gramatik	downtempo
Gravina	techno
Gravina & Omar	rap
Gravina & omar	rap
Gray Chalk	None
Gray Gravity	None
Greeen & Moeraki	None
Greg Iaia	None
Greg Iala	None
Greg la Brelle	None
Gregorythme	techno
Gregrythme	None
Groove Junkies	house music
Guel	None
Guest de Berlin	None
Guillaume Delattre	hip hop
Gunnar Guess	house music
Gurtz	dub
Guti	disco
Guy Joshua	None
Guyus	uk garage
Guzy	None
Guzzle	None
Gynesh Bakir	None
Gypsis	None
Gypstrip	None
HANZ BEATER tanz	None
HECTOR DMB b2b ALEX ANDER	None
HERMANSSON & MARTINEZ	None
HERR LIEBE & LEATHERETTE	None
HERR TERZ	None
HERTS	None
HOBI	disco
HOBO	None
HOSH	techno
HOSH  Diynamic Rec	None
HUMAN ELEMENT	progressive psytrance
HVOB	house music
Hallenstadion Foyer	None
Hallenstadion Frontline  Hardstyle	None
Hallenstadion Mainfloor Arena	None
Hallenstadion Rang 1  Trance Floor	None
Hallenstadion Rang 2  House Electro I	None
Hallenstadion Sound Restaurant  House Electro II	None
Hallenstadion Storage Ost  Hotter Than Hell	None
Hamburg	None
Haneef Raisani	None
Hang	new tribe
Hanne & Lore	house music
Hans Bouffmyhre	techno
Hans Jung	techno
Hansim Glück	None
Hardcore Masterz Vienna	hardcore
Hardly Booked	None
Haya Mottarek	None
Haydn	classical
Hazzard Boys	None
Heartleader	None
Heartthrob  Mnus	None
Heartthrob Minus live	None
Hecht&Zander	None
Hector	tropical
Hector Couto	techno
Heidi	country
Heidi  Get Physical	None
Heiko	coverchill
Heiko MSO	house music
Heimat	hip hop
Heimat Peer Kusiv	None
Heimlich Knüller	None
Helder	house music
Helder b2b Joram	None
HeliOn	None
Hemmann & Kaden	techno
Henning Richter	hip hop
Henrik Schwarz	techno
Henry Clausen	None
Henry Pass	None
Henry Sure	None
Hepp live	None
Herman	show tunes
Hermanez	techno
Hermansson & Martinez	None
Hernan Cayetano	None
Herodot	disco
Herr Mehr	None
Herr Meyer & Sentio	None
Herr Mueller	None
Herr Müller	None
Herr Vogel	None
Herrrouine	None
HerzblutEdinburgh	None
Herzschwester	techno
Herzschwester  Gelbes Billett Musik	None
Herzschwester & Thom Nagy	techno
Heval	electronica
HiGY	None
Hidden Peaks	None
HighLive	None
HighLive & Gravina	rap
HighLive Miniload BS	None
Highgrade	jump up
Highgrade Afterparty	None
Highgrade Disharmonic Orchestra	disco
Highgrade Rec	None
Highlife	None
Hiivemind	techno
Hinde BE	None
Hive	indie poptimism
Hive Audio	None
Hive Audio  ag	None
Hobo  Mnus	None
Hobé D	None
Home Park	disco
Honey Dijon	house music
Honoree	techno
Horasse	None
Horizontal  Chile	None
Hos & Pacoco	None
Hot Jam	None
Hot Waves	None
House	None
House & Tech House	None
House Rockers Electroradio  Cube	None
HouseElectro	None
HpsyV aka Infinity LIVE	None
Hraach	house music
Huazee	None
Hug & Schiemann	None
Hugel	None
Hugo Mendez	None
Hypnotic	afrobeat
I	hip hop
I am Frost	techno
IG Culture	breakbeat
IGGY	pop
IL	opera
INMIND	None
INSTINCT	hardcore
IROO	None
ISAbella Maison DEtre	None
IT	rap
Ibiza	house music
Ich & Du	None
Ida Daugaard	None
Idealist	ambient
Igor	classical
Igor Blaska	None
Igor Blaska & The Mad Family	None
Igor Blaska feat Lik &	None
Ikonika	uk garage
Ilona Maras	None
Impact	None
Imperial Tabasco	None
Imperial Tiger Orchestra	ethiopian pop
In list con drink chf 25   20	None
Infinity	None
Info Liste Prenotazione Tavoli	None
Ingo Boss	hip hop
Ingrid aka Adrian Bergmann	None
Ink	pop
Ink aka Nik	None
Ink aka Nik dj	None
Insane	rap
Inside Floor	None
Inspiration	None
Instant Rave	None
Intro by Andersen	None
Intro by Meschuggo	None
Intro by Rocca & Dineo	None
Invincibile	None
Iokoi	None
Ion Ludwig	None
Isidore	None
Ismail & Clive	None
Isolated Lines	techno
Italoboyz  Marco Donato	None
Italy	None
Itiswhatitis	None
Ittetsu	None
Ivan Alvarez	None
Ivan R	None
Ivo Christow	None
Izia  The Chase	None
J ROCC	hip hop
J Sayne	None
JACKSMIN	None
JAKSMIN	None
JAMES MC HALLE tanzkarrusell bern	None
JASHARI	None
JCUSH	None
JD	new americana
JD Hakulinen	None
JESSE JAY	rock
JEUDI Records	None
JKin	None
JNS DJ Team vs Execute DJ Team	None
JOHN CATALANO	None
JOHN MAD & NORA	None
JOHN TAALSBERG	None
JOHNNY B	None
JOHNNY QUEST	kc indie
JOHNY BLAZE	None
JOKER	trap
JONE & Max Nero	None
JOSEPHINE DE PARIS	techno
JOSHUA	pop
JOSKO ANTEK	None
JP Chronic Ibiza	None
JPTR	None
JR	hip hop
JSayne	None
JSebK  many more	None
JUNKSOUND MOVEMENT	None
JUTZI	None
Jack & Jus	None
Jack & Juus	None
Jack & the Jerk	None
Jack Jenson	None
Jack Pattern	techno
Jack Teck	new tribe
Jacqui	jazz christmas
Jacqui  MiniShake Music  Sion	None
Jagged	pop
Jaime Fiorito	house music
Jake the Rapper	house music
Jam City	house music
Jam Janiro	None
Jam On	None
Jama Deejay	None
Jame Mc Hale	None
Jame McHale	None
James Mc Hale	None
James Pants	idm
James Taylor	rock
Jamie Jones	techno
Jamie Lewis	house music
Jamie White	techno
Jan Krueger	None
Jan Penarrubia	techno
Jan Schulte	None
Janiz	None
Jashari	None
Jaso LIVE	None
Jauss	None
Javier Moreno	house music
Jax	house music
Jaxon & Emre Bektas	None
Jaxson Owens	None
Jay Joe	None
Jay Mas	None
Jay Phonic	techno
JayJo	None
Jaybee feat Sandman & Appenzeller SängerFREUNDe	None
Jazzanova	downtempo
Jean Baptiste	renaissance
Jean Toussaint	None
Jecko Kay	None
Jeem Collins	techno
Jeem Collins Feection	None
Jeff Swing	techno
Jeff Swing  Dan Lagardere  Ken Wan  Little  Big T	None
Jelipe Jalapeño	None
Jem Haynes	house music
Jena	idol
Jennifer Cardini	microhouse
Jeremy De Koste	house music
Jeremy P Caulfield pres UNIT  dumb unit	None
Jerry Joxx	None
Jessica Diaz	None
Jestics	None
Jevne	house music
Jewl	None
Jimi Jules	disco
Jimi Jules Hive Audio  Bern	None
Jinxx b2b Muck	None
Joachim Spieth	disco
Joe Feretti	None
Joe Ferretti	None
Joe Galen	None
Joe Janell	None
Joe Mckechnie	house music
Joe Mckechnie & Will Sergeant	rap
Joe T Vannelli STAR DJ	None
Johannes Heil	techno
Johannesburg	None
John &	rock
John Boston	None
John Clats	None
John Dimas	house music
John Lemon	techno
John Lemon The Darkroom  Zürich	None
John Morales	hip hop
Johnita Lemonetta	None
Johnny Bossco	None
Johny Blaze	None
Jokari	disco
Joker	trap
Jolly Buoy	None
Jon Donson	techno
Jon Kennedy	downtempo
Jonas Kopp	techno
Jonny Miller	breakbeat
Joram	disco
Joris Belzin	None
Jorven	None
Jose Maria Ramon	hip hop
Jose Parra	flamenco
Josephine	cabaret
Josephine de Paris	techno
Josh Wicks	None
Josh Wink	techno
Josè Parra	flamenco
José Parra	flamenco
Joxx	None
Js  Acts	None
Juan Veloz	None
Juanjo Martin	electro latino
Jubairo	None
Juen	None
Juen & Bach	None
Juicy Lucy	rock
Juke Trax	None
Jukebox Champions	None
Julian Hansmeier	None
Julian Jeweil	techno
Juliano Lopez	disco
Julien	chamber pop
Julien Aubert	None
Julietta	vapor soul
Julius Abel	house music
Jun Akimoto	hip hop
Jun Akimoto Fuse  Kyoto	None
Junior B	None
Junior Boys	electronic rock
JuniorC	None
Junksound live	None
JusEd	None
Just Music  23 febbraio 2013	None
Jutzi	None
Jutzi  subsTANZ be	None
Jutzi & Don Tetris	None
Jutzi b2b Maximilian berg	None
Juzz	disco
Jørg  Jon Donson	None
Jørg aka Jon Donson	None
KAI HILLMANN	None
KALEID feat Electrosexual & DORIAN E	None
KENHOBIZ	None
KENT	trap
KISS ROOM	None
KK3D	None
KKToy	None
KLAUS	techno
KLOPFGEISTER	techno
KONPIUTA LIVE	None
KONPIUTALIVE	None
KRamba	None
KULARIS	progressive psytrance
Kaan DÃ¼zarat	None
Kaan Düzarat	None
Kablam	fluxwork
Kackmusikk	None
Kai Alce	house music
Kaiser & Giraffe	None
Kalabrese	house music
Kalmou	None
Kamil Pawel	None
Kantarik	hip hop
Kaosbrothers  T wie Techno	None
KaraMaehl	None
Karan Shah	techno
Karera	None
Karl Gustav	None
Karl Knatter	None
Karl Van Hinten	None
Kate Simko	techno
Kate Simko Get Physical  LONDON	None
Kater Blau	None
Kater Holzig	None
Kater HolzigBerlin	None
KaterBlau	None
Katermukke	None
KatermukkeBerlin	None
Katsching Kollektiv	None
Katta	None
Keen	country
Keith Worthy	None
Kejeblos	None
Kellerkind	house music
Kellerkind  stil vor talent  bern	None
Ken Wan	house music
Kenel & Sonne	None
Kenel & Sonne Arche  Zürich	None
Kenjiro Ultramagnetic	None
Kenny Ground	house music
Kens	deep gothic post-punk
Kerri Chandler	house music
KevKev	None
KevKev & Mahlermeister	None
Kevin Shala	techno
Khaderbai	abstract beats
Khainz	progressive psytrance
Khidja	house music
KiMi	None
Kiara Records Spain	None
Kid Fonque	None
Kid Konzoom	None
Kid Silly	None
Kiki	mellow gold
Kim Prevedello	hip hop
Kindimmer	techno
Kinky Beats	None
Kiril Bikov	None
Kiste	None
Kittie	metal
Klang	disco
Klang Architekt	None
KlangFormer	None
Klangwelt  Geneve	None
Klaus	techno
Klico  Freakouts	None
Klischee	electro music
Knor	None
Knowbru Innocent Music	None
Knäckebröd	None
Kodbar	None
Koko Chanel	None
Kolbe	None
Kollektiv KlangGut	house music
Koma dub	None
KompaktSão Paulo	None
Komplex 457	None
Komsomol	None
Konrad Dycke	None
Konstantin Sibold	techno
Kopfkino 3D	None
Koreless	uk garage
Kormac	electro music
Kornél Kovács	house music
Kortex	None
Kosta Dee	deep freestyle
Kotelett&Zadak	None
Kraftwerk	rock
Kratermann	None
Kreuzton	techno
Krill Music	None
Kriss Toff	None
Krono	house music
Kruse & Nuernberg	disco
Kruse & Nürnberg	None
Kufanya	None
Kuhlmann	deep pop edm
Kumquat	None
Kun	None
Kunstraum Walcheturm  Kanonengasse 20  8004 ZÃ¼rich	None
Kunstraum Walcheturm  Kanonengasse 20  8004 Zürich	None
Kurilian	None
Kurilian Kratz	None
Kutmah	idm
Kyrill & Redford	groove room
Kåre Kyl	None
Kölsch	house music
König Balthasar	None
LA BAAZ	progressive psytrance
LA BIONDA	None
LA LUCIOLE	None
LA MINE EXPRESS	None
LABO M	None
LAD	disco
LAIKAN	None
LAIN  techno merveilleuse	None
LAMPENFIEBER	None
LARA feat Babag&Cholon	None
LASSMALAURA Katerholzig	None
LCAW	house music
LCP	None
LEE  O	None
LEE N EFFE	None
LEEO	None
LEONARDO	cantautor
LEWIS	None
LFT live	None
LINE UP	None
LITTLE D	None
LIVE	christian christmas
LIVE ARTISTS	None
LIVE AT SET	None
LIVE Alessandro Parisi	None
LIVEACTS	None
LNF	hip hop
LOUH	None
LOUISAHHH	techno
LS & Massuro Takashi	None
LUBØMIR & CRANG	None
LUCA GEROSA	None
LUCKY	rap
LUCKY PAUL	disco
LUFT	techno
LUIS RODRIGUES	accordion
LUKE SANTOS	None
LVNDSCAPE	house music
LVis 1990	None
LXIR	None
La ForÃªt	None
La Forêt	None
La Forêt  TT  TONY DA	None
La Luciole	None
La Mine Express	None
La Vitamina	None
La mine express	None
La soirée aura lieu au parc des Bastions	None
Labaaz	techno
Lady BarAcquaCabaretLove Tempo	None
Lady Boop	None
Lady NooN	None
Lady Noon	None
Lady Noon vs De Feo	None
Lain	None
Lakuti	None
Lampert	None
Lando	techno
Laolu	techno
Lara Valentina	None
Larry	regional
Larry King	None
Lars Moston	house music
Larytta	hip hop
Laser Lele	None
Lauhaus	techno
Lauren Lo Sung	None
Laurent Bovey	hip hop
Laurent Charbon	hip hop
Lausanne	None
LausanneBerlin	None
Layfar	None
Lazare Hoche	house music
Le Baron	house music
Le ChatMan	None
Le Citadin	None
Le Frère	None
Le Noir	soukous
Le Petit Lutin	None
Le Peuple de lHerbe	dub
LeLe	None
Lebensfreude	None
Lee Burridge	house music
Lee Burridge  All Day I Dream	None
Lee Curtiss	techno
Lee Gamble	techno
Lee Jokes	disco
Lee Van Dowski	techno
Lee Webster	techno
Lefto	hip hop
Leftroom  Us	None
Lega 237RU	None
Lehar	romantic
Leke da Loco	None
Lemonick	disco
LennixMusic	None
Leo	house music
Leon	rock
Les Diplomates	None
Les Puppetmastaz	None
Les Round Table Knights	None
Les petits pilous	techno
Lesnicar	None
Letabli	None
Leventino	None
Lexer	house music
Lexx	disco
Liam Butler	None
LichtDEFEKTE von Van Nutt	None
Liebkind	None
Liittle Lu	None
Lil Silva	uk garage
Lilith	spanish punk
Line up	None
Lineup	None
Lineup Indoor  Mainfloor	None
Lineup Open Air	None
Ling & Mexx	None
Lionel Stephan D	house music
Liquid Soul	trance music
Little	pop
Little Ernie	None
Little Helpers  London	None
Little Lu	None
Little Lu b2b Jon Donson	None
Little Victor	None
Liv Stone	techno
Live	christian christmas
Live Act	None
Live Digitalism  Gus Gus  Lexy & KPaul  The Advent  Dapayk & Padberg  Dusty Kid  Heartthrob  Einzelkind	None
Live Elekfantz	None
Live Familie Schweizers Wohnzimmer	None
Live Gui Boratto	None
Live Jagged	None
Live Lcio	None
Live Nick Dow	None
Live Pitsch & Magnano	None
Live Umami	None
Live Visuals by Blauton	None
Live areage	None
LiveVisuals on 3 Screens by BHD	None
Livia Moretti voice	None
Livingroomfm	None
Livio & Roby	techno
Lo mid High	None
Lo2	None
Lobe Records	None
Lobi Rodio und Kelstroem	None
Local Support	None
Lolo	indie poptimism
Lolo & Romeo	None
London	classical
LondonBarcelona	None
LondonNYC	None
LondonNew York	None
Look Like	house music
Lord Kesseli & The Drums	None
Lorenzo Gangi	None
Loris Scaglia	None
Los Cruzeiros	hip hop
Los Suruba	disco
Los Vacios de Charly	None
Los Wenamigos	None
Los Wenamigos & After party w Alex Niggemann	rap
Los dos	deep regional mexican
Louh	None
Louh Punkt  Zürich	None
Louie Liköör	None
Louis Brown	None
Louisahhh	techno
Lovers	rock
Low Jack	house music
Low Tales	house music
Lowrel & Hardy	None
Lowris	hip hop
LuLúxpo	None
LuLúxpo La Forêt	None
Luc G	None
Luca Agnelli & Marco Faraone	house music
Luca Barletta  Oliver von Mentlen	None
Luca Fari	None
Luca Fiorelli	None
Luca Gerosa	None
Luca Leiser	None
Luca Lozano	disco
Luca Parravicini	None
Luca Rinardi	None
Luca Torre	techno
Luca de Grandis	None
Lucas MonÃ¨me	None
Lucas Monème	None
Lucas Ramirez	None
Lucerne	None
Luciano	adult standards
Luciano b2b Carl Craig	None
Luciano b2b Ernesto Ferreyra	None
Lucidflow  Be	None
Luciover	None
Lucky	rap
Ludovic B	None
Lui Young	techno
Luis Cruz	None
Luis Roza	None
Luiz & Winth	None
Luk	estonian pop
Lukas Kleesattel	techno
Lukastel	None
Luke Redford	None
Luki	None
Lukie Wyniger aka UNCLE PENG PENG	None
Lukie Wyniger aka Uncle Peng Peng	None
Lukino	disco
Luluxpo	disco
Lumpex	None
Lurob	house music
Lynda Phoenix	breakbeat
Lützenkirchen	techno
MA	trap
MAHMOOD	None
MAIN Room	None
MALEKOS BEUTEL & AMARU	None
MANDY	pop
MANDY  Get Physical	None
MANDY  Patrick	None
MANFLY  MANDY	None
MANIAK	None
MANON	techno
MANON desolat züri	None
MANU	world
MANUEL VOCK	None
MANUMAL	None
MAPUSA MAPUSA	None
MARC BENZ	None
MARCO NAVARRO	None
MARIE PRIEUX	None
MARKO BLAZE	None
MARLON	None
MARQUE AUREL & MUSIC P	None
MAS RICARDO	None
MASSIMO GERARDI	None
MATHIO	None
MATIJA	None
MATT MANIK	None
MATTIØ & AVA	None
MAUA	None
MAUDITE & LE HORLA	None
MAURO CAPITALE  Enzo Pianzola	None
MAURO VILLAREALE	None
MAUVE	None
MAX CELLI	None
MAX KLEBSON	None
MAXTER	None
MAY KAY pincode  minimalmood BELLINZONA	None
MBP	None
MC Delinquent aka Waterboy	None
MC Honeybrown	None
MC Jay	None
MC2	None
MDMO	None
ME & her	rap
MELON	rock
MGness	techno
MIA MILANO	None
MIA tanzkarrusell mulhouse	None
MIDIMAL	progressive psytrance
MIGL	None
MIGUEL	hip hop
MIK MAROO kumquat ZURICH	None
MIKE FATAL & NIKA NIKITA	None
MIKE MUFF	None
MIKE T	deep pop r&b
MIKE VÄTH  Gon Records zh	None
MILK RESIDENTS	None
MILLIVOLT	None
MINIMALLOUNGE	techno
MINITECHHOUSE FLOOR	None
MIRCO CARUSO	hip hop
MIRCO MENDOSTA	None
MISS DUCKIN	None
MISS VIVIAN KANT	None
MITEINANDER MUSIK	None
MOHORIZONS	None
MONICA DIAS	None
MONSIEUR P & MADFUNK	None
MOON	pop
MR ROX & MR SIMON	None
MRJUKE	None
MRTREND	None
MRux	disco
MTDF	house music
MXR	None
MaMe	None
Maalva Cruz	None
Maayan Nidam	techno
Maceo Plex	house music
Macromism	techno
Mad House  USA	None
Mad Resident	None
Madame Kenel live	None
Maddslinky	breakbeat
Madfunk & Reas	None
Madhouse Records	None
Madmotormiquel	house music
Madnax	techno
Mado	None
Madteo	house music
Madwave	None
Maertini Broes DJ Team  more	None
Maetrik	techno
Magda	techno
Magic Mixers	None
Magicstone	None
Magit Cacoon	disco
Mahlermeister	None
Maho	None
Maickel Esse	None
Maickel Esse AKA Inlunius Locus	None
Main Floor	None
Main Room	None
Mainfloor	None
Makam	None
Makau	techno
Makossa & Megablast	disco
Malente	breakbeat
Malicious Joy	None
Malik	pop
Mambo Chick	None
Manaré	techno
Manege 8  Berlin	None
Maniac Man	None
Mannheim	christmas
Manon	techno
Manu Chaman	disco
ManuHeme	None
Manual  Terminus	None
Manuel Fischer	None
Manuel Mind	None
Manuel Moreno	None
Manuell	hip hop
Manuelle Music	None
Manuelle Musik	None
Manuheme	None
Many More	None
Mar Dean	None
Marc Benz	None
Marc DArrigo	techno
Marc Evans	house music
Marc Fuhrmann	None
Marc Maurice	None
Marc OTool	None
Marc Romboy	techno
Marc dArrigo	house music
MarcIntosh	None
Marcel Dettmann	techno
Marcel Fengler	techno
Marcel Hofer	None
Marcio	None
Marcism	None
Marco Bailey	techno
Marco Basso	None
Marco Battagliero	None
Marco Capone	None
Marco De Rosa	house music
Marco Effe	hip hop
Marco Folli	None
Marco Navarro	None
Marco Nea	None
Marco Repetto	None
Marco Repetto & Mastra Live	None
Marco Repetto live	None
Marco Resmann	techno
Marco Rossi	None
Marco Serra	None
Marco Tegui	None
Marco Trinkler	None
Marco Vertoner	None
Marco Zenker	dub
Marco da Mata	None
Marcos	house music
Marcos Del Sol	None
Marcos del Sol	None
Marcow	None
Marcus Intalex	drum and bass
Marcus Meinhardt	house music
Marek Hemmann	techno
Margaret Dygas	dub
Maria Blessing	None
Marika Rossa	techno
Mario Ferrini	None
Mario Zar	None
Mark Ernestus	fluxwork
Mark Fanciulli	disco
Mark Lemigton	None
Mark Lemington  DB  Voltec  Flavius Tadeus	None
Mark Seven	disco
Mark Steven	disco
Mark Stone	None
Mark de CliveLowe	None
Markova	opm
Markus Fix	techno
Markus Homm	techno
Markus Homm & Mihai Popoviciu	house music
Markus Kenel	house music
Markus Lindner	techno
Markus Lindner  Cityfox	None
Markus Lindner  Stadtpark	None
Markus haZe	None
Marlon	None
Marocco	None
Marosh Kopp	None
Marque Aurel	None
Marrocco	None
Martelli	channel pop
Martin Baur	techno
Martin Baur Index  Underdog Luzern	None
Martin Buttrich	techno
Martin Eyerer	techno
Martin Landsky	techno
Martin Meier	None
Marvin & Guy	rap
Marwin	None
Mary Jane	funk
Mas Ricardo	None
Masa	house music
Masaya	hip hop
Masomenos	techno
Massive Jay	None
Mastra	deep
Mastra Live	None
Mastra live	None
Matador	francoton
Mater Fader	None
Materia	house music
Mathew Jonson	techno
Mathias & Andreas	None
Mathias Kaden	techno
Mathias Mesteno	techno
Mathieu Barnaby	None
Mathieu Raetz	None
Matija	None
Matjia	None
Matrixxman	house music
Matt Grey	None
Matt Manik	None
Matt Prehn	disco
Matt Tolfrey	techno
Matteo Arcucci	techno
Matteo Arcuccit	None
Matteo Melillo	None
Matthew Burton	techno
Matthew Styles	house music
Matthias Tanzmann	techno
Mattia Presta b2b Sthepan Esse	None
Matto	electronic rock
Matto Belmondo aka	None
Mattoo	techno
Maty Palc	None
Maurice n Morris	None
Mauy	None
Max	pop
Max B Grant	hardstyle
Max Bragantini aka Max B	None
Max Buchalik	house music
Max Klebson	None
Max Orian Vs Rob Dolder	None
Max Parker	None
Max Robbers	None
Max Tundra	None
Max Wanderer	None
Maximilian Berg	None
Maya Jane Coles  hypercolour  mobilee  London	None
Maybe	None
Me Dro	None
Meander  Nl	None
Meester Krizz	None
Megablast	None
Mehmet Aslan	house music
Meikel	techno
Mel Nagelbein	None
Melchior	garage pop
Membrane	covertrance
Memnok	techno
Memoria  Belgium	None
Mendo	house music
Mercury	rock
Mescene	None
Mess Me	electro trash
Messiah	reggaeton flow
Metaphysical	hip hop
Mia	pop
Mia Kaltes	None
Mia Kaltes  Finefood Records  Switzerland	None
Miajica	disco
Miau Studio Floor	None
Mic Drive	None
Michael Deep	house music
Michael Fate	None
Michael Fresh	None
Michael Gull	None
Michael Seelenruhig	None
Michael Vonplon	None
MichaelPfister	None
Michal Ho	None
Michel Cleis	None
Mick Sick	None
Mickail	None
Mickey Morris	None
Micky Monzza	None
Midnight Operator	hip hop
Midnight Pulse	disco
Miett	None
Miguel	pop
Mihael Simic	None
Mihai Popoviciu	house music
Mihajlo K	None
Mihigh	techno
Mike Dyson	None
Mike Huckaby	house music
Mike Kay	None
Mike Khoury	techno
Mike Machine	None
Mike Steez	None
Mike Teixeira	None
Mike Vamp	None
Mike Väth	None
Mike Väth  Audionatica  Dreksler & Haerle  Dub Tales	None
Mike Waulie	None
Mil Waukee	None
Milk Klub resident  Geneva	None
Millivolt	None
Milo Häfliger	None
Milos D	None
Milosz	None
Mimmo	None
Min	pop
Mind Against	techno
MindX Snowman	None
Mindfuture	None
Mini Bashekim	None
Miniload	None
Minimat & nanard	techno
Minimo Imprint	None
Minishake	None
Minus 8	downtempo
Mio Martini	disco
Mira	classical
Mira & Chris Schwarzwälder	techno
Mirax	None
Mirco	house music
Mirco Caruso	hip hop
Mirco Many	house music
Mirco Mendosta	None
Mirco Niemeier	house music
Mirko Caruso	None
Mirko Loko	techno
Mirko Loko  Cadenza	None
Mischkultur	None
Mismo	None
Mismo Konzum  Hive  Minirampe  ZH	None
Miss Flora	house music
Miss Flower vs JudgAnn 20 Years Of Hardcore Special Anniversary Cut A Kaos vs LemX The Massacre vs	None
Miss Loira Louca  Freakouts	None
Miss Ly One	None
Miss TessX & Emo	None
Missill	None
Mit Spezial Acts leider dürfen wir die namen noch nicht Publizieren da die Acts auf den Officiellen Streetparade Stages spielen werden und als surprise am abend noch bei uns feiern und auflegen werden	None
Mit dabei sind die talentierten Locals Francesco Parla	None
Miteinander Musik	None
Mixhell	techno
Miyagi	house music
Mln	None
Mme Trash	None
Moan  Miami	None
Mobilee	None
Mobylette	None
Mobylette b2b Soivé	None
Moderat	electronic rock
Modestino & Ed Luis	None
Modnar	None
Modular Club	None
Modulaw	None
Mon Mec & Jean Charles de Monte Carlo	None
Money B	None
Monica Dias	None
Monika Kruse	techno
Monkey Freaks	None
Monkey Safari	deep
Monocline  Planet Rhythm	None
Monoloc	techno
Monoplage	None
Monoplage & ECO	rap
Monoteque	None
Monotox	None
Monowatt live	None
Monpetitponey	None
Montagmorgen	None
Monte	None
Moomin	house music
Moon	pop
Moonharbour	None
Moosfiebr	techno
Morard	None
Morbid Sound	None
Mord Fustang	uk garage
Mordax	house music
Moresounds	hip hop
Morgan Tomas	techno
Moro & Floro	None
Morphine records  live	None
Moscoman	house music
Mosso	None
Motor City Drum Ensemble	techno
Mount Kimbie	electronic rock
Mountain People	techno
Mouse On Mars	intelligent dance music
Mouseen	None
Mouseen & Dejan	None
Mouseen & Denny	None
Mr Friction	None
Mr Hobbs	None
Mr Jonk	None
Mr Pnk	None
Mr Rod	None
Mr RoxOn & Simon	None
MrDaNos	None
MrFiction	None
MrLucky	house music
Ms Hyde  Fabelhaft  Lady Bruce & YaYa	None
Mucho Stylez	techno
Mukatsuku	None
Multitask	None
Mumdance	fluxwork
Murciano	house music
Murphy	rap
Mushrooms Project	house music
Music From Memory  Amsterdam	None
Music P	disco
Music selected by	None
Mynightlifefm	None
MÃ©diateur Electronics  F	None
MÉNAGE À TROIS	None
Mäx Varano	None
Médiateur Electronics  F	None
Möggli French Kitchen	None
Möwe	house music
München	None
NADER	techno
NAHSTER ONER	None
NALAYA BROWN	None
NATRON	technical
NDKj	techno
NED ONEAL	None
NEIGHBOUR GUIZ	None
NEMO	rock
NESHA	None
NEW YORK	None
NEWCOM	None
NEXOS	None
NGOC LAN	vietnamese pop
NHKKoyxen	None
NICED	None
NICKY F	None
NICO MASSA	None
NICOLA SIMIONATO	None
NIK	rock
NIK BÄRTSCH	fourth world
NIKOLA KOTEVSKI	None
NINETOES	techno
NIP	rap
NL	house music
NOIA Italy	None
NORBERT DAVENPORT & MGJ	None
NTO	hip hop
NU	kompa
NUKEM	rock
NYC	beatdown
Naca	None
Nader	techno
Nahoma	None
Nahste Oner	None
Nakadia	techno
Naomi Bowler	None
Nastia	None
Natalia	rock
Natch	techno
Natch & Ruben Coslada	rap
Nath	None
Nathan Fake	techno
Naturklang  Zh	None
Naughty Neigbours	None
Naxxos	house music
Neamatiques	None
Ned O Neal	None
Neekee	None
Neevo	None
Neil Landstrumm vs Bill Youngman	None
Nekow	disco
Nektar	rock
Nelson De Jesus	None
Nelson Garcia	dominican pop
Nemo	rock
Nemo  All Night Long	None
Nemo & Etienne Du Toit	None
Nemo & Etienne du Toit	None
Nemo and Friends	None
Nemok6	None
Nenad J	None
Neon Golden VJ	None
Nervös	rap
Neto	regional mexican pop
Neutronix	None
Neverdogs	techno
Neverending	canadian indie
New York	None
New York  Glasgow	None
Ngly	house music
Ngoc Lan	vietnamese pop
Nguzunguzu	fluxwork
Nice Nine	None
Nici Faerber	hip hop
Nici Faerber & Dani Nydegger	hip hop
Nici Faerber & Herr Müller	hip hop
Nici Faerber Miteinander Musik  Zürich	None
Nick Curly	house music
Nick Nasty	house music
Nico	pop
Nico Faerber	None
Nico Lahs	disco
Nico Mariani	None
Nico Massa	None
Nico Pusch	house music
Nico Stojan bar25 berlin	None
Nico Sun	None
Nicola Kazimir	disco
Nicola Kazimir Punkt  Zürich	None
Nicola Koch	house music
Nicola Koch  Amaro  Flavio Calzado  Corpataux  KlangFormer  Pedro Pereira	None
Nicola S	None
Nicola Zoli	None
Nicolaj	None
Nicolas Duvoisin	disco
Nicolas Haelg	house music
Nicolas Ruiz	disco
Nicole Moudaber	techno
Nicolike	None
Niconé & Sascha Braemer	house music
Niels van Gogh	techno
Nightshift	None
Nik	rock
Nik Frankenberg	None
Nik Weston	breakbeat
Niko Schwind	deep
Nikola Kotevski	None
Nikola Kotevski& Patrick Podage	None
Nikolaj Tange Lange	None
Nikolas Haelg	None
Nils Fraser	None
Nils Hoffmann	deep
Nima Gorji	techno
Nimmersatt	None
Nina Kraviz	techno
Nina Nana	None
Ninette	None
No list con drink chf 30   25	None
Nobodys Perfect	None
Noel Audio	None
Noiiises	None
Noir	hip hop
Nole	None
Nolè	None
Nolé	None
Nonsdrome	None
NorbertTo	None
Norbertto	None
Nordstern	None
Noromal & Durdek	rap
Noromal & Durdek & Kubin	rap
Norway	rock
Nous	house music
Nous mettre feu à Usine On reprend la vieille équipe et on rajoute du poivre et du piment dans la vodka Paf  Soirée bien corsée en perspective pour les fans de drumnbass avec le rebelle pirate DJ Das	None
Nova Materia	None
Noé Weigl	None
Nu Pulse	None
Nukem	house music
Nummer	ambient
Nuuktal Rec CH	None
Nôze	techno
OCTOBER RUST	None
OGOUN FERRAILLE	None
OLA Rec	None
OLIVER CLICHÉ	None
OLIVER K	re:techno
OLLIN	None
ORGANIC STUFF	None
ORGON GROOVE	None
OSI	progressive
OTIST RIDDIM	None
OUT OF ORDER	None
OUTLAND	None
Oase & Sainte Harare aka Foupoudav	None
Ockham	None
Off Rec	None
Offen Music	None
Og Spiritual Godess	None
OgeSoundsystem	None
Ohrstrom	None
Ojié	None
Oli	None
Oli Allen	None
Oliver	house music
Oliver Aden	None
Oliver Aden & Luis Cruz	None
Oliver Dollar	house music
Oliver Hafenbauer & MANY MORE	house music
Oliver Huntemann	techno
Oliver K	hip hop
Oliver Koletzki	house music
Oliver Markreich	house music
Oliver Stumm	None
Oliver van der Miescher	None
Ollin	None
Om Unit	uk garage
Omar	reggaeton
Omen Accord	None
Ondrej	techno
Ondrej KUMQUAT	None
Ondrej Kumquat	None
One Records	None
Ongaku	None
Onkin	None
Onra	hip hop
Onur Gokhan Gokcek	None
Onur Özer	techno
Onur Özer COCOON RECORDINGS	None
Openair Sven Väth	None
Opuswerk	techno
Opuswerk  techno prénatale	None
Oram Modular	None
Ordinary Subject	house music
Oscar Nicczo	None
Oscar Schubaq	techno
Oslo	orchestral
Ostwind	None
Osunlade	house music
Otis Ango	techno
Otto Von Schirach feat Notorious Nastie	None
Outside Terrace Floor	None
Overless	None
Ovski	None
Ovum	None
Oxalis	None
Oxia	techno
Oxyd	None
Ozan	turkish
Ozelot & Lizerd	None
P Bell	None
P Carrado	None
P Jones Karton  Amsterdam	None
PANADURA	None
PAOLO BARDELLI	disco
PARIS	uk garage
PASCALLA	None
PASCI	None
PASCI  Cheeky Choice	None
PATKP B2B ALEX ANDER	None
PATRIQUE	None
PBell	None
PBen	None
PCC	None
PEDRAM	None
PER CHI ARRIVA DA MILANO	None
PER CHI ARRIVA DA VARESE	None
PERFECT STRANGER Live	None
PERFORMANCE YUNELLESKA	None
PERIGOSO & MR PARANOIA	None
PETER SZANTO  mischkultur	None
PHILIP BADER	house music
PHILLIP INÄBNIT	None
PHURPA	None
PIERICK	None
PIGMAN	None
PK Squared	None
PLACID	house music
PLASTIC FM	None
PLO Man	None
POL	None
POSSA	None
PRO TONE	None
PROFILER	None
PSYCO	None
PTess	None
PUBLICIST	disco
PURE TECH	None
Pablo Bolivar	techno
Pablo Denegri	techno
Pablo Einzig	techno
Pablo Nouvelle	house music
Pachanga Boys	None
Pacifica	string quartet
Pacman	trap
Paco	rumba
Paco Osuna	techno
Padrino	None
Pailette	None
Palms Out Sounds	None
Palms Trax	house music
PanPot	None
Pandallougi & MontCoco	techno
Pandour	None
Panevino	None
Panorama Bar	None
Panoramabar  Berlin	None
Panteros666	techno
Pantha Du Prince	electronic rock
Paolo Paleologo	disco
Para One	house music
Para One B2B Curses	None
Paride Saraceni	None
Paris	uk garage
Parquet Rec	None
Parra Soundsystem	None
Partikel	dub
Pascal FEOS  Frankfurt	None
Pascal Inc	None
Pascal Prosper	None
Pascal Thomson	None
Pascal Tokar	None
Pascal Tokar vs Jerry	None
Pascal Viscardi	house music
Pasci	None
Pasci  Friedas Büxe extended	None
Pasci  Sandro Kühne  Bonny & Clyde  Love Cult	None
Pask	None
Paste 20	None
Pat Patrisha	None
Patricia Schmusekatze	None
Patrick Chardronnet	techno
Patrick Podage	groove room
Patrick Podage & Nikola Kotevski	rap
Patrick Zigon	techno
Patrique B2B Luca Vallante	None
Patrischa	house music
Patryk Molinari	house music
Patt & Mandibula	None
Patula	None
Paul A	None
Paul Chambers	jazz
Paul Eg	techno
Paul Eg  Ethnik GrooveMinimo ImprintDefinition Records	None
Paul Kalkbrenner	techno
Paul Lomax  Deepflight Ibiza	None
Paul Thoma	None
Paula Temple	dub
Paulo Diaz	None
Pavel live	None
Pawlikowski	classic polish pop
Pazkal	house music
Peak b2b Marc DArrigo	None
Pech & Schwefel	None
Pedram	None
Peggy Gou	house music
Pender Street Steppers	None
Pendler	None
Pepe Brogna	None
Pepito Lindo	None
Per pagare meno	None
Perfect Stranger	progressive psytrance
Performances by Life is a Bitch Crew	None
Perigoso&MrParanoia  Freakouts Events	None
Perlon	None
Perlon  Berlin	None
Permanent Triangle	None
Permanent Vacation	techno
Permanent Vacation  Italie	None
Permanent VacationDrumpoet Community	None
Perrine En Morceaux	None
Perseo	None
Pete & Pete	hip hop
Pete Rock	hip hop
Peter D	techno
Peter Lavelle	None
Peter Schumann	hip hop
Peter Szanto	None
Petitjean	None
Pettinato	None
Pfeffy	None
Pfrequency	None
Phantom Project	None
Phantom Project l Minimal	None
Phantomas & PAOLO	None
Phanton	None
Phil Asher	breakbeat
Phil Cole	disco
Phil Garner What Else	None
Phil Riss & Ali C	None
Phil zviel	None
Philemon	None
Philip Bader	house music
Philip G Cifuentes	None
Philipp Aregger	None
Philipp Rochard	None
Philipp Weibel	None
Philippe	harpsichord
Philippe Dunst	None
Philippe Petit	techno
Philippe Petit all night long	None
Phonica	None
Phonosynthese live	None
Phrex	None
Phucking Happyend	None
Phuture Traxx	rock
Piasa	None
Piatto	techno
Piero P & Luigi Forte	None
Pietro Mancini	None
Pikaya	hip hop
Pilocka Krach	disco
Pino Arduini	None
Pional	disco
Piratenkind	None
Pixelpunks	None
Pièrick	None
Planet Mu	None
Planet Vision	None
Plastic City Rec	None
Plastik Funk	house music
Plastique de Rève	None
Platinum	beats
Play it Loud	None
Playdoe	None
Player b2b Belcastro	None
Playlove	techno
Pleasurekraft	techno
Plusculaar	None
Plushgrizzly	None
Pochatz	None
Pokerflat	None
Polabdul	None
Polaris	None
Polydance Djs	None
Pomelo	None
Posada	classic colombian pop
Pour celles et ceux qui débarquent	None
Pow Low	disco
Premiere Moby Disc Radio by Jørg	None
Premiesku	house music
Press C	None
Pretty Pink	disco
Prezzi	None
Priku	disco
Princess P	None
Prinzessin in Not	None
Procid	None
Professor Wouassa	afrobeat
Profondo	None
Progenitor  LIVE	None
Programme	None
Proud	None
Proudly People	techno
Prélocations sur à Sounds Records	None
PsYnesS	None
Psycho Weazel	None
Psykoloco	house music
Publicist	disco
Puma	house music
Pure Tech  Freakouts	None
Purple Project	None
Purpurea	None
Päge	house music
Púrpura	None
QUINTO ELEMENTO	regional
Qebeq	None
Qebeq & special guest	None
Quan	rap
Quarion	techno
Quentin Mosimann	None
Question & Exclamaton Mark	None
Quitim	None
Quitim  Marcio  Dee Nelli  Stoga  Der Kleine Italiener  Dani S & Dilusso  Fabian Kozelsky	None
Quivver	house music
R Ist Lieb	None
R San	None
RAOUL murg	None
RAPHAEL RABAN	None
RAPU B2B Nekow	None
RAS MALI	None
RATIO  AMSTERDAM	None
RBMA	None
REVERSE	emo
REX & DUX	techno
RINA LOU	None
RINO	rap
RINO  Cityfox	None
RINO cityfox züri	None
RIVE MAGENTA & FRIENDS	None
RJR	None
ROCKTRONIC	None
ROGER23	disco
ROLF IMHOF	None
RTec	None
Raban	None
Racker	None
Radi Tabasco	None
Radio Slave	techno
Radiorifle	None
Radro	None
Radro & DANIEL MARRONE	None
Raf Dask	techno
Raf Marchesini	disco
Rafaele Castiglione	house music
Rafeeq	None
Ragesh Nair	techno
Rainer Trüby	None
Rainer Zufall b2b Streichholz	None
Ralf dj	None
Ralph Good	techno
Ralph Sliwinski	techno
Ramady feat ManuL	None
Ramiro Lopez	techno
Ramon Tapia	house music
Randall M	None
Randall M tINI & the gang  Orlando	None
Raphael Dincsoy	techno
Raphael Raban	None
Raphaello	None
Rapu & Nekow	None
Rapu & Nekow PRISMA Music  Zug	None
Rare Movement	house music
Rare Movement  JONNY N TRAVIS	None
Raw Operators	None
Raw Vox	None
Ray Douglas	None
Ray Jones	None
Razor	metal
ReAxis	disco
ReChi	None
ReUP	None
ReYou	disco
Rearte	None
Reas	house music
Reber	house music
Rebolledo	deep cumbia sonidera
Recarey	None
Recarey B2B Max Clebson	None
Recondite	techno
Records	indie
Red Jam	None
Red Robin	None
ReeFlex	None
Regenbogen	ostrock
Reggy Van Oers	techno
Regular	disco
Rekids  Berlin	None
Reloading rec	None
Remote Area	None
Renato Broccini	idm
Rene Bourgeois	house music
Rennie Røyma	None
Renè S	None
Resident  De La Porter  Skorpionkinder Records  Cube Resident	None
Resident Advisor	None
Residents	rock
Resopal	None
Reto Ardour	techno
Reto Ardour & Benja	techno
Return	pop
Return b2b Patrischa	None
Reverse  LIVE	None
Revier	None
Revolvercanada	None
Rhadoo	None
Ricardo Villalobos	techno
Riccardo de Cicco  Sal Capone	None
Rice & Beans	None
Rich	rap
Rich Miles	None
Richy Ahmed	house music
Rick Even	None
Rico Rausch	None
Rico Tubbs	house music
Rina Lou	None
Rino	rap
Rino Cityfox  Zürich	None
Riot School	None
Riparian aka Tommy Lexxus	None
Ripperton	soul
Ritter Butzke  Berlin	None
River Ist Böse	None
River ist Böse	None
River ist böse	None
Rizzoknor live	None
Ro	rap
Robby Naish	None
Robel	None
Robert Babicz	techno
Robert Dietz	techno
Robert James	disco
Robert Johnson	blues
Robert Nesta	None
Roberta Nicholls	techno
Roberta Nicholls all Day	None
Roberto Didio	None
Robin Martinelli	None
Robin Schulz	house music
Robin Sukroso	techno
Rocco	disco
Rock Machine  Berlin	None
Rocketnumbernine	None
Rodney Hunter	downtempo
Rodri	None
Rodri  audiotheque  bern	None
Rodriguez Jr	techno
Roger Sanchez	house music
Roger Torroni	None
Rogi	None
Roksonik	None
RolandSousa	None
Rolf Imhof	None
Rolf Saxer	disco
Rollende Beats	None
Roman Klinger	None
Romano Ciccone	None
Romano Rapeso	techno
Romano Rapeso Teknologik Rec	None
Romano The Alchemist	None
Romar	rap
Romeo	bachata
Ron Costa	techno
Ron Morelli	house music
Ronald Grauer	None
Rootwords	None
Rosalinda	None
Rosso&Capriice  Freakouts	None
Rotary	jazz funk
Rotchopf	None
Round Table Knights	house music
Rover	None
Rowboat Records	None
Roy Misher	None
RoyGreen & Protone	None
Ruben	tropical
Ruben Coslada	None
Ruede Hagelstein	techno
Rufio	punk
Rufus	electronic rock
Rumlaut	None
Rusconi	None
Russ Liquid	idm
Russia	None
Ryan Crosson	techno
Ryan Crosson b2b Cesar Merveille	None
Ryan Hawkin	techno
Ryan Hawkin & Konpiuta	rap
Ryan K	None
Ryan Mathiesen	disco
Ryan Sullivan	techno
Rynecologist	techno
Ræve	house music
S 233 direzione Malnate	None
SANKT	dark jazz
SBiene	None
SCHEINIZZL	house music
SCNTST	techno
SEBASTIAN WOJKOVSKI	None
SENSITYVES	None
SENSUAL SQUEAK	None
SERGIO MESA	None
SERGIO MUSA	None
SEVEN	house music
SHADED	techno
SHKAMB	None
SIKK Project	None
SILENT SPHERE	None
SIMINI	None
SIMON	rock
SIMON EFFECT	None
SIMON STK	None
SIS	hip hop
SK Supreme	None
SKY JANSSEN anymany zurich	None
SKay	None
SMALL ROOM	thai indie
SMART MONKEYS	None
SNARDI	None
SOKRATES	None
SOLOK	None
SONABZ	None
SOPHIE LE MEILLOUR	None
SPACEPLANET	None
SPARGA	None
SPECIAL GUEST DJS	None
SPECIAL GUEST SHOW GIRLS VERNICE	None
SPECIAL VOICE	None
SPHERE	house music
SPOR	None
SPREEDELAY Katerholzig	None
SRANGE	None
SRubinfeld	None
SSDSS	None
SSSS	disco
STEFAN BINIAK	None
STEFANO MTM b2b MIRKO GROOVE FREQUENCY	None
SUPERMAFIA VJS	None
SUPPORTED BY	None
SUSPECT ONE	None
SWE	zouk riddim
SWEET DBROTHERHOOD	None
SWIT HONEY	None
SYLK POLETTI	None
SYMPHONIX	techno
Sa	None
Sa 2609 1200  100	None
Sabb	techno
Sachi Toyama	None
Sachi Toyama &BaZZkd	None
Salon	rock
Salvatore Freda	house music
Salvatore Romeo	None
Salz&Pfeffer	None
Salzunpepper	None
Sam	country
Sam Binga	hip hop
Sam Divine	house music
Sam Genious	None
Sam Seven	None
Sammy Gee	None
Sampayo	None
Samsara	neo-psychedelic
Samstag 07042012	None
Samuel andre madsen	hip hop
Samuri	disco
Samy Fresh	house music
Samy Lee	None
San Francisco	None
San Marco	deep orchestral
San Marco  Cheeky Choice	None
San Proper	techno
San Proper & D Live	rock
Sandro Falletta	techno
Sandro Kuhne	None
Sandro Kuhne Official	None
Sandro Kühne	None
Sandro ZH	None
Sandro silva	house music
Sandsturm	None
Sanmon	None
Sante	house music
Santiago Cortez	None
Santis	techno
Santorini	techno
Santoro & Blair	None
Santoros	rock
Santosh Khan	disco
Santé	deep
Sarah Main  Jade residents	None
Sarard	None
Saravah Soul	afrobeat
Sarna	house music
Sascha Braemer	house music
Sascha Cawa	house music
Sascha Cigrovski	None
Sascha Dive	techno
Sascha Rohrer	None
Saturday	None
Saturday to Sunday	None
Saty	None
Saul & Murphy	None
Saved	anthem worship
Saxo	romantico
Scaloni DJ	None
Scarlett Etienne	hip hop
Sche Sche	hip hop
ScheSche & Mismo	None
Schmerol	None
Schmerol & Andreas Ramos	None
Schmerol Baked  Zürich	None
Schnautzi	None
Schuhmacher	techno
Schwebekasten	None
Schwester Gill	None
SciTec	None
Scoopy	None
Scott Bradford	house music
Scott Brown	hardcore
Scott Kemp	techno
ScottyA	None
Scout Klas	None
Scream	trap
Scuba	uk garage
Scum	horrorcore
Sdanke	None
Seb Blake	disco
Seb Blake & Albi	rap
Seb Blake b2b Albi	None
Seb Zito	techno
Sebas O Verde	techno
Sebastian	grupera
Sebastian Groth	techno
Sebastian Ingrosso	house music
Sebastian Mullaert & Ulf Eriksson	techno
Sebastian Spring	techno
Sebastian Wojkovski	None
Sebastian Wojkowski	None
Sebastien	classical
Sebatien B	None
Sebo	house music
Second Deck	None
Second Florr	None
Second floor	deep chill
Secondfloor	None
Secret Guest	None
Sedzed	None
Sedzed b2b El Alusinante	None
Seiji	orchestral
Selador	None
Selim & Armin	None
Selim&Armin	None
Sell Sander	None
Senking	techno
Senoo	anime score
Sentiment	None
Senzen	None
Sepp	disco
Sequenzheer	None
Serafin	orchestral
Seranthony	None
Sercan Demir aka Seco	None
Sergio Mesa	None
Sergio Trillini	None
Serio	rap
Serioes & Legendaer	None
Servet Argin	None
Sese	None
Session Deluxe	None
Session Victim	house music
Seteve	None
Seth Troxler	techno
Several Definitions	house music
Sex Organs	None
Seymen	None
Shadow Rec	None
Shaf Raisi	None
Shahira	None
Shaka	grupera
Shaka aka Kurt Spichiger	None
Shaun Reeves	techno
She DJ Nathalia	None
She DJ Panadura	None
She DJ Vanita	None
She Nionika	None
Shed	madchester
Shinichi Osawa	house music
Shonky	techno
Sidgis	None
Sied van Riel	trance music
Siegwart	None
Signor Rossi	None
Silencio	rock
Silent Neighbors	None
Silky Raven	None
Silvano	None
Silvision	techno
Simian Keiser	None
Simoki	None
Simon & Shaker	deep uplifting trance
Simon Effect	None
Simon Effect ARCHIPELCH	None
Simon Mike	None
Simon T	house music
Simple & Sans	rap
Simplicity	christian relaxative
Simplistic	None
Sinden	house music
Sinisa Tamamovic	techno
Sinjin Hawke	house music
Sinkane	None
Sinneswandel	None
Sinneswandel  Berlin	None
Sinneswandel  ZH	None
Sins	None
Sins & Temiri	rap
Sir Colin	choral
Sirion	progressive psytrance
Sirion  CH	None
Sirion Rec  Be	None
Sirion Records	None
Skail Master M	techno
Skaos	ska
Skiing	None
Skor	hip hop
Sky & Anyken	None
Slapdance & Sandy Pants	None
Smallpeople	house music
Smalltown Collective	house music
Smirre	None
Smos	None
Snowstorm	None
So	emo
So 2709 1200  100	None
SoSSoundz of SunElektrisch	None
Soame	disco
Soivé	None
Solee	techno
Solid	None
Soliman	techno
Solomun	house music
Someone Else	techno
Sonabz	None
SonerTshichek	None
Sonik	None
Sonja Moonear	None
Sonntag 08042012	None
Sonny Catanese	None
Sonny Vice	None
Sons of Aoide	None
Soulmate	None
Soulstar Syndicate	None
Soult	None
Soulwax	electronic rock
Sound Nomaden ft MSP	None
Sous Sol	rap
South Africa	None
Soweto	world
Space Rangerz	None
SpaceK	psych
Spacebox720 live	None
Spartaque	techno
Special Guest	None
Special Guest Mia Kaltes	None
Special Guests and Surprises	None
Special K	disco
Special guest Euphoria	None
Specimen	electronic rock
Speedrax	None
Spencer Parker	techno
Spenzas overdub Orchestra	None
Spiegelbild	None
Spikers	None
Spoony Talker	house music
Spor	None
Sprout	rock
SquarElectric	disco
Squep	house music
St Germain	downtempo
St Plomb	None
StPaul	None
Stabio  Mendrisio	None
Stadtpark	None
Stairs	hip hop
Stallo & Etn	rap
Stan Starry	None
Starhouse	None
Starsand	None
Start 2200	None
Stasis Recordings	None
Stassy	None
StatedLife	None
Station service	None
Stealth RecordsUK	None
Steeve March	disco
Stefan Biniak	None
Stefan Goldmann	techno
Stefan Nolic	None
Stefan Nolic Naturklang  Zürich	None
Stefano MTM b2b Grow Frequency	None
Steffen Flum	None
Steffen Sonnenschein	disco
Steffi	hip hop
Steiner	soundtrack
Stellina	None
Stephan Bodzin	techno
Stephane Jusserand Alfonso Reyes	None
Stephane Lando	house music
Stephen Bodzin	None
Stereo Express	house music
Sternenwanderer	None
Steve Active	None
Steve Cole	smooth jazz
Steve OSullivan	techno
Steve Sanders	None
Steve Supreme	None
Steven Beyer	techno
Steven Stone	None
Stevie Ray Monkey Jam  Cube	None
Sticka	None
Stiglitz & Bernstein	None
Stiglitz&Bernstein	None
Stil & Taktvoll	None
Stil vor Talent	None
Stil vor Talent Hamburg	None
Stil vor TalentBerlin	None
Stil&Taktvoll	None
Stimming	techno
Stino Stallone	None
Stipé	None
Stockholm  SE	None
Stoga	None
Stoga saugstauber	None
Stonato	None
Strange Loving	None
Strassenmajor	None
Stray	new
Strb	None
Strumberg	None
Studer TM	None
Studer TM l Freistil	None
Studio 41	None
Styro	None
Styro 2000	None
SuMan & Placebo	house music
Suara	anime
Sub Bros	None
Subban	None
Substance	techno
Such a Serge	None
Suddenly Neighbours	None
Sundance	None
Sunday	emo
Sunday Breakfast	None
Sunday to Tuesday morning	None
Sunset Handjob  Halle	None
Super Flu	house music
SuperFlu	None
Supermafia	None
Supermarket	None
Supermarket Zurich	None
Superpoze	disco
Supersonic Sound	None
Support CGibbs	None
Support Credo	None
Support DJs	None
Support OUS Label Night mit BITTUNER	None
Susie Star	None
Sutsche	None
Sven Dohse	hip hop
Sven Ninneman	None
Sven Schaller	techno
Sven Tasnadi	house music
Sven The Freak	None
Sven VÃ¤th	techno
Sven Väth	techno
Sven Wittekind	schranz
Svenskj	None
SwamThing	None
Swan H	None
SweetnCandy	None
Swissdeep	None
Switchbox	None
Swithoney	None
Swosch	None
Sybille Jeans	None
Symoh Sares	None
Symphonix LIVE	None
Synapson	house music
Syndrome WPW	None
Synin	None
Syntec	ebm
Syracuse	hip hop
System RecSUI	None
Systematic  PARIS	None
Sébastien Léger	None
T0DO	None
T4L	None
TAF	neo metal
TANZWIESE	None
TBA	techno
TBC	None
TBird	None
TECHNO WHYNOT	None
TECHNOKEKS	None
TEMPO Moderno	None
TESTOSTERONE CLUB	None
TG	country
THE FLYING MUSTARDS	None
THE Juan Maclean	electronic rock
THE KOLETZKIS LIVE	None
THE RICH MANS KITCHEN ORCHESTRA	None
THE RIDDLER	None
THEX	None
THEY LIVE	None
THIS LINEUP WILL BE FREE OF CHARGES ON PLACE DE LEUROPE	None
THOMAS P HEKMANN	None
THOMAS WOOD	None
TICON	trance music
TICON Live	None
TITTO LA ROCKA	None
TIVE	house music
TM Juke	downtempo
TMOWOOD tv	None
TNT	None
TOBI DREIPOL	None
TOILET ACOUSTIC	None
TOM GROOVE	None
TOM WINEGARD plasurelap biel	None
TON IN TON	None
TOYBOYS	None
TRIPLE AGENT	breaks
TROMBETA	None
TROUBADOUR	None
TRUE LIES	progressive psytrance
TRiKOS b2b Lucas Vogt	None
TRoy	pop
TRoy on the set	None
TSBIN aka TSN and SBI	None
TUBA	classical christmas
TUNED	None
TUSSLE	None
TWO ME	None
Tabis	None
Tableturner Duo	None
Tableturner duo	None
Tacteel	None
Tadeo Doberska	house music
Tagedeep	None
Tagträumer²	None
Tako & Jamie Tiller	house music
Tal Stef	None
Tale Of Us	techno
Tama Sumo	house music
Tanua	techno
Tanzamt	None
Tanzstube mit Mad Katz Techno	None
Tanzstube mit Schwerelos	None
Tapes	ambient
Tapesh	house music
Tapirus	None
Tarco	None
Tarik	rap
Tarotkarten legen mit Señor Deckshark aka János	None
Tashi Noir	None
Task Horizon	drum and bass
Taucher	bubble trance
Tba	techno
Tec Jones	disco
TecJones	disco
Techhouse	None
Technik	None
Techno  Why Not	None
Techrifice	None
Tectonic  Berlin	None
Tee Moe	None
Teenage Mutants	house music
Tekamolo dj	None
Teki Tekua	None
Teknopunx	None
Tempa	uk garage
Teo Ermotti	None
Terasun	None
Terminal M	None
Terra Nova	hip hop
Terrazza Floor	None
Terry	ambient
Terry Pardini	None
Tetsuya Ura	None
Texas	country
The Acid hotel	None
The Bassment	None
The Chronics	None
The Cruzaders	rock
The Csc	None
The Cube Guys	house music
The Deadline	None
The Dean Soniks	None
The Essentials	None
The Hacker	electronic rock
The Housecreamers	house music
The Joy Boys	rock
The M&B Experiment	None
The Martinez Brothers	house music
The Oh Nos	chicago indie
The Parallax	electro
The Proxy	None
The Rah	None
The Rapy	None
The Ripper	None
The Siegfrieds & Toys	None
The Sons of the Desert	deep contemporary country
The Stereo Youth	None
The Sweet Life Society	electro music
The Teledubbies	None
The Toyboys	None
The Wild Cowboys	disco
Thereal Demonti aka Samy Demonti	None
Think Tank DJs	None
Thom Mayr	None
Thom Nagy	None
Thomas Melchior	None
Thomas Muller	hip hop
Thomas Schumacher	techno
Thomas Wood & Alon Levi	None
Thomas Zopf	None
Thugfucker	disco
Tiago Cortez	None
Tiari	hip hop
Tief Records	None
Tiefgeist	None
Tiefschwarz	techno
Tiesto	house music
Tiga Lily	None
Tigerskin	techno
Till Tape	None
Till von Sein	techno
TillTape	None
Tillhelm Well	None
Tillup	None
Tim Engelhardt	house music
Tim Exile LIVE	None
Tim Xavier	hip hop
Timbee Rec	None
TimbeeSUI	None
Time Has Changed	None
Time Passager	None
Time Tarracho	None
Timmo	techno
Timo Maas  Rocket & Ponies  Coccon	None
Timoteo	brega
Timothy J Fairplay	None
Tin Man	techno
Tino Kaufholz	None
Tinush	house music
Tissu	None
Tiësto	house music
ToBe	None
Toast Terry	None
Tobey Lee	None
Tobi Neumann	house music
Tocadisco	techno
Todd Bodine	hip hop
Todo	regional mexican pop
Toffee	substep
Toilet Acoustic	None
Tokyo	electronic rock
Tolga Kéz	None
TolisQ	house music
Tom & Cherry	None
Tom Alemanno	house music
Tom Bosson	None
Tom Burclay	house music
Tom H	None
Tom Mandolini	None
Tom Novy	house music
Tom Pusch	None
Tom Trago	house music
Tom Wineman	None
TomTeeT	None
Tomcraft	techno
Tommy J Gren	disco
Tomvson	None
Tomy Gips	None
TonTon	None
Toni Varga	house music
Tonic	rock
Tonic  FreshnLoud	None
Tonknecht	None
Tonton	None
Tony Garcia	freestyle
Tony Garcias  Borderline	None
Tony Nocera	None
Tony White	blues
Toolroom  UKUSA	None
Topic	house music
Torentus	None
Torsten Kanzler	schranz
Touching Music  New York	None
Tough Love	house music
Toy  O	rock
Trabant	icelandic pop
Tracknics	None
Trance	None
Transport USA	None
Tre Rose	None
Treatyourdjright	None
Treibstoff	None
Tremendo	house music
Tremendo  Mad Attitude	None
Trentemoller	electronic rock
Trentemøller	electronic rock
TriDeuces	None
Trinidad	rap
Trio Heinz Herbert	None
Tristan Bohn	None
Trouble Maker	k-pop
Truci  Relogical Rec & Define Rec  ITA	None
True	None
Tryal	None
Tryphon	None
Tschespito	None
Tube & Berger	deep
Tucillo	None
Tuncay Celik	hip hop
Tuned	None
Turbulent DJs	None
Turntablerockers	None
Twisted FrequencySUI	None
Two Suspect	None
Two Suspects	None
Two Suspectt	None
Twoets	None
Tzinah Records	None
UK	zapstep
UKIce	None
URBAN FLOOR	None
USA	None
Uglyfunker	None
Uhuruku	None
Ulli & Maesoo	None
Umami	house music
Umbe Nalle	None
Umberto Nalle	None
Umut	None
Unbe Nalle	None
Undercatt	house music
Underground Connexion	None
Understand	None
Uner	techno
Unite Family	None
Us and Sparkles	None
Usa	None
Ushuaia Ibiza	None
Uto Karem	techno
V Stax	None
VACINTOSH	None
VAISHIYAS	progressive psytrance
VANITA	disco
VAlpen	hip hop
VAlpen aka Dachshund & Dave The Hustler	None
VID	None
VIP FLOOR	None
VISIONS OF TREES	house music
VISUAL	None
VISUALS	None
VISUALS by	None
VITO LONERO	None
VJ Bildspur	None
VJ Gremi	None
VJ Stereolux Auto Pilot	None
VJing by Projektor Kollektiv	None
VKawumski	None
VOCAL LIVE	None
VOLKAN OCAK	None
VS	pop
Vadim Svoboda	None
Vakant	None
Valentin	cumbia
Valentin Boesch	None
Valentino	hip hop
Valerio Raponi	house music
Valetino	None
Valico autostradale di ChiassoBrogeda	None
Vamos Art	house music
Van Hai	techno
Vanessa Sukowski	None
Vanita	disco
Vario Volinski	house music
Vegetative Wachstumsphase	None
Venom	house music
Vera	deep australian indie
Veronika D	None
Vertoner	None
Verveine	None
Via Angelo Maspoli	None
Vicino al Casino Admiral e Fox Town	None
Vico Dinami	None
Victor L	None
Vid aka Egal3	None
Viera	deep regional mexican
Villa Bosso	hip hop
Vince Vella	None
VincentIulian	None
Vinz Vega	None
Violett	techno
Virgil Enzinger	schranz
Virginia	disco
Visionist	fluxwork
Visionkids	None
Visionquest	techno
Visuals by Lisa Laser	None
Visuel par VJ Badbeat	None
Visuels et performances	None
Vitek	None
Vkee	None
Vladimir Corbin	house music
Vladimir Ivkovic	None
Vlnolam Kawumski	None
Vocalist Lele Margot	None
Voigtmann	house music
Volkan Ocak	None
Volkan Ocak & Claudio	None
Volkan Ocak b2b Claudio	None
Volkshaus	None
Volta	rock
Volta Cab	disco
Voltec	None
Voodookid	None
Voodookit	None
Vouipe	None
Voyage Direct	None
Vulgaris	None
W O L F M U S I C	house music
WADE	country
WAGON REPAIR  GENEVA	None
WE KILLED THE JUKEBOX	None
WESTD	techno
WITH	pop
WTF & Bonus Beats	None
WURZELFLOOR	None
WWWDJSAMCOM	None
Waldherr	None
Walls	None
Walter Albini	None
Walter Wolf	None
Wandervogel	None
Wandler	techno
Wankelmut	house music
Wareika	techno
Warm up	None
Warmupper  Alex T  Rauch Club	None
Washerman	disco
Wasted Ruffians	house music
Waveform	ambient
We Are	anthem worship
We Dig Underground  Mad Rey	None
We stand for	None
Wed Techno  CH	None
Wedernoch	None
Weedz	None
Wehbba	techno
Wen	pop
Wenotme  Maria blessing Oliver Aden & Luis Cruz	None
Wenzel Dashington	None
Whim	techno
White Perception	None
Whitehouse	None
Why Be	korean pop
Wicked Wilma	None
Wien	None
Will Sergeant	None
Winkel  VintageMöbel	None
Wla Garcia	techno
Wobble Lovers	electro trash
Wohnzimmer	None
Wolf MÃ¼ller	None
Wolf Müller	None
Wolfskind	None
Wonnow	None
Woody	blues
Woolfy vs PROJECTIONS	balearic
Worakls	house music
Work in Progress	None
Wunschkinder	None
XCESS	None
XDB	techno
XLR8R	None
XOSE	None
XV KILIST & Rocco	None
Xander Valley	None
Xeno	electronic rock
Xenocracy DJs	None
Xose	None
YETTI MEISSNER	None
YONI BANKS & YAN KA	None
YOSKO	None
Yall	None
Yan Luong	hip hop
Yann Detroit	None
Yannick Müller	None
Yannik Müller	None
Yare	None
Yaroslav Lenzyak	techno
Yesin	disco
Yoni Banks & Yan Ka	None
Yougene	None
Young Marco	house music
Yourube Grooves  BE	None
Ypsilon	None
Yuli	None
Yvan Genkins	techno
Yves Helbling	None
ZH	None
ZIDEKICK	None
ZOO	None
ZOZ	None
ZaJazza	None
Zaikadelic	None
Zajazza feat Illspokin	None
ZanoP	None
Zapoff	None
Zavatta	None
Zebopunkt	None
Zed Bias	uk garage
Zenker Brothers	None
ZentroN	None
ZerO	downtempo
Zero	downtempo
Zest halfhours	None
Zodiak	None
Zoe Xenia	techno
Zombidou	None
Zombie Disco Squad	techno
Zongamin	None
Zouaoui	None
Zozo	techno
Zrk	techno
Zurich	None
Zustra	None
Zweitraum	None
Zwette	house music
Zwillingsmann	None
ZüriPistolPete	None
Zürich	None
a 300 mt uscita autostrada	None
adimatique	None
adriano aka adi	None
afro disco	None
alongside MC DRS	None
and Movel Traxx Hes received press coverage from DJ Mag	None
and New York Citys Turrbotax and Momas PS1 events	None
and ghetto tech together with a knack for creating sparse	None
and many more	None
and moore	deep texas country
and more	deep freestyle
and more TBA	None
and others	None
and tba	None
andri	deep
andri live	None
après plusieurs apparitions télévisuelles	None
aron	acoustic pop
arā	pop
as to the manner born	None
as well as Rip It Up Additionally	None
as well as had featured remixes on BBE	None
audiotheque	disco
b2b	None
be	rock
beatbrothers	None
bescheren das Nachtleben jedoch mit hoch qualitativen Musikproduktionen und legen dazu sehr viel Wert auf solide Soundauswahl für ihre	None
bleepsequence	None
bonsoir  bern	None
bossa	None
broken beat	None
buraq	None
buraq aka Leke da Loco	None
checkon	None
chicago house et plus si affinités	None
cityfox zürich	None
classics	rock
comme cerise sur le pâté	None
cosmos uk & fresh 80s  dj	None
created his own label	None
dOP	techno
das Krause Duo	None
deep	emo
deep house	None
deep house  tech house	None
deguds	None
dessous	None
detroit	None
diSoul	techno
disco	emo
dj Zest	None
dj bod	None
dj jonny sender	None
dj lynn Jordan	None
dj lynn jordan	None
dj rize	None
djgino	None
djs Guyus	None
doma musique	None
dominic	pop
doubleare	None
dr habakuk	None
drompojke	techno
duble	rock
duburchin	None
dzanin	None
débarque à PTR  Formé en 1996	None
ecological and sustainable developpement	None
edits	house music
electronic  deep house  tech house	None
enregistrent leur premier album  Creature funk  en 2003 Alors que leur second  Creature Shock Radio  obtient un franc succès et les élève à un niveau supérieur	None
entropie	None
et pour cette édition	None
fatti mettere in lista	None
floppy funk	None
formbar bern	None
friends	emo
funk	None
gabor	soul jazz
gallo	None
garage	alternative country
geneva	grave wave
ghetto house	None
girl	mashup
great impro & avantgarde band  live	None
great stuff münchen	None
guest	electronic rock
gun club münchen	None
hes headlined parties such as Londons Night Slugs	None
hidden trainer	None
hive & zukunft zurich	None
house	None
httpssoundcloudcomblanktonsammelstelle	None
httpswwwfacebookcomClubSupermarket	None
httpwwwfacebookcomcircumflux	None
httpwwwmyspacecomdjleventino	None
hypnorex	None
ieva	None
ils construisent alors un vaisseau spatial et partent dans le cosmos à la recherche de signes nouveaux et de valeurs à transmettre à lhumanité Après un long périple riche en aventures	None
ils tentent de bâtir un nouvel ordre mondial	None
imaginez un mix entre le Muppet Show et le WuTang Clan Le seul  groupe de jouets  sur Terre	None
incite liveAV	None
italospace disco	None
juke	None
klangpunkt rec	None
krystyna	classic polish pop
ladybruce und monair	None
le cerf de la jungle DJ Dser	None
le coté obscur de DJ Kenhobiz	None
leur nouvel album  Revolve and Step up  sortira le 26 mars prochain  De quoi faire remuer vos corps de grosses marionnettes	None
line up	None
line up Interlop	None
line up KQC	None
live	christian christmas
live Hepp	None
live KMK	None
live Rotkeller	None
live art & VJ Projection	None
live set	None
llian Tape  Buenos Aires	None
long	new age
ma	trap
manon	techno
marco k f	None
mathieu sabotage B2B such a serge	None
mathis	easy listening
mauy	None
mentalgroove	None
mia	pop
miaumusic  BE	None
mickey monza	None
mimetic	industrial music
minitek	None
mobilee	None
more	metal
more TBA	None
more infos soon	None
more tba	None
morris audio	None
motionlabch	None
mrrox & mrsimon	None
murphy	rap
music and related art forms	None
musik krause	None
mynightlifefm	None
nekЯoBo  loungecore	None
nemoy	None
nervmusic	None
oO	None
omar	reggaeton
other location	None
packende Vibes  BORN & das SupiTeam verwöhnt seine Gäste mit Musik der Extraklasse  DER HouseLaden in Zürich Nicht umsonst steht im Supermarket eine der besten Soundsysteme  Kv2 Audio rundet das Hörerlebnis perfekt ab	None
pasci	None
peacefrog	None
pendler	None
plus juste pour toutes les marionnettes et créatures Malheureusement	None
post dubstep	None
prog house	None
psyco african beat	None
quality and safety	None
racker	None
ramin	soundtrack
reedits	None
rest  Bern	None
reverse	emo
revolvercanada	None
rien ne change et les Puppetmastaz tombent en dépression Avec laide de leur psychanalyste Ziggy Scandalous et lappui financier de Sneakerboots	None
ronkanditt	None
ruffPack international	None
sCs  Studio 41  Montreux Jazz Festival	None
sascha cigrovski	None
sco	None
see u at dancefloor	None
seranthony	None
sinneswandel	None
skurill  BE	None
snappy tracks that manage to convey a physicality and funk with spectacular precision	None
socialmedia	None
soon	progressive psytrance
soul	hip hop
space disco	None
stil vor talent	None
surf and exotica	None
t	hip hop
tINI	hip hop
tat1	None
tat2	None
tbc	None
tech house	None
techno	None
techno machine	None
terry pardini  happy  solothurn	None
thomonn	None
tictactoe	None
tolerance and networking in the culture scene	None
tolga köz	None
tom tek	None
treibhouse	None
tropicalia  dj	None
tuningbox	None
tuningspork & leena	None
udossonmredit	None
uncoolch	None
und	pop
und als DJs	None
undergroundproject	None
une spécialité venant directement de Londres	None
ursprung	None
uscita Mendrisio	None
very special Guest DJ	None
w Plusculaar & Primr aka Temiri	None
w Temiri	None
wankäla	None
warm up	None
weird disco	None
welches genau zu beobachten ist Hier tauschen sich Künstler untereinander aus und unterstützen sich gegenseitig in Sachen Musikproduktionen und Kooperationen	None
whatever	None
wwwmyspacecomdjmanon	None
wwwmyspacecomdjs2dirty	None
wwwmyspacecomibogaemok	None
wwwmyspacecommapusamapusa	None
wwwmyspacecommoosfiebr	None
wwwmyspacecompiatto	None
x Frango	None
x Girl	None
x Mastra	None
x Miles b2b Ab&Artig b2b Moezard	None
x Profondo	None
xa0	None
xa0Anna Ullrich	None
xa0Lausanne	None
xa0african boogie  dj	None
xa0high life	None
zerO	downtempo
zh	None
zürich	None
Überraschungsgast Berlin	None
ΚΕΜΑΛ	None
Ночной дозор	None
