	None
237	None
237 Family	None
4057 BASEL	None
AL	soul
ALON LEVI	None
ASON	None
ATA	techno
Aaron Khaleian	None
Abel	deep indie r&b
Abou Samra	house music
Accama	None
Adana Twins	deep
Addison Groove	uk garage
Adriano Mirabile	dub
Adriatique	techno
Ajele	None
Albert & Hofmann	None
Alci	salsa
Alex Dallas	None
Allegra Lusini	None
Andhazel	None
Andre	techno
Animal Trainer	deep
Anthik	house music
Ata	techno
Atish	house music
BASSnSMILE Crew	None
BIFASICO	None
BIFASICO aka ManuHeme & LITCH	None
BPM  BS	None
BUNKER	None
Baile Musik  BE	None
Banshee	vaporwave
Barbir	None
Barem	techno
Basel	consort
Bedran	None
Ben Def	None
Ben Rau	techno
Berlin	house music
Bfly Steiner  Nahste Oner	None
Bogota	cumbia
Boloko	None
Bonjour Ben	None
Bonny & Clyde	None
Braunbeck	techno
Brothers in Arms	None
Bruno Pronsato	None
Burt Cobain & Ali  Alburt	None
CENACLE CREW	None
CH	None
CNDR	None
Calado	None
Camiolo	None
Cascandy live	None
Charles Fenckler	dub
Christo	house music
Chuck Poland	None
Cobblestone Jazz	techno
Crowdpleaser	techno
DELOR	deep sunset lounge
DJ Coma	None
DJ JEAN BALAISE	None
DJ KOSMICK	None
DJ LAFOLIE ON THE MIX	None
DJ Le Roi	hip hop
DJ MoRFiN	None
DJ Oxyxa	None
DJ POSTMAN	None
DJ SF12 & DJ LYPTIC ONE	None
DJ ST XAVIER	None
DJ Spiri	None
DJ TASTY	None
DJ Tomic	None
DJs Green Velvet  DJ Rush  Monika Kruse  Felix Kröcher  Moonbootica  RaudiveOliver Ho  DIM  Shonky  Xenia Beliayeva  Steve Land aka Randy  Hannah Holland  Dachshund  Agnès  Smilla  Phuture Traxx  TurntableBabes  Ulli & Maesoo  Banga  Beda  Sandro Kühne and others to be confirmed	None
DJs René S	None
DJulz	techno
DON CREEK  Freaky A	None
DVision  BE	None
Dan Curtin	techno
Dancehall  Hiphop	None
Dandy Jack	techno
Dani Nydegger	None
Daniele Mastracci	groove room
Danni B	house music
Dario DAttis	disco
Dario DAttis Official	None
Dario La Mazza	None
David Fjörgenson	None
David Fjörgenson Live	None
De La Maso	rock
Deetron	techno
Definition	dreamo
Dejan	None
Dejan  Cityfox	None
Digitalism	electronic rock
Divalvi	house music
Doma	hi-nrg
Domenico Dagnelli	None
Dominik Eulberg	techno
Dropout Agency	None
Dropout Agency  BE	None
Dualism ZH	None
Dubculture  BE	None
ENØS	None
ERISU  Artjacking et F&S	None
Edelstahl	techno
El Alusinante	None
Emage	None
Enzo Lo Conte	None
Enzo Pianzola aka Mrtrend	None
Extrastunden	None
Ezikiel	techno
FLYING AWAY	None
FREITAG & FREINACHT ZH	None
FS Bart	None
Fabian Ulmer & more	None
Fabo	trap
Fabri	None
Fannik&Phil	None
Fat Sushi	techno
Figure Düsseldorf	None
Figure Francfort	None
Finefood	None
First Claz	None
Frank C	folk
Frank Vespari	None
Frank Vespari & Little Victor	None
Fred Linger	disco
Friday	punk christmas
Fulvio Cala	None
GEOERGE LAMELL	None
GUEST Sebas O Verde	None
Gallo	None
Georg Stuby	None
Get Funky  BE	None
Get Physical	None
Gianni Callipari	disco
Giusi Consoli	None
Guillaume Delattre	hip hop
Gunnar Guess	house music
HERTS	None
Heartleader	None
Hernan Cayetano	None
Herr Müller	None
Hetan	None
Hexler	None
Hive Audio	None
Honoree	techno
Ilona Maras	None
Insel	None
Ismail & Clive	None
Itiswhatitis	None
Ito	None
Ivan R	None
JAMIE LEWIS	house music
JOHN TAALSBERG	None
JOSKO ANTEK	None
James Mc Hale	None
Jem Haynes	house music
Jens Bond	techno
Jihell	None
Jimi Jules	disco
Johannes Heil	techno
John Lemon	techno
Juen & Bach	None
Juli Lee	None
JusEd	None
Juzz	disco
Kantarik	hip hop
Karotte	techno
Kevin Shala	techno
Konpiuta	None
Konpiuta Live	None
Konstantin Sibold	techno
Krizzli	disco
Kruse & Nuernberg	disco
LEON	rock
LUDOVIC B	None
LUFT	techno
La Vie Cest Facile	None
Lacrema	None
Laolu	techno
Layer V	None
Lee Van Dowski	techno
LeeO	None
Lemonick	disco
Lexx	disco
Lilly Palmer	None
Lineas De Nazca MEX	None
Little Victor	None
Live Digitalism  Gus Gus  Lexy & KPaul  The Advent  Dapayk & Padberg  Dusty Kid  Heartthrob  Einzelkind	None
Lo2	None
London	classical
Look Like	house music
LoveMEAlex b2b MAD  Deep Tech Records  Malicious Smile	None
Luca Parravicini	None
Luca Torre	techno
Luca de Grandis	None
Lui Young	techno
Luk	estonian pop
MANDEG ZH	None
MTDF	house music
Mado	None
Magdalena	harpsichord
Mannequine	disco
Manon	techno
ManuHeme	None
Manuel Fischer	None
Manuheme	None
Marcel Fengler	techno
Marco Berto	house music
Marco Capone	None
Marco Folli	None
Markus Suckut	dub
Martin Eyerer	techno
Marvin Aloys	None
Masaya	hip hop
Masaya  Official Fanpage	None
Mater Fader	None
Meikel	techno
Melbourne	deep orchestral
Melchior	punk blues
Mental X	None
Mia	electronic rock
Mia Kaltes	None
Mic Drive	None
Michel Cleis	None
Mirco Caruso	hip hop
Mirko Loko	techno
Miss Jools	techno
Missy Jay	house music
Modnar	None
Modulaw	None
Mokship	None
Monkey Safari	house music
Mov Elan	None
Murciano	house music
Music selected by	None
MÉNAGE À TROIS	None
NEW LOCATION Roter Korsar UFERSTRASSE 40	None
NICED	None
NICKY F	None
Nahste Oner	None
Nici Faerber	hip hop
Nico Audiowave	None
Nico Wilde	None
Nicola Koch	techno
Nicola Zoli	None
Nicos Oldies	None
Noel Audio	None
Nomarel	None
Nous	techno
OLIVER CLICHÉ	None
OLΔF	techno
Oliver Aden & Luis Cruz	None
Oliver Spiess	None
Opuswerk	techno
P Carrado	None
PEDRAM	None
PSYCHO WEAZEL	None
Pacifica	string quartet
Paolo Paleologo	disco
Partikel ZH	None
Pascal Viscardi	house music
Pasci	None
Patrischa	house music
Pawlikowski	classic polish pop
Pazkal	techno
Pender Street Steppers	None
Peter Lavelle	None
Phil Cole	disco
Phil zviel	None
Pitch Black  BS	None
Pranava	None
Psycho Weazel	None
Quarion	techno
RMEK	None
Raf Dask	techno
Rainer Trüby	None
Raphaello	None
ReYou	deep
Reklok	None
Reto Ardour	techno
Ripperton	soul
Robby Naish	None
Roberta Nicholls	techno
Roberta Nicholls all Day	None
Roman Klinger	None
Ronald Grauer	None
Round Table Knights	house music
Ryan Crosson	techno
SHKAMB	None
SK Supreme	None
SUPERMAFIA	None
Sabb	deep
Salvatore Freda	techno
Samsara	retro metal
San Francisco	None
Sandro Kuhne	None
Sandro Kühne	None
Santé	deep
Sascha Stohler	None
Saturday	None
Saved	anthem worship
Sche Sche	hip hop
ScheSche & Mismo	None
Scissor me Senseless	None
Sdanke	None
Sebastian Spring	techno
Sentiment	None
Session Deluxe	None
Seteve	None
She Nionika	None
Signor Rossi	None
Simon Lemont	None
Simpig	dub
Skail Master M	techno
Smalltown Collective	techno
Soame	disco
SonerTshichek	None
Soulfinder	house music
Soulmate	None
Sous Sol	rap
Spaghuzz	None
Special Guest	None
Speedrax	None
Sprout Haris	None
Start 2200	None
Stefano Ritteri	None
Steve Cole	smooth jazz
Strange Loving	None
Sunday	post-grunge
Support	None
Swissdeep	None
T Williams	None
TBA	techno
TIVE	house music
Tama Sumo	house music
Tanua	techno
Tarik	rap
Tatum Rush	None
Ten Walls	house music
The Alchemist	hip hop
The Chronics	None
Thom Mayr	None
Thomas Wood & Alon Levi	None
Tim Davidson	None
Timoteo	sertanejo tradicional
Tive	house music
Tom Alemanno	house music
Toni Varga	house music
Tristan Bohn	None
UK	zapstep
Uone	house music
Valentin Boesch	None
Vanita	disco
Victoria Engel	techno
Viera	deep regional mexican
Visionkids	None
W O L F M U S I C	house music
WAREHOUSE	None
Washerman	disco
Weith	None
X BADKLAAT	None
X DUBDAVE	None
X MRPIGMAN	None
Xetal	None
YONI BANKS & YAN KA	None
Yann Detroit	None
Yourube Grooves  BE	None
Yves Helbling	None
ZH	None
Zenit  Faust  Raphallus	None
Zurich	None
Zürich	None
and more TBA	None
httpsoundcloudcommrpigman	None
idle	comic
iiiü	None
manuheme & Litch aka BIFASICO  Guest	None
other location	None
ramin	video game music
skurill  BE	None
und	pop
Âme	None
