	None
& more	deep freestyle
01h25 à 02h55  Miss Duckin	None
130BPM	disco
15 CHF	None
19h00 à 20h00  Metronome Djs	None
20 CHF	None
20h00 à 20h45  Tanua	None
20h45 à 22h15  Fabian Kozelsky	None
22h15 à 23h45  Frother	None
23h45 à 01h25  Oxensa	None
2nd Opus	None
6NOK	None
959er	disco
AGENT	punk
AL NØRD	None
AL SENTO	None
ALON LEVI	None
ANALOG	vapor soul
ANDREW THE GRAND	None
ANDRI LIVE	None
ARIAS	house music
ASON	None
AXL P Aleryde	None
Aalbou	None
Aaron Khaleian	None
Abilic	disco
Abou Samra	house music
Abstract	None
Accama	None
Acumen	techno
Adam Winston	None
Adana Twins	deep
Adolpho & Franky	None
Adolpho & Franky and more	None
Adrian Martin	disco
Adrian Martin  Miniload  Nordstern	None
Adriano Mirabile	house music
Adriatique	techno
Adva	None
Afterhour guarantee location tbc	None
Agaric	techno
Agent	punk
Akt	None
Albi	None
Alci	classic colombian pop
Alessandro Crimi	disco
Alex Anderst	None
Alex Celler	techno
Alex Dallas	None
Alex G & Fame	rap
Alex Price	techno
Alex Tea	disco
Allegra Lusini	None
Alma Negra	None
Alphajet	None
Ambivalent	techno
Amsterdam	None
An21	house music
Ander	techno
Andersen	None
Andhazel	None
Andre	techno
Andrew The Grand	None
Andrey Pushkarev	techno
Andri	house music
Androgyn	hardcore
André Galluzzi	None
André Marvin	None
Andrés Marcos	None
Anemonen	None
Angelo B	None
Anima	vapor soul
Anima Dj set	None
Animal Trainer	house music
Animal Trainer  hive audio  zürich	None
Anish	disco
Anja Schneider	techno
Anna Tur	disco
Anthik	house music
Anthony	hollywood
Anthony Megaro	techno
Antix	progressive psytrance
Antja	None
Apu	None
Archie Hamilton	techno
Ari Onni	None
Arkki	None
Armonica	None
Aron	acoustic pop
Arutani	None
Astroneff	None
Ata	house music
Atish	house music
Attilio	None
Aurora Halal	disco
Avem	None
Azimute	techno
Azoth	None
Azzuro	None
BEDRAN	None
BJÖRN LOMAR	None
BL	None
BOCUSE	None
BOUND EFFECT	None
BP Zulauf	None
BS	None
Baba & Adhmad Til	None
Baden	bossa nova
Baile Musik  BE	None
Baile Musik  DE	None
Balatonbeats	None
Balouk	None
Banshee	vaporwave
Barac	disco
Barbir	None
Barem	techno
Bart Skils	techno
Basel	consort
Basic Fingers	None
Basstherapie ZH	None
Basstronauten	house music
Beda	disco
Beda & Lukas	techno
Bee Lincoln	techno
Ben Purple	None
Ben Rau	techno
Benj Hangar11	None
Benja	None
Benjamin Fehr  Catenaccio  Foundsound  Finefood Records  Berlin	None
Beppe Loda	None
Berber & Pasta	None
Berghain Ostgut	None
Berlin	house music
Bfly	None
Bfly Steiner	house music
Bfly Steiner  Nahste Oner	None
Björn Lomar	None
Blaqq & Whyd	None
Bobby & Steve	rap
Bogota	rock
Boloko	None
Bonafide 3000 ISR live Support FEA Soundsytem BE	None
Bonjour Ben	None
Bonnie	rock
Bonny & Clyde	None
Boomjacks	None
Borderline Dominik Eulberg	None
Borderliners Rec	None
Boris Dolinski	None
Boris Why	house music
Breandan Davey	techno
Brian Sanhaji	hip hop
Brothers in Arms	None
Bufiman	house music
Bunk3r RecordsSubwoofer Records	None
Byzance	None
CCO	disco
CH	None
CJPHOUS	None
CLAUDE STAFFIERI	None
CNDR	None
CUT	electronic rock
Cab Drivers	None
Cabinet Records	None
Cafe Singer Dirty Doering	None
Café Gold	None
Caillou	None
Calado	None
Camea	house music
Camiolo	None
Canson	house music
Cantina Brothers	None
Carl Jack aka Abdomen	None
Carlo Cannone	None
Carlo Ruetz	house music
Centaury	None
Central Rodeo	house music
Cesar Merveille	techno
Cesco	None
Chad Andrew	hip hop
Charles Meyer	house music
Chateau Chepere	None
Chicago Shlag	None
Chris Koegler	None
Chris Leon	None
Chris Leòn	None
Chris Rockwell	techno
Chris di Carlo	None
Christian & Raphaël	house music
Christian Elefante	None
Christian Schiemann	disco
Christo	house music
Chuck Poland	None
Cindy	pop
Cipmo	None
Claude Laurier	None
Claudio Carrera	None
Clem	ambient
Clit Eastwood	None
Club Q	None
CoMini	None
Cobblestone Jazz	techno
Cocoon	chanson
Coffy Drop	None
Cold Colors	electronic rock
Comini	None
Contexterrior	None
Copenhagen	choral
Copyright	house music
Cosi Dee	None
Cosmo & Faber	rap
Cristian Tamborrini	house music
Crosstown RebelsFR	None
Culoe De Song	house music
D Cosmo	None
D Cosmo & Faber	None
DADO REY	None
DANIEL BROESECKE	None
DFA	None
DJ Ass	None
DJ Aunt One & Napoleton	None
DJ Bazooka	None
DJ Bone & Sir D Modernist	techno
DJ Civi	None
DJ Coma	None
DJ D	trap
DJ Deenasty	None
DJ Dub	dub
DJ Emerson	techno
DJ Freezer	None
DJ JEAN BALAISE	None
DJ Jamie Lewis	None
DJ KOSMICK	None
DJ LAFOLIE ON THE MIX	None
DJ Le Roi	hip hop
DJ Mathematic	None
DJ MoRFiN	None
DJ Nünn	None
DJ Oxyxa	None
DJ POSTMAN	None
DJ PTess	None
DJ Rush	techno
DJ SCM	None
DJ SF12 & DJ LYPTIC ONE	None
DJ ST XAVIER	None
DJ Spen	house music
DJ TASTY	None
DJ Tray	None
DJ Yellow	techno
DJS	new jack swing
DJs Eli Verveine	None
DJs Green Velvet  DJ Rush  Monika Kruse  Felix Kröcher  Moonbootica  RaudiveOliver Ho  DIM  Shonky  Xenia Beliayeva  Steve Land aka Randy  Hannah Holland  Dachshund  Agnès  Smilla  Phuture Traxx  TurntableBabes  Ulli & Maesoo  Banga  Beda  Sandro Kühne and others to be confirmed	None
DJs Nik	None
DJs René S	None
DMT	vaporwave
DModestino	None
DNox	house music
DON CREEK  Freaky A	None
DVision  BE	None
DaTO	malaysian pop
Daley Padley	None
Dalibox	disco
Damon aka Nikosss	None
Dan Curtin	techno
Dan Curtin USA	None
Dan Farserelli	deep
Dan Noel	house music
Dan Welton	house music
Dan Welton and Edgar Jack	None
Dancehall  Hiphop	None
Dandy Jack	techno
Dani Casarano	techno
Dani Nydegger	None
Daniel Branco	None
Daniel Broesecke	None
Daniel Marrone	None
Daniele Cosmo	None
Daniele Mastracci	groove room
Danielson	swedish
Danielson & norbertto	None
Dany Movida	None
Daria	techno
Dario DAttis	disco
Dario DAttis Official	None
Dario La Mazza	None
Dario Sorano	techno
Darren Flecta	house music
Darrien	hardcore
Das Blenden	None
Das HOUSE	None
Das Pferd	None
Dave Eleanor	rap
Dave Multitask	None
David Armada	disco
David Delgado	hip hop
David Durango	techno
David Fernaux	None
David Torr	disco
De La Maso	rock
De la Bass	trap
DeWalta	techno
Dean Breda	None
Deep n Dub	None
Deeperfect	None
Deetron	techno
Defend	rock
Definition	hardcore
Dejan	None
Dejan  Cityfox	None
Delakeyz	house music
Dement3d	None
Dement3d  CH	None
Der Dirigent	None
Desolat	None
Did Low	None
Die Kistenkerle	None
Diego Indigo	None
Diego Vendossa	None
Digitalism	electronic rock
Dinan	None
Dineo	None
Dirty Greg	None
Divided Rec	None
Divinity	None
Divus Berlin	None
Dixon	soundtrack
Dj Klash aka Klashizzle	None
Dj RP	None
Dj Toyo	None
Dj Yan Bruno	None
Djazzy	dub
Djerry C	None
Djs	new jack swing
Doma	hi-nrg
Domenico Dagnelli	None
Domenico Rosa	disco
Don Ramon	argentine reggae
Doppelpack	None
Doppelt Gemoppelt	techno
DoubtingThomas	techno
Dream	pop
Dropout Agency	None
Dropout Agency  BE	None
Drumcell	techno
Dubculture  BE	None
Duff	pop
DuoRhythm	None
Durdek & Kubin	None
ELAY	None
ETYPE	None
EXTRASTUNDEN JONATHAN SOLO	None
Echo 106	house music
Ed Luis	None
Eddie Thoneick	house music
Edgar Jack	techno
Edgar Jack and Marrocco	None
Eelke Kleijn	house music
Eintakt	None
Ekserd	disco
El Alusinante	None
El Tigre Sound	None
Elevated	None
Elex Morano	None
Eli Verveine	techno
Elrino	None
Emage	None
Emre	turkish
Ena Lind	techno
EngBang	None
Enzo Lo Conte	None
Enzo Pianzola Mauro Capitale	None
Enzo di Caprio	None
EnzoMrTrendPianzola	None
Ephrem Luechinger	None
Erasmus & Krieger	None
Eric Borgo	house music
Euphoria  CH vs UK	None
Evo & RST	None
Extrastunden	None
Extrawelt	house music
Ezikiel	techno
FABIAN BINKERT	None
FLAVIO	channel pop
FLINKE FINGER	None
FLYING AWAY	None
FRAnk K	None
FRED LICCI	None
FREDi Salomon	None
Faber	emo
Fabien	None
Fabio Papa	None
Fabio Riccio	None
Fabio Siverino	None
Fabio Tamborini	None
Fabio Tamborrini	disco
Fabri	None
Fabø	crunk
Fantastic Friends  Highgrade  Metroline Limited	None
Fat Sushi	house music
Faust	classical performance
Faux Couture	None
Federico Molinari	techno
Feel X	None
Fehlfunktion	None
Felix Kröcher	schranz
Fenomen	hip hop
Figure	rock
Finnebassen	house music
First Claz	None
First Deck	None
Flapjackers	house music
Flavio	channel pop
Flieder	None
Floor 1	None
Floor 2	hi-nrg
Florian Defunes	None
Florian MSK	None
Florin	romanian pop
Flowbuster	None
Fourth Kind	None
FranG	classical performance
Francesco Ballato	None
Franck C	None
Frank C	folk
Frank Sonic	techno
Frank Vespari	None
Frank Vespari & Little Victor	None
Frank Vespari b2b Litte Victor	None
Franky Fiction	None
Franky Fourfingers	None
Franz Filter	None
FreakBoutique	None
Freaky Charly & Oscar Niczzo	None
Fred Licci	None
Fred Linger	disco
Fredy S	rock
Fretzki	None
Friday	pop
Friede Freude Freitag	None
Frogoroth	None
Fulvio Cala	None
GD	k-pop
GHETTO PO	None
GL Everest	None
Gallo	None
Garance	techno
Gary Beck	techno
Gayle San	schranz
Gel Abril	house music
Gera	None
Get Funky  BE	None
Get Physical	None
GetBuzz	None
Ghetto Po	None
Ghost	metal
Gianni & more	None
Gianni Callipari	disco
Gianni Parrini  Rimini  Italia	None
Gio Amenkov	None
Giorgio Maulini	techno
Giusi Consoli	None
Gobbit	None
Goetzlich	None
Goldfinger Brothers	hip hop
Goldoni	None
Gomorra	techno
Gordan Starr	house music
Gravina	techno
Gravina & omar	rap
Gray Chalk	None
Greeen & Moeraki	None
Greg Iaia	None
Greg Iala	None
Greg la Brelle	None
Gregorythme	techno
Guel	None
Guy Joshua	None
Guzzle	None
Gypsis	None
Gypstrip	None
HERTS	None
HOBI	disco
Hang	new tribe
Hans Bouffmyhre	techno
Haydn	classical
Heartleader	None
Heimat	hip hop
Heimat Peer Kusiv	None
Helder b2b Joram	None
Hemmann & Kaden	house music
Herman	tin pan alley
Hermansson & Martinez	None
Hernan Cayetano	None
Herr Meyer & Sentio	None
Herr Müller	None
Herrrouine	None
Herzschwester  Gelbes Billett Musik	None
HiGY	None
HighLive	None
Highlife	None
Hive	indie poptimism
Hive Audio	None
Honey Dijon	house music
Huazee	None
Idealist	ambient
Igor Blaska	None
Igor Blaska & The Mad Family	None
Ilona Maras	None
Inside Floor	None
Instant Rave	None
Intro by Andersen	None
Intro by Meschuggo	None
Intro by Rocca & Dineo	None
Ion Ludwig	None
Italoboyz  Marco Donato	None
Itiswhatitis	None
Ivan R	None
Ivo Christow	None
J Sayne	None
JACKSMIN	None
JAKSMIN	None
JASHARI	None
JD Hakulinen	None
JOHN MAD & NORA	None
JOHN TAALSBERG	None
JOHNNY QUEST	indie
JOHNY BLAZE	None
JONE & Max Nero	None
JOSKO ANTEK	None
JPTR	None
JR	hip hop
JSebK  many more	None
Jack & the Jerk	None
Jack Pattern	techno
Jam On	None
Jame Mc Hale	None
Jame McHale	None
James Mc Hale	None
James Pants	idm
Jamie Jones	techno
Jamie Lewis	house music
Jan Krueger	None
Jan Schulte	None
Jashari	None
Jaso LIVE	None
Jauss	None
Javier Moreno	house music
Jay Mas	None
Jeff Swing	techno
Jem Haynes	house music
Jena	idol
Jimi Jules	disco
Joachim Spieth	disco
Joe Mckechnie	house music
Joe Mckechnie & Will Sergeant	rap
John Boston	None
John Lemon	techno
Johnita Lemonetta	None
Johny Blaze	None
Joker	trap
Joris Belzin	None
Jorven	None
Josh Wicks	None
Juen & Bach	None
Juliano Lopez	disco
Julietta	vapor soul
Junior B	None
Junior Boys	electronic rock
JusEd	None
Juzz	disco
KAI HILLMANN	None
KENT	trap
KK3D	None
KONPIUTALIVE	None
Kaan Düzarat	None
Kaiser & Giraffe	None
Kalabrese	house music
Kalmou	None
Kantarik	hip hop
Katta	None
Kejeblos	None
KevKev	None
KevKev & Mahlermeister	None
Kevin Shala	techno
Khaderbai	abstract beats
Khidja	house music
KiMi	None
Kid Konzoom	None
Kim Prevedello	hip hop
Kiril Bikov	None
Kiste	None
KlangFormer	None
Knor	None
Kodbar	None
Konrad Dycke	None
Konstantin Sibold	techno
Kopfkino 3D	None
Kosta Dee	deep freestyle
Kraftwerk	rock
Krill Music	None
Kruse & Nuernberg	disco
Kufanya	None
Kuhlmann	deep pop edm
Kun	None
Kunstraum Walcheturm  Kanonengasse 20  8004 Zürich	None
König Balthasar	None
LA MINE EXPRESS	None
LAD	hardcore
LAMPENFIEBER	None
LEE  O	None
LEE N EFFE	None
LEONARDO	cantautor
LEWIS	None
LITTLE D	None
LIVE AT SET	None
LIVE Alessandro Parisi	None
LNF	hip hop
LUCA GEROSA	None
LUIS RODRIGUES	accordion
LXIR	None
La Forêt	None
La Luciole	None
La Mine Express	None
Lando	techno
Laolu	techno
Larytta	techno
Laurent Charbon	disco
Lausanne	None
Lazare Hoche	house music
Le Baron	house music
Le Citadin	None
Le Noir	azontobeats
Lebensfreude	None
Lee Van Dowski	techno
Lee Webster	techno
Lehar	romantic
Leke da Loco	None
Lesnicar	None
Letabli	None
Leventino	None
Lexx	disco
LichtDEFEKTE von Van Nutt	None
Lineup	None
Lineup Indoor  Mainfloor	None
Lineup Open Air	None
Ling & Mexx	None
Lionel Stephan D	house music
Little Victor	None
Live Digitalism  Gus Gus  Lexy & KPaul  The Advent  Dapayk & Padberg  Dusty Kid  Heartthrob  Einzelkind	None
Live Familie Schweizers Wohnzimmer	None
Live Pitsch & Magnano	None
Lo2	None
Local Support	None
Lolo	indie poptimism
Look Like	house music
Lord Kesseli & The Drums	None
Loris Scaglia	None
Los Cruzeiros	disco
Los Wenamigos	None
Los Wenamigos & After party w Alex Niggemann	rap
Louie Liköör	None
Luca Barletta  Oliver von Mentlen	None
Luca Fiorelli	None
Luca Torre	techno
Luca de Grandis	None
Lucas Monème	None
Lucas Ramirez	None
Luciano b2b Ernesto Ferreyra	None
Luciover	None
Lui Young	techno
Luis Roza	None
Luk	estonian pop
Lukastel	None
Lukie Wyniger aka UNCLE PENG PENG	None
Lukie Wyniger aka Uncle Peng Peng	None
Lützenkirchen	techno
MALEKOS BEUTEL & AMARU	None
MANDY  Patrick	None
MARC BENZ	None
MARQUE AUREL & MUSIC P	None
MAS RICARDO	None
MATHIO	None
MAURO CAPITALE  Enzo Pianzola	None
MAUVE	None
MAX CELLI	None
MC Jay	None
ME & her	rap
MIKE T	deep pop r&b
MIRCO CARUSO	hip hop
MRJUKE	None
MRTREND	None
MTDF	house music
Madame Kenel live	None
Mado	None
Madwave	None
Magicstone	None
Magit Cacoon	disco
Mahlermeister	None
Main Floor	None
Main Room	None
Makau	techno
Malik	pop
Manon	techno
ManuHeme	None
Manuel Fischer	None
Manuell	hip hop
Manuelle Musik	None
Manuheme	None
Marc DArrigo	house music
Marc Evans	house music
Marc Fuhrmann	None
MarcIntosh	None
Marcel Fengler	techno
Marco Bailey	techno
Marco Capone	None
Marco Effe	techno
Marco Folli	None
Marco Resmann	techno
Marco da Mata	None
Marcos	house music
Marcos Del Sol	None
Marcos del Sol	None
Marcow	None
Marcus Meinhardt	house music
Marika Rossa	techno
Mario Ferrini	None
Mark Stone	None
Markova	opm
Markus Homm	techno
Markus haZe	None
Marosh Kopp	None
Marque Aurel	None
Marrocco	None
Martelli	channel pop
Martin Buttrich	techno
Martin Eyerer	techno
Masaya	hip hop
Mastra	deep
Mastra Live	None
Mater Fader	None
Mathias Kaden	techno
Mathias Mesteno	techno
Matthias Tanzmann	techno
Matto	electronic rock
Mattoo	house music
Maurice n Morris	None
Me Dro	None
Mehmet Aslan	house music
Meikel	techno
Melchior	punk blues
Memnok	techno
Mia	electronic rock
Mia Kaltes	None
Mia Kaltes  Finefood Records  Switzerland	None
Miau Studio Floor	None
Mic Drive	None
Michael Fate	None
Michael Fresh	None
Michael Gull	None
Michael Seelenruhig	None
Michal Ho	None
Michel Cleis	None
Mickail	None
Miett	None
Miguel	pop
Mihael Simic	None
Mihai Popoviciu	house music
Mihigh	techno
Mike Kay	None
Mike Väth	None
Milos D	None
Mimmo	None
Mind Against	techno
Miniload	None
Minimat & nanard	techno
Minimo Imprint	None
Mirax	None
Mirco	house music
Mirco Caruso	hip hop
Mirko Loko	techno
Modestino & Ed Luis	None
Modnar	None
Monika Kruse	techno
Monkey Safari	house music
Monocline  Planet Rhythm	None
Monoteque	None
Monotox	None
Moonharbour	None
Morbid Sound	None
Morgan Tomas	techno
Moscoman	house music
MrLucky	house music
Ms Hyde  Fabelhaft  Lady Bruce & YaYa	None
Mucho Stylez	techno
Murciano	house music
Murphy	rap
Mushrooms Project	house music
Music From Memory  Amsterdam	None
Music P	hardcore
Music selected by	None
MÉNAGE À TROIS	None
Médiateur Electronics  F	None
NDKj	techno
NED ONEAL	None
NESHA	None
NICED	None
NICKY F	None
NINETOES	house music
NTO	techno
NUKEM	house music
Nahste Oner	None
Natch	techno
Nath	None
Ned O Neal	None
Neekee	None
Neevo	None
Nektar	rock
Nelson De Jesus	None
Nemok6	None
Nenad J	None
Neon Golden VJ	None
Nervös	rap
Neutronix	None
Nici Faerber	hip hop
Nico	pop
Nico Mariani	None
Nico Pusch	house music
Nicola Koch	house music
Nicola Zoli	None
Nicolas Duvoisin	disco
Nik Frankenberg	None
Nikolaj Tange Lange	None
Nima Gorji	techno
Nina Nana	None
Ninette	None
Noel Audio	None
Noir	chamber psych
NorbertTo	None
Norbertto	None
Nous	house music
Noé Weigl	None
OLIVER CLICHÉ	None
OLIVER K	re:techno
OTIST RIDDIM	None
Offen Music	None
Oli Allen	None
Oliver Aden & Luis Cruz	None
Oliver Dollar	house music
Oliver K	re:techno
Oliver Koletzki	house music
Ollin	None
Onur Gokhan Gokcek	None
Onur Özer	techno
Openair Sven Väth	None
Opuswerk	techno
Oram Modular	None
Oscar Schubaq	house music
Oslo	orchestral
Osunlade	house music
Outside Terrace Floor	None
Ovum	None
Oxia	techno
Ozan	turkish
P Carrado	None
PASCALLA	None
PASCI	None
PBell	None
PBen	None
PEDRAM	None
PHILLIP INÄBNIT	None
PHURPA	None
POSSA	None
PTess	None
Pablo Einzig	techno
Pacifica	string quartet
Pacman	trap
Panevino	None
Paolo Paleologo	disco
Paride Saraceni	None
Pascal Viscardi	house music
Pasci	None
Pask	None
Pat Patrisha	None
Patrique B2B Luca Vallante	None
Patrischa	house music
Paul Eg	techno
Paul Thoma	None
Pavel live	None
Pawlikowski	classic polish pop
Pazkal	house music
Pech & Schwefel	None
Pedram	None
Pender Street Steppers	None
Pepe Brogna	None
Perlon  Berlin	None
Permanent Vacation	techno
Pete & Pete	hip hop
Peter Schumann	house music
Peter Szanto	None
Pfeffy	None
Phil Asher	breakbeat
Phil Cole	disco
Phil Riss & Ali C	None
Phil zviel	None
Philip G Cifuentes	None
Philippe	orchestral
Philippe Petit	techno
Philippe Petit all night long	None
Phrex	None
Phuture Traxx	house music
Piero P & Luigi Forte	None
Pietro Mancini	None
Pino Arduini	None
Piratenkind	None
Pixelpunks	None
Playlove	techno
Pochatz	None
Press C	None
Priku	disco
Procid	None
Proud	None
Psycho Weazel	None
Puma	house music
Purple Project	None
Purpurea	None
Qebeq	None
Qebeq & special guest	None
Quan	rap
Quarion	techno
Quitim	None
R San	None
RAPU B2B Nekow	None
REVERSE	metalcore
REX & DUX	house music
RINO	rap
RJR	None
RTec	None
Raban	None
Radio Slave	techno
Radro	None
Radro & DANIEL MARRONE	None
Raf Dask	techno
Rainer Trüby	None
Ralf dj	None
Ralph Sliwinski	techno
Raphael Dincsoy	techno
Raphaello	None
Raw Vox	None
Ray Jones	None
ReAxis	disco
Regenbogen	ostrock
Reloading rec	None
Residents	rock
Reto Ardour	techno
Revolvercanada	None
Rhadoo	None
Rick Even	None
Rino	rap
Ripperton	soul
Robby Naish	None
Robel	None
Robert Nesta	None
Roberta Nicholls	techno
Roberta Nicholls all Day	None
Robin Martinelli	None
Rodri	None
Roger Torroni	None
Rogi	None
RolandSousa	None
Rolf Imhof	None
Romano Rapeso	techno
Romano The Alchemist	None
Romar	rap
Romeo	tropical
Ronald Grauer	None
Rotary	jazz funk
Rotchopf	None
Round Table Knights	house music
Roy Misher	None
Ruben Coslada	None
Ruede Hagelstein	techno
Rufio	punk
Rusconi	None
Ryan Crosson	techno
Ryan Hawkin	techno
Ryan Hawkin & Konpiuta	rap
SEBASTIAN WOJKOVSKI	None
SERGIO MUSA	None
SHKAMB	None
SIMON	folk
SIMON EFFECT	None
SK Supreme	None
SNARDI	None
SONABZ	None
SRubinfeld	None
STEFAN BINIAK	None
Sa 2609 1200  100	None
Sabb	techno
Salvatore Freda	house music
Salzunpepper	None
Sam Divine	house music
Sam Genious	None
Sampayo	None
Samsara	electronic rock
Samuel andre madsen	techno
San Francisco	None
San Marco	deep orchestral
Sandro Kuhne	None
Sandro Kühne	None
Sanmon	None
Santoros	rock
Santosh Khan	disco
Santé	deep
Sascha Braemer	house music
Sascha Cigrovski	None
Sascha Rohrer	None
Saturday	None
Saty	None
Saved	anthem worship
Sche Sche	hip hop
ScheSche & Mismo	None
Schwebekasten	None
Schwester Gill	None
Scott Bradford	house music
Scott Kemp	techno
Sdanke	None
Seb Blake	disco
Seb Blake & Albi	rap
Sebastian Groth	techno
Sebastian Spring	techno
Sebastian Wojkovski	None
Sebastian Wojkowski	None
Second Deck	None
Sedzed	None
Sedzed b2b El Alusinante	None
Senoo	anime score
Sentiment	None
Serafin	orchestral
Seranthony	None
Servet Argin	None
Session Deluxe	None
Seteve	None
Several Definitions	house music
Sex Organs	None
Shahira	None
Shaka aka Kurt Spichiger	None
Shonky	techno
Signor Rossi	None
Silencio	rock
Silent Neighbors	None
Silvision	techno
Simon & Shaker	deep uplifting trance
Sinisa Tamamovic	techno
Sirion	progressive psytrance
Skaos	ska
Smalltown Collective	house music
Smos	None
So 2709 1200  100	None
Soame	disco
Sonabz	None
SonerTshichek	None
Sonja Moonear	None
Sonny Catanese	None
Soulmate	None
Sous Sol	rap
Special Guest	None
Special Guest Mia Kaltes	None
Special K	rock
Speedrax	None
Spikers	None
Squep	house music
Starsand	None
Start 2200	None
Stassy	None
Stealth RecordsUK	None
Steeve March	disco
Stefan Goldmann	techno
Steffen Flum	None
Steiner	soundtrack
Sternenwanderer	None
Steve Cole	smooth jazz
Steve OSullivan	techno
Steven Beyer	techno
Steven Stone	None
Stimming	techno
Stockholm  SE	None
Strange Loving	None
Strassenmajor	None
Strb	None
Styro 2000	None
Subban	None
Substance	techno
Sunday	pop
Sunday Breakfast	None
Super Flu	house music
SuperFlu	None
Supersonic Sound	None
Sven Schaller	techno
Sven Väth	techno
Swissdeep	None
Symphonix LIVE	None
Syntec	electronic rock
Syracuse	disco
System RecSUI	None
TAF	neo metal
TANZWIESE	None
TBA	techno
TBird	None
TECHNO WHYNOT	None
THE FLYING MUSTARDS	None
THEX	None
TIVE	house music
TNT	None
TOBI DREIPOL	None
TOYBOYS	None
TROMBETA	None
TUBA	brass ensemble
TWO ME	None
Tako & Jamie Tiller	house music
Tama Sumo	house music
Tanua	techno
Tanzamt	None
Tapirus	None
Tarco	None
Techno  Why Not	None
Teenage Mutants	house music
Teki Tekua	None
Terrazza Floor	None
Terry	ambient
The Cruzaders	rock
The Cube Guys	house music
The Essentials	None
The M&B Experiment	None
The Toyboys	None
Thom Mayr	None
Thom Nagy	None
Thomas Schumacher	techno
Thomas Wood & Alon Levi	None
Tiari	hip hop
Tiefgeist	None
Till Tape	None
Timbee Rec	None
TimbeeSUI	None
Time Has Changed	None
Timo Maas  Rocket & Ponies  Coccon	None
Timothy J Fairplay	None
Tin Man	techno
Tolga Kéz	None
Tom H	None
Tom Novy	house music
TomTeeT	None
Tomcraft	techno
Toni Varga	house music
Tonic	rock
Tony Garcia	freestyle
Torsten Kanzler	schranz
Toy  O	rock
Tracknics	None
Trio Heinz Herbert	None
Tristan Bohn	None
True	None
Tryphon	None
Tschespito	None
Twisted FrequencySUI	None
Twoets	None
UK	zapstep
USA	None
Umbe Nalle	None
Unbe Nalle	None
Undercatt	house music
Underground Connexion	None
VAlpen	hip hop
VAlpen aka Dachshund & Dave The Hustler	None
VJ Bildspur	None
VJ Gremi	None
Vakant	None
Valentin	cumbia
Valentino	pop
Valerio Raponi	house music
Vanessa Sukowski	None
Vanita	disco
Vario Volinski	house music
Victor L	None
Viera	banda
VincentIulian	None
Visionkids	None
Visuel par VJ Badbeat	None
Vkee	None
Vladimir Corbin	house music
Vladimir Ivkovic	None
Vlnolam Kawumski	None
W O L F M U S I C	house music
WURZELFLOOR	None
Waldherr	None
Walter Albini	None
Walter Wolf	None
Wandler	techno
Wankelmut	house music
Washerman	disco
We Dig Underground  Mad Rey	None
Wed Techno  CH	None
Wehbba	techno
Whim	techno
Wicked Wilma	None
Will Sergeant	None
Wolf Müller	None
Woody	blues
Wunschkinder	None
XOSE	None
Xander Valley	None
Xose	None
YONI BANKS & YAN KA	None
Yann Detroit	None
Yare	None
Yaroslav Lenzyak	house music
Yougene	None
Yourube Grooves  BE	None
Yves Helbling	None
ZOO	None
Zenker Brothers	None
Zozo	techno
Zrk	techno
Zurich	None
Zürich	None
and more TBA	None
and others	None
andri	house music
aron	acoustic pop
