	None
& more	deep freestyle
& more TBA	None
&ME	metalcore
0000  0100  MAHMOOD	None
0000  0100 DJ Olafson	None
0000  0100 Pascal Tokar	None
0000  0100 STEPH COLE	None
0000  0145 Pig & Dan	None
0000  0200	None
0000  0200  Clara	None
0000  0200 FION 2000	None
0000  0530 Av Skardi	None
0000  ANDROO	None
0000 Andrea Oliva	None
0015 Kollektiv Turmstrasse	None
0030  0200 Darsen	None
0030  0530 SOFA TEE & HERMES	None
0030  END	None
0030  END  JEANTOUSSAINT & 2000	None
0045 Guy Gerber	None
00h ENDt	None
00h00  02h00tDJ Dub	None
0100  0200  ARTMAILLE	None
0100  0200 Cosmic Bastards	None
0100  0200 Nick Berola & Daniro	None
0100  0300 Chris Liebing	None
0100  0300 Gelivan	None
0100  0400 Dr Lektroluv	None
0130  0330 Ellen Allien	None
0130 AKA AKA feat Thalstroem	None
0140 Dandi & Ugo	None
0145  0330 Sascha Braemer	None
01h25 à 02h55  Miss Duckin	None
01h30  Oxensa	None
0200  0300 Dilly Noises	None
0200  0330 Gelivan	None
0200  0400	None
0200  0400  Daniel Wang	None
0200  0400  Substance aka DJ Pete	None
0200  0400 Anthony Parasole	None
0200  0400 Steve Angello	None
0200  HORASSE & Tissu	None
0200  Soichi Terada	None
02192016	None
02202016	None
0230 Carl Cox	None
02h00  04h30tPhly	None
02h30  Hobo	None
0300  0400 Robert Tune	None
0300  0500 Len Faki	None
0300  Alan Bolumar	None
0300 FormatB	None
0320 Torsten Kanzler	None
0330  0430 Lexy & KPaul	None
0330  0500 NDroo	None
0330  0515 Catz N Dogz	None
03h30  Damian Deroma	None
0400  0500 Dave202	None
0400  0500 Marco Rossi	None
0400  0500 Mr LuWi	None
0400  0530  Strb	None
0400  0530 OJIE	None
0400  05h30	None
0400  END  Crowdpleaser	None
0430  0530 Manon	None
0430 Animal Trainer	None
0430 Len Faki	None
0500  0630 Felix Kröcher	None
0500 Darrien	None
0515  0630 Klaudia Gawlas	None
0530  0630 BMG	None
05h00  08h00 Fabien	None
08h00  10h00 Frango	None
10 Jahre Rakete Openair presents The Lake	None
100Tons	None
10h00  11h30tDandy & Trony	None
10h00 11h30tVoltmar	None
11h30  13h30tBertel Gee	None
11h30  13h30tProfondo	None
12h00  13h30 Simon Effect	None
13h30  15h00 Mia Kaltes	None
13h30  15h00tDjerry C	None
13h30  15h30tVolta	None
15 CHF	None
15h00  16h30 Marco da Mata and Matthew LIVE	None
15h00  17h00tEurokai	None
15h30  16h30tVan Hai	None
1600  1900 JEAN TOUSSAINT & 2000	None
16h30  18h00 dAN from Bern & Steffi SoWeso	None
16h30  18h00tDani Casarano	None
17h00  18h30tHorizontal Vertikal	None
1800  0200  MARTIN GIRALDO aka DJTAL	None
18h  22h  Jean Clef	None
18h  22h  Pascal Viscardi Saft Recordings	None
18h  22h  Seteve	None
18h00  19h00 Matija	None
18h00  20h00tAjele	None
18h0022h00 Pascal Viscardi  DEEP HOUSE  RARE GROOVE	None
18h30  20h00tNils	None
1900  2100 ARTMAILLE	None
1900 Vertical Surround Performance mimetic	None
1940 Vertical Surround Performance mimetic	None
19h  22h  Constellation  Juicy Fruity Funky Fresh Life Beats & Rhymes	None
19h  22h  Felix Et Chat	None
19h  22h  Marlon & Andreas	None
19h  22h  Rony KN	None
19h00  21h00 Plastic FM LIVE	None
19h00 à 20h00  Metronome Djs	None
20 CHF	None
20 years Root Down  Compost Records feat	None
2020 Vertical Surround Performance mimetic	None
2020 Vision	None
20h00  21h30tAndri	None
20h00 22hh00tSonja Moonear	None
20h00 à 20h45  Tanua	None
20h45 à 22h15  Fabian Kozelsky	None
2100  2300 MAHMOOD	None
2100 Vertical Surround Performance mimetic	None
21h00  23h00 Don Ramon	None
21h30  23h30tValentino	None
2200  0100  MEGABLAST & MAKOSSA	None
2200  0630 Various Chill Out DJs	None
2200  2230 DBMM	None
2200  2230 Merik & GStone	None
2200  2245 Sergio Trillini	None
2200  2300 Steph Cole	None
2200 Dejan	None
2200 Del Sol	None
2200 Sergio Trillini	None
2215 Stefano Noferini	None
2230  0000 Nils Hoffmann	None
2230  2330 Smalltown Collective	None
2245  2345 DJerry C	None
22h00  1h00  Metro Area	None
22h15 à 23h45  Frother	None
22h30 ENDt	None
2300  0000 Daniel Wang	None
2300  0000 RoMix	None
2300  0000 SAMD FURIOUS	None
2300  0000 SamD Furious	None
2300  0030 Daniro & Nick Berola	None
2300  0100 mastermark	None
2300 Djerry C	None
2315 KlangfabriK	None
2330  0100 Klangkarussell	None
2330 Marek Hemmann	None
2345  0130 Wankelmut	None
23h00  PhNeutre	None
23h45 à 01h25  Oxensa	None
25 years Ninja Tune feat	None
2Takt	None
2econd Class Citizen	ninja
2nd Opus	None
3010	rap
47  FR	None
4T	None
6NOK	None
959er	disco
A Friend	emo
A Heiniger	disco
A State of Mind	None
A touch of deep	None
ABGESAGT	None
ACES A	None
AFTER PARTY  01H00  05H00	None
AG	hardcore
AL NØRD	None
ALES NAPS	None
ALEX PATCHWORK	None
ALL NIGHT LONG	None
AM	pop
AMARO	reggaeton
AMari	None
ANALOG	vapor soul
ANDREAS & MLK	rap
ANDREJ	None
ANDRI LIVE	None
ANDRÈS GARCÌA	None
ANDY GUHL	None
ANGEL	indie
ANGELICA FRAVI	None
ANTHONY  TÃTON  NICOLAJ  Mr Silent & She DJ Vany	None
ANTHONY  TÉTON  NICOLAJ  Mr Silent & She DJ Vany	None
ANswer	None
AOKI takamasa	ambient
ASM	None
ASMIAR	None
AST & KLAUDIJA GROOVIN GOLIC	None
ATN	None
AXL P	None
AXL P Aleryde	None
Aaawesome Colors	None
Aalbou	None
Aaron HaÃ»s	None
Aaron Haûs	None
Ab & Artig	techno
Abel	deep indie r&b
Abigail Bailey	None
Abilic	disco
About Paula	None
Abstrhytmik	None
Abyssinie Club	None
Acaso	None
Acid Arab	house music
Acid House	c86
Acid Pauli	house music
Acker	easy listening
Acktivism	None
Acousmie	None
ActFact Records	None
Actamin	None
Acumen	techno
Adam Port	disco
Adam Wiston	None
Adana Twins	deep
Adolpho & Franky	None
Adolpho & Franky and more	None
Adrian Amirail	None
Adrian Bergmann	None
Adrian Bergmann anyideas	None
Adrian Flavour	None
Adrian Martin	disco
Adrian Martin  Miniload  Nordstern	None
Adriano	disco
Adriano Mirabile	dub
Adriatique	techno
Adrien	None
Adry	None
Adryan	None
Aeed	idm
Aeffryboedy	None
Aerophobica	None
Africaine 808	fluxwork
Afrojack	house music
Afronaught	breakbeat
After Grauer	None
After after party  Sidewalk Cafe	None
AfterBoat	None
AfterParty mit Nicolas Kazimir	None
Afterhour guarantee location tbc	None
Agape	None
Agaric	techno
Agent	punk
Agonis	None
Agoria	techno
Ajele	None
Akinetik	None
Akowa	None
Aktaruss	None
Aktuelles Album Friede Freude	None
Aktuelles Album Mo Kolours	None
Aktuelles Album Observatory	None
Akua Naru	None
Akwarium	None
Ala Vs Dinasty	None
Ala Vs Dynasty	None
Alain	classical piano
Alain Heiniger	None
Alain Roy	None
Alain Szerdahelyi	None
Alan Dente	None
Alan Fitzpatrick	house music
Alan K	techno
Albee	None
Albert & Hofmann	None
Albert Hofmann aka Sins & GaLaBar	None
Albi	None
Alci	vallenato
Alden Tyrell	electro
Ale Marquez	disco
Alejandro Mosso	techno
Alessandro Bertolino	None
Alessandro Crimi	disco
Alessio	None
Alessio&Dominik	rap
Alex & Digby	rap
Alex Attias	breakbeat
Alex Bau	techno
Alex Belluscio	None
Alex Beluscio	None
Alex Beluscio &Marvin Meyer	None
Alex Celler	techno
Alex Dallas	None
Alex Dallas  Washerman	None
Alex Dima	None
Alex Kostic	None
Alex Lore	None
Alex Mendes	disco
Alex Mine	house music
Alex Niggemann	techno
Alex Picone	techno
Alex Price	techno
Alex Pro	None
Alex Tea	disco
Alexandre Eco	None
Alexis Cabrera	techno
Alfonso Forte	techno
Algorythmik	electro music
Alice Russell	downtempo
All Day I Dream	None
Alle Farben	deep
Allemagne	None
Allen Rich & Gaultier Barras	None
Alma Negra	None
Alma Soul	None
Aloan	None
Along with his teammates DJ Spinn and DJ GantMan	None
Alphajet  TheFamily  Winterthur	None
Altar of Flies	noise
Alternative Floor	None
Aluk Todolo	metal
Alx	reggaeton
Amaro	reggaeton
Ambareesh	None
Ambivalent	techno
Amenthia	None
AmnÃ©sia	mandible
Amnésia	bass music
An21	house music
AnGy KoRe	techno
Ana Eva  The Kitchen Room	None
And Hazel	None
AndId	techno
Andaloop	disco
Ander	techno
Andersen	None
Andhim	house music
Andi Malanders	None
Andre	techno
Andrea Festa	techno
Andrea Festa  CH	None
Andrea Frisina	disco
Andrea Giamboni	None
Andrea Oliva	house music
Andrea Pesta	None
Andrea Roma	techno
Andreas	swedish
Andreas Foxx	techno
Andreas Henneberg	house music
Andreas Ramos	disco
Andri	deep
Androgyn	hardcore
André Duracell	None
André Galluzzi	None
André Marvin	None
André Reuse	None
Anemonen	None
Angel Haze	indie r&b
Angelica Fravi	None
Angelica Fravi Aka Angy Dee	None
Angerfist	hardcore
Angy Dee	None
Anima	vapor soul
Anima Dj set	None
Animal Trainer	deep
Animal Trainer  hive audio  zürich	None
Anish	rap
Anja	techno
Anja Schneider	techno
Ann Clue	None
Anna Ternheim	swedish
Anna Tur	disco
Anomis	None
Anthik	house music
Anthony	hollywood
Anthony Cat	None
Anthony Dandrea	None
Anthony Megaro	techno
Anthony Shake Shakir	techno
Antipop Consortium	hip hop
Antix	progressive psytrance
Antja	None
Anton Madera	disco
Antoni Bios	disco
Apashe	trap
Aphex Twin	electronic rock
Apu	None
Aquarius Heaven	disco
Archie Hamilton	techno
Area Remote	None
Argentina	romantico
Argentine	None
Ariel Kinsky	None
Arival	None
Arival b2b Coolcat	None
Ark	vapor
Arkki	None
Arnstroem	None
Aron	acoustic pop
Arthur Russells Instrumentals Directed by Peter Gordon	None
Arthur Verocai	bossa nova
Artik	russian pop
Artimix	None
Artmaillé	None
Arutani	None
Ash kidd	rap
Astroneff	None
Ata	techno
Atari Teenage Riot	hardcore
Atjazz & Jullian Gomes	rap
Atlantiks	None
Attias	None
Audino	None
Audino & Barbir	None
Audio Dope	None
Audio Dope & Zois	None
Audio Jack	techno
Audio Soul	None
Audio Werner	techno
Audiohm	None
Audiojack	house music
Audioline	None
Audionotica	None
Aulay	None
Aulay Fou	disco
Aulay Fou aka Purabronca	None
Aulay Purabronca	None
Aus	metal
Autechre	techno
Autistic	techno
Automathi	None
Avatism	disco
Avem	None
Avesta	big room
Avicii	house music
Awanto3	hip hop
Aware	None
Awesome Tapes From Africa	disco
Axel Boman	house music
Aytunç Köles	None
Azadeeh	None
Azaxx	None
Azuni	techno
Azur	None
Azymuth	jazz
B Y Z Å N C E  Deepethnic Music	None
B2B	None
BASS N SMILE	None
BE	rock
BEATSPOKE	None
BEDRAN	None
BEN MUETSCH	None
BERLIN	house music
BERNARDO	None
BFLY STEINER	house music
BFORE	None
BILDER vom Club	None
BK	techno
BL	None
BLAUSON	None
BLKND	None
BNX	None
BOBBY & STEVE	rap
BOCUSE	None
BOLD	hardcore
BOOTMAKER	None
BOUND EFFECT	None
BP Zulauf	None
BPM Project	None
BS	None
BUVETTE live	None
BVoice	techno
Baba & Adhmad Til	None
Baba Roga	None
Babo	None
Bacalao	video game music
Backspin Boys	None
Backstube	None
Bad Chance	None
Bad Man vs Dirty Harry	None
Bad Nelson	None
Bad Nelson Darsen	None
Bad News	None
Baden	bossa nova
Bahia BlancaAR	None
Bala M	None
Balatonbeats	None
Balouk	None
Baltazzar	None
Balzklub	None
Balzklub Rollo Tomasi	None
Bang Goes	None
Banshee	escape room
Bar	funk
Bar 25	None
Bar 25  Zürich	None
Barbir	None
Barcelona	dreamo
Barem	techno
Barenhvrd	trap
Baroz	None
Bas Ibellini	None
Basel	consort
Basel Deep House Youngstars	None
Bashkim	None
Bass Clef	bass music
Bass Warriors	breakbeat
BassbÃ¼ro	None
Bassbüro	None
Bassnsmile	None
Basstherapie ZH	None
Basstronauten	techno
Bastian Lehnert	disco
Bastian Schuster	techno
Batiment	disco
Batiment b2b Marla	None
Battles	comic
Batuk	None
Bauchamp	None
Bauchamp  Live	None
Baumeister	None
Beam Rec	None
Beaner	disco
Beardyman	drum and bass
Beastie Boys Pauls Boutique	None
Beatamines	house music
Beats in Space  DE	None
Beatspoke	None
Beautiful Swimmers	disco
Beckers	None
Beda	disco
Beda  NAT	None
Beda & Lukas	techno
Beda und Marwin	None
Bedouin	rock
Bedran	None
Bee Lincoln	techno
Beez & Simo	None
Beirud Nas	None
Bekka	None
Belfort	None
Bella Sarris	None
Belleruche	downtempo
Belzebass	electro trash
Ben	singer-songwriter
Ben Ashton	None
Ben Guayas	None
Ben Kaczor	rap
Ben Kaczor aka BOM	None
Ben Moss	disco
Ben Purple	None
Ben Purple  TheFamily  Winterthur	None
Ben Purple  Winterthur	None
Ben Rau	techno
Ben Westbeech	None
Ben Yoo Suk	None
Beneath	None
Beni Jacksen	None
Beni Jacksen b2b Dan B	None
Benj Hangar11	None
Benja	None
Benja & Reto Ardour	None
Benjamin Damage	house music
Benjamin Fehr	hip hop
Benjamin Freeney	None
Benji B	breakbeat
Benno Blome	disco
Benoit & Sergio	disco
Benotmane	house music
Berber & Pasta	None
Berin	None
Berlin	house music
Berlin D	None
Berlin Room Resident Dj Matteo Melillo	None
Berlin Room with Matteo Melillo	None
BerlinChile	None
BerlinDE	None
BerlinZH	None
Bern	None
Bernard Parmegiani	free improvisation
Bernardo	None
Bernstein & Stiglitz	None
Betty Boop	None
Betty&Ford	None
Big Apple	None
BigenericMarco Repetto	None
BildstÃ¶rung	None
Bildstörung	None
Bill Patrick	None
BillyO	None
Binh	vietnamese pop
Bintus	house music
Bio	None
Biotob	None
Bird	indie
Biru	None
Bisculpter	None
BitTuner	None
Bitsculpter	techno
Black Bunker djs	None
Black Butter	None
Black Coffee	house music
Black Motion	house music
Black Spirit	rock
Blackphone666	None
Blair	disco
Blaqq & Whyd	None
Blazer	soca
Bloc937  Ariane Effect	None
BlockWorx	None
Blodvite	None
Blondish	house music
Blue Devilz	None
Bo51	None
Boat	emo
Bob Bellerue	None
Bobby & Steve	rap
Bobmo	techno
Boddhi Satva	house music
BodenLos	None
Body&Soul	None
Bok Bok	None
Bomber Shock	None
Bon Vivants  Colliding Fields	None
Bonaventure	disco
BondageMusic	None
Bonenergy	None
Bongalow Family	None
Bongoklub Züri	None
Bonnie	rock
Bonobo	downtempo
Bonstein	None
Bonzzaj	None
Bonzzaj All Stars	None
Bonzzaj Records	None
Boo Boo Groove	None
BooBoo Groove	None
Boogie Belgique	electro music
Boogiemann	None
Booka Shade	house music
Boomjacks	None
Bora Bora	etherpop
Bordeaux	None
Borderline Dominik Eulberg	None
Boris Werner	techno
Boris Why	disco
Born Bjorg	techno
Bourse aux vinyls et instruments dès 16h00	None
Bowmore	None
Bowser	None
Bowski	techno
Boy Next Door	None
BoyAn	house music
Boys Noize	house music
Bradley Zero	None
Brandt Brauer Frick	microhouse
Braniquake	None
Branislove	None
Branko	house music
Brassroots	brass band
Break New Soil	None
Breandan Davey	techno
Brett Jackson	None
Brett Jacobs  NG TRAX	None
Brian Python	None
Brian Sanhaji	hip hop
Brodinski	house music
Brown S	house music
BrownS	country gospel
Bruk Boogie Kru	house music
Bruk Boogie Kru feat The Layders	None
Bruno Vice	None
Brussels Regulate	None
Bryan	country
Bryan Coletta	None
Bryan Lewis Saunders	None
Bud Clyde	None
Buenos Aires & Mike Wall	None
Buenos AiresAR	None
Bulgaria	None
Bunk3r RecordsSubwoofer Records	None
Bunte Kuh	None
Burgerboss Tyler	None
Burnski	techno
Burnt Friedman	fourth world
Busines2Business	None
Business2Business	None
Butch	neo mellow
Butterfly	rock
Butterfly feat Ice MC	None
By HyperWerk HGK FHNW	None
Bäm Bäm	trap
CARLOS EVANGELISTA	None
CATWEAZLE  MinimalFraktion	None
CCKBY	None
CCut	None
CEM	turkish
CEO Müller	None
CEZAR	techno
CFly	None
CH	None
CHIC AND THE TRAMP	None
CHIKAGO	None
CJ Stone	bubble trance
CJPHOUS	None
CLAUDE aka Fulgeance	None
CLFT Militia	techno
CLIT EASTWOOD & WINONA SLIDER	None
CLOUDBOAT	None
CLR	None
CLUB	electronic rock
CLUB Floor II	None
CMYK	None
CNDR	None
CONSTAR	None
COSNOST	None
CRAY	trap
CREAM	rock
CROCODILE SOUP	rap
CRay	trap
CRay & Guipei	None
CYPHER	None
CYRUS DUFOY	None
Cabanne	None
Cadenza  Berlin	None
Caduceus Empirical  Genève	None
Cafe Singer Dirty Doering	None
Café Gold	None
Caillou	None
Caleesi	None
Callis	None
Camea	house music
Camo & Krooked	drum and bass
Canada	electronic rock
Canson	house music
Cantina Brothers	None
CapohLitch	None
Caracas Club aka Kadebostan & Laolu	None
Card On Spokes	hip hop
Carex Human revolution	None
Cari Lekebusch	techno
Cari Lekebusch  Stockholm	None
Caribou	electronic rock
Carl Cox	house music
Carla Du Riche	None
Carlo Cannone	None
Carlo Ruetz	techno
Carlos J	None
Carlos Valdes & Sandrien	techno
Casa Show	None
Casque	None
Cassy	microhouse
Castro Moore	None
Catacombs	funeral doom
Catz N Dogz	house music
Cedric B	techno
Cem Orlow	house music
Centaury	None
Central Rodeo	disco
CepheÃ¬	None
Cepheì	None
Ceri	techno
Cesar Merveille	techno
Cesco	None
Chaim	disco
Chang Kee Jazz & Jeromen	None
Chaos In The CBD	house music
Chapkmace	None
Character  CH	None
Charles Meyer	disco
Charlotte de Witte	None
Chase & Status	house music
Chateau Chepere	None
Chaton	None
Chic Miniature	None
Chicago Shlag	None
Chicagos Mad Decent Block Party	None
Chief	trap
Chill	None
Chill Chilla & Backdoorboys	None
Chloé	None
Chlär b2b Versatile	None
Chrigi G us Z	None
Chris Ahn	techno
Chris Clayton	None
Chris Lattner	techno
Chris Leon	None
Chris Leòn	None
Chris Liebing	techno
Chris Mono & Matjia	None
Chris Rockwell	techno
Chris Rockwell  MinimalFraktion  Eidgenoss	None
Chris SchwarzwÃ¤lder	None
Chris Schwarzwälder	None
Chris Sonaxx	techno
Chris Tietjen	disco
Chris Vee  Techno Room From 2400 to 200	None
Chris de Rebel	None
Chris di Carlo	None
Chris the Rebel	None
Christian & Raphaël	rap
Christian Burkhardt	techno
Christian Gimbel	None
Christian Knipp	rap
Christian Prommer	None
Christopher Joseph	None
Chronophone	None
Chymera	house music
Cika	None
Cindy	rock
Cinthie	house music
Cipmo	None
Cippi	idm
Circle Music  Berne	None
Cirkus	downtempo
Citizen Kain	house music
City Lights	pop
Civil Music  BE	None
Clap Clap	electronic rock
Claptone	house music
Clara 3000	techno
Clash	rock
Claude Laurier	None
Claude Monnet	house music
Claude Staffieri  LaFamiglia  CH	None
Claude Tarrel	None
Claudio Carrera	None
Clay Wilson	country
Clem	ambient
Clem  Specimen	None
Cleydys Villalon	None
Clincker	None
Clinitec	None
Clio	german
Clit Eastwood	None
Clive Bean	None
Clive Henry	techno
CloZee	idm
Club	electronic rock
Club Cheval	disco
CnD	None
CoMini	None
Cobeia	rock
Cockboy	None
Cockwhore & Macho	None
Code Red	boy band
Codex Empire	techno
Coffy Drop	None
Colliding Fields	None
Collin Travel	None
Colludo	None
Colt Seavers	None
Coma Cruise Live	None
Comfortnoise	None
Comfortnoise Ploy	None
Comini	None
Cominit	None
Concert	classical
Concert de Vouipe	None
Condor	cumbia sonidera
Coni	house music
Connaiseur	None
Consor	techno
Constell rassemble et unit dans la diversité	None
Conzuela Numez	None
Cool Cat	None
Coolcat	None
Cooly G	bass music
Copenhagen	choral
CopenhagenDK	None
Copyright	disco
CordobaAR	None
Core Rhythm	None
Corin	None
Corin Martin  Mountain People  StPlomb  Dollar Mambo	None
Corpataux	techno
Corso	None
Cosi Dee	None
Cosmix	None
Cosmo	None
Cosmokolor	house music
Cosnost	None
Cotton Claw	house music
Coughy live actvisuals Beatrice Sommer	None
Counteract	None
Counterbalance	None
Crazy Daisy	None
Creaky Jackals	trap
Cream Couture	None
Cream CoutureIT	None
Crean Floor Vanilla	None
Create w DOMA & TheAlchemist	None
Creative Discotheque	None
Cris P	None
Criss	uk garage
Cristi Cons	disco
Cristian Tamborrini	house music
Cristian Varela	techno
Critical Mitch	None
Crosstown Rebels  Berlin	None
Crotek	None
Crowdpleaser	techno
Cruz Jr	None
Crystal Fighters	electronic rock
Cuartero	techno
Cubex	house music
Cubique	None
Culoe De Song	house music
Culprit Sentiment	None
Culver	None
Curly Project	techno
Cuushe	ambient
Cyril Léger	None
César Merveille	None
D	rock
D Club	None
DADBALLS	None
DADO REY	None
DAN NOEL	house music
DANIEL BRENNER	None
DARKMAZE Live	None
DAVID FJORGENSON LIVE	None
DC&KE	None
DCP	None
DE	regional mexican
DEEJAY NIONIKA	None
DEKO by MINIMALFRAKTION	None
DELAYED PROJECT	None
DER PFLANZER	None
DETROITROCKETSCIENCE	None
DEYAN	None
DFIND	None
DGRZ	None
DI 29  11H30  22H00	None
DIEGO	regional mexican
DIEGO INDIGO	None
DIGITAL NATIVES	None
DIVINE ADVENTURE	None
DJ 7	None
DJ Andrew	None
DJ Andy Smith	None
DJ BALU	None
DJ BK	None
DJ BRADD	None
DJ Bazooka	None
DJ Bone	techno
DJ Bone & Sir D Modernist	techno
DJ Byte	None
DJ Cam	downtempo
DJ Civi	None
DJ Cosmokolor & Raouf Djazz	None
DJ DACID	None
DJ DONAT	None
DJ Dano NL	None
DJ Dario La Mazza	None
DJ Deep	techno
DJ Delectrok	None
DJ Dierlijk	None
DJ Dk13	None
DJ Don Vincent	None
DJ Doom	hip hop
DJ Doses	None
DJ Doug	None
DJ Dream	None
DJ Dub	dub
DJ Duckk	None
DJ EZ	house music
DJ Emess	None
DJ Energy	bubble trance
DJ F	None
DJ FINE	None
DJ FMC	None
DJ Flow	None
DJ Food	breakbeat
DJ Freezer	None
DJ GUMJA	re:techno
DJ GantMan	footwork
DJ Geepunkt	None
DJ Giuly	None
DJ Giuly vs Sensenmann	None
DJ Giusy S	None
DJ Godfather and Jammin Gerald He has the ability to blend elements of house	None
DJ Hotfingerz	None
DJ IM Jdore	None
DJ IN DA MIX	None
DJ ISMASH	None
DJ Inderrock	None
DJ Insane	None
DJ Jamie Lewis	None
DJ JayZone	None
DJ Jerome	None
DJ Jibone	None
DJ Joh	hardstyle
DJ KAMA	sunset lounge
DJ Kosta Greco	None
DJ Koze	house music
DJ Kristof	hardcore
DJ LCP	None
DJ LJ	None
DJ Le Baron	disco
DJ Le Roi	hip hop
DJ Lee	hands up
DJ Lucc	None
DJ Markus haZe  save the VINYL	None
DJ Marvin J	None
DJ Mastra & Kellerkind	None
DJ Mathematic	None
DJ Mathieu	makossa
DJ Milosz	None
DJ Moneyshot & DJ Cheeba	None
DJ Mute	None
DJ Nader	house music
DJ Neophyte	gabba
DJ Nonames	None
DJ Nukem	disco
DJ Nünn	None
DJ Oil	None
DJ Overdose	electro
DJ PBell	None
DJ PStar	None
DJ Pasci	None
DJ Pièrick	None
DJ Pone	turntablism
DJ RAMSES	None
DJ RECAREY	None
DJ RKK	None
DJ ROMAN CLEISS	None
DJ ROSS	None
DJ Randy	None
DJ Rashad	house music
DJ Rashad has become notorious for making Juke anthems that have made fans outside the world of Chicago mix cds Hes released records on Dancemania	None
DJ Rashad has been instrumental to the creation and evolution of Chicago Juke music and has been lifelong friends with other key players on the scene such as Paul Johnson	None
DJ Reas	None
DJ Remo	None
DJ Result	None
DJ Rocca	downtempo
DJ Rumory	None
DJ Rush	techno
DJ SCM	None
DJ STERNEIS	None
DJ STOPPA	None
DJ STYLE & DAITAN	None
DJ Sam	None
DJ Sammy	hi-nrg
DJ Set Glue eyes & guest DJ Jerome Antony	None
DJ Soda Club	None
DJ Soulchild	None
DJ Spen	house music
DJ Spider	mashup
DJ Spinn	footwork
DJ Sprinkles	None
DJ Steaw	house music
DJ Steppak	None
DJ Steve Tudikc	None
DJ Style	coverchill
DJ Style & Soe	None
DJ T	house music
DJ TLR	techno
DJ Tekin	house music
DJ Tray	None
DJ Tyrone B Nelson	None
DJ UNIT	None
DJ Vadim	downtempo
DJ Vibe started mixing early It was back in 1983 that AntÃ³nio TÃ³ Pereira got his first ever club gig at Lisbons Bataclan spot Today he still dedicates his 30 talented years of music to all of us crowd people	None
DJ Vibe started mixing early It was back in 1983 that António Tó Pereira got his first ever club gig at Lisbons Bataclan spot Today he still dedicates his 30 talented years of music to all of us crowd people	None
DJ XETAL	None
DJ Yellow	techno
DJ Zebra	mashup
DJ set	None
DJAHSTA	None
DJAZZ	None
DJDuo Katzentanz	None
DJS	new jack swing
DJamency	disco
DJs	new jack swing
DJs Atomic Nick	None
DJs BitTuner	None
DJs Duo Meda & Medooza	None
DJs Green n Brown	None
DJs with bad haircuts	house music
DK	None
DK Brown	None
DLC	None
DMS vs Miss JayKill	None
DMT	indie dream pop
DMX Krew	house music
DMalice	None
DModestino	None
DNox	techno
DOLBYD  France  Naked Lunch	None
DONT DJ	None
DOPPELPACK	None
DR BARESCO	None
DRHELMUT	None
DUAL II	disco
DUB GRAFFITTI & Alfredo Ramos	None
DUSTY	soul
DVW	disco
Da Benni	None
Da Brenner	reggae fusion
Da Bruk Boogie Crew	None
Da Cruz	bossa nova jazz
Da Ron	None
DaTO	malaysian pop
Dachshund	techno
Dacid	None
Dactylo	None
Dadaglobal	disco
Dadavistic Orchestra	hauntology
Daddys Groove	house music
Dais & Duschek	None
Daisuke Ichiba	None
Dak  Violeta White	None
Dalibox  MinimalFraktion  Basel	None
Damian Deroma	techno
Damian Lazarus	techno
Damiano von Erckert	techno
Damon Jee	techno
Damon aka Nikosss	None
Dan Andrei	None
Dan B	None
Dan Curtin USA	None
Dan LagardÃ¨re	None
Dan Lagardère	None
Dan Michaels	None
Dan NoÃ«l	None
Dan Noël	None
Dan Shake	house music
Dan Welton	house music
Dance Affair	None
Dancecode	None
Dandi & Ugo	techno
Dandy Jack	techno
Dani Casarano	techno
Daniel Broesecke	None
Daniel Dreier	techno
Daniel Sanchez	techno
Danielson	swedish
Danielson & Norbertto	None
Danielson & norbertto	None
Danilo Plessow	techno
Danilo Plessow aka Inverse Cinematics	None
Danilo Rossini	None
Danilo Schneider & Eveline Fink	disco
Daniro	None
Danny Daze	disco
Danny Krivit	hip hop
Danny Serrano	techno
Danny Serrano is one of electronic musics most exciting upandcomers	None
Danny Settimio	house music
Danny sets have energy	None
Danse Noire Soundsystem	None
Danse Noire djs	None
Dantze	None
DantzeBerlin DE	None
Dany Jack	None
Daparec	techno
Darek	None
Daria	techno
Dario DAttis	disco
Dario La Mazza	None
Dario Rival	None
Dario Rohrbach	None
Dario Zenker	techno
Dariolem	None
Darius Syrossian	house music
Dark Headz	hardcore
Darko Stronqvist	None
Darkstar	post-disco
Darren Flecta	disco
Darrien	hardcore
Das Blenden	None
Das Duo	None
Das Fest	None
Das Hutwerk	techno
Das letzte mal nach der Street Parade im Rohstofflager feiern  denn am 179189 findet das finale AbschiedsWeekend statt	None
Datendrang	None
Dave 202	trance music
Dave Clarke	techno
Dave Dalux	None
Dave Dinger & Matija	rap
Dave Eleanor	disco
Dave Hard	None
Dave Joy	None
Dave Multitask	None
Dave Neff	house music
Dave Phillips	psychobilly
Dave Saved	None
Dave The Hustler	disco
Dave202	trance music
David Armada	disco
David Armada  Specimen	None
David Delgado	hip hop
David Durango	techno
David Faust	house music
David Fernaux	None
David Guetta	pop
David Jimenez	None
David Keno	house music
David Lamon	None
David Rodigan	None
David Steel	hip hop
David Torr	disco
David Vunk	disco
David5	None
Davide Bomben & Era	None
Davide Bomben & Era Vulgaris	None
Davide Squillace	techno
Davidon	disco
Dax J	techno
Dd King	None
De La Vega	None
De fêtes marathon où amour rime avec toujours en afters rocambolesques en passant par le cockpit de la Ruche ou du Hoppetosse nos deux compères semploient à distiller leur goût immodéré du bon groove	None
De la Bass	trap
DeWalta	techno
Dead Bunny	None
Dead can Trance	None
Deadbeat	techno
Deadmau5	house music
Dean	easy listening
Dean Breda	None
Deborah De Luca	techno
Decalicious	None
Decktro	None
Deco by Visionnaires Extralucides	None
Deconstructing Drumboys	None
Dee Nelli	None
Dee Nelli hooojmusic	None
Deeno	None
Deep Bros	None
Deep n Dub	None
Deep und TechHouse	None
Deepchild	house music
Deepfreeze	None
Deepwave	None
Deetron	techno
Definition	screamo
Dejan	None
Dekmantel  San Francisco	None
Deko by Night Facotory DekoKollektiv	None
Delakeyz	house music
Delphic	electronic rock
Demegy	None
Dement3d	None
Dement3d  CH	None
Demetrio Giannice	house music
Demir & Seymen	None
Den Sorte Skole	None
Dengue Dengue Dengue	neo-psychedelic
Denis Capizzi	None
Der Dirigent	None
Der Dritte Raum	techno
Der Gekaterte Stiefel	None
Der Held	None
Der Mega Watt Clan	None
Der Schmeisser	None
Der Tietz	None
Der schlechte Einfluss	None
DerStein	None
Derek	hip hop
Dersu	None
Detailer & Mc Smart B	None
DiDario	None
DiTosca	None
Die Dummen Nutten	None
Die Goldbrenner	None
Diego Krause	hip hop
Diego Suarez	disco
Diego Tony	None
Diego Vendossa	None
Dietrich & Strolch	techno
Digital Geist	dark electro-industrial
Digital Natives	None
Digital Pirates	disco
Digitalis	dub
Digitalist	dark psytrance
Digitron	None
Digitule	None
Dilek	None
Dilek Records	None
Dillon	house music
Dim  Eevy	None
Dim & Eevy	None
Dim Mak	brutal death metal
Dimb	None
Dimette	None
Dimitri Monev	techno
Dimlite&Julian Sartorius	None
Dinan	None
Dinky	techno
Dino White aka DinoTon	None
Dirk Schönhöfer	None
Dirty Cultures Official	None
Dirty Doering	deep
Dirty Flav	None
Dirty Greg	None
Dirty Larry	techno
Dirty South	house music
DirtyMadSound	None
DisOrder	rap
Disco Channel	None
Discod  Banga	None
Disko Dario	None
Divalvi	house music
Divinity	None
Divus Berlin	None
Dixon	soundtrack
Diynamic	None
Dj	trap
Dj Arode	None
Dj Aroy	None
Dj Christo	None
Dj DFyne	None
Dj Dubstep	None
Dj Falcon	house music
Dj Fenomen	None
Dj FinalX	None
Dj Geedubz & Dj Kama	None
Dj Gino	None
Dj Jestics	None
Dj Kama & OEl	None
Dj Keri	None
Dj Klash aka Klashizzle	None
Dj Lorenz	None
Dj Lu K & Fionom	None
Dj Lucc	None
Dj Mark  Commercial Room From 2400 to 200	None
Dj Martin Meier	None
Dj Miguel	None
Dj Mitch	None
Dj Never Die	techno
Dj Nikolaz	None
Dj Ouch	hip hop
Dj Pasci	None
Dj Pitch	None
Dj Plaza	None
Dj Ram Vee	None
Dj Reas	None
Dj Rotation  Hip Hop Room with Dj Pitch	None
Dj Rouni	None
Dj Shepdog	None
Dj Smooky	None
Dj Sticka	None
Dj Style	coverchill
Dj Tom Vibe	None
Dj Volta	None
Dj Yan Bruno	None
Dj Zano P	None
Dj depuis 10ans	None
Dj dion	None
Dj set & visual show by Kreisprozess	None
Dj set FAB	None
DjMitch & Urban Panik	None
DjS	new jack swing
Djaimin	None
Djamency	disco
Djanny	None
Djazzy	disco
Djedjotronic	techno
Djeniz	None
Djerem vs Assym	None
Djerry C	None
Djs	new jack swing
Djs Christo & Ramin	None
Djs with Bad Haircuts	house music
Doctor Dru	disco
Dole & Kom	house music
Dollar Mambo	disco
Domenico Rosa	disco
Domi Chansorn	None
Dominic	k-pop
Dominik Auderset	house music
Dominik Eulberg	techno
Don Ramon	argentine reggae
Don Ramon San Marco Pasci joey	None
DonDario	house music
Doomenfels	None
Doomwork	techno
Doppelpack	None
Doppelt Gemoppelt	techno
Dorian	None
Douala	None
Double You  Jokari	None
Doublewave	techno
DoubtingThomas	techno
Douster	techno
Downwards	electronic rock
Dr BARESCO	None
Dr Bitstream	None
Dr Motte	None
DrHelmut	None
Dread J	techno
Dready 2	None
Dready2	None
Dream	hip hop
Dreksler & Haerle	None
Dreksler & Haerle LIVE	None
Drumder  the Bonggos	None
Drumedar	None
Dual Channel	None
Dualism	progressive psytrance
Dub Dummies	techno
DubExMachina	None
Dubfunk	disco
Dublex Inc	electro jazz
Dublin	None
Dubois	None
Dubstep	None
Dubstep & Aulay Fou	None
Duckk & Doogood	None
Ducks on Repeat	techno
Duff	pop
Dunkeltier	None
Duo Rhythm	None
DuoRhythm	None
Duorhythm	None
Duplex	techno
Durdek & Kubin	None
Dylan Casale	house music
Dynalor	None
Dynalor & Wasabideluxe	None
Dysonc	None
Dzanin	None
DÃ©bruit	indie jazz
DâmFunk & Band	None
Débruit	indie jazz
Dürerstuben	house music
E Funker	None
ECHOLOT Dub System feat High Smile & Likkle Ferguson & Eastrow Redemption Release feat Stereo Luchs & Belly Rankings Turbo Audio	None
EChord	None
EDMX	video game music
EFunker	None
EL NIÑO  TICINO	None
ELAY	None
ELC	None
ELECTRONIC FLOOR	None
ELK RHINO	None
EM & EM aka Akustik & Martin Baur	None
EMOK	progressive psytrance
ENDON	None
ETYPE	None
EXTRASTUNDEN	None
EZ	None
EZoo resident DJs	None
East End Dubs	None
Easton	country
Easy	rap
Eclektic  Winterthur	None
Eco	trance music
Ed Luis	None
Ed Schraders Music Beat	noise pop
Eddie Hyde	rap
Eddie Queen	None
Eddy Queen	None
Eddy Ramich	house music
Edison Cabrino	None
Edison Cabrino b2b Teo Ermotti	None
EdisonCabrino b2b TeoErmotti	None
Eelke Kleijn	house music
Eevy	None
Efdemin	techno
Efdemin  Dial  Berlin	None
Eff&lle	None
Effortlessly balancing a will to experiment with an unwavering commitment to thefounding spirit of house	None
Egokind	house music
Egotronic	german
Egyptrixx	bass music
Einmaleins	None
Einstürzende Neubauten	experimental
Eintakt	None
Eintritt ab 18 Jahren  Open 0500	None
Ekman	None
El Alusinante	None
El Primo	None
El Rhino	None
El Tigre Sound	None
El Tigre Sound System	None
ElBey	None
Elay	None
ElectroSystem	None
ElectroniqueUKIT	None
Electrophil Rec	None
Elektro Guzzi	techno
Elektrobopacek	None
Elex Morano	None
Eli Verveine	techno
Elia Rediger	None
Eliott	None
Eliphino	bass music
Elk  Grillmaster b2b Le Horla	None
Elk  The Grillmaster	None
Elle Reve	None
Elle Rêve	None
Ellen Allien	techno
Elliver	None
Elrino	None
Elrino  ABARTIK	None
Elvis Benait	None
Elvis Cassetta	house music
Elysia Crampton	fluxwork
Emanuel Satie	house music
Emil Teiger	None
Emilie Nana	hip hop
Emix	techno
Emmat	techno
Empro	techno
Emptyset	fluxwork
Ena Lind	techno
Enfant DOr	None
EngBang	None
Ensemble Phoenix Basel	modern performance
Enzo Lo Conte	None
Enzo Pianzola Mauro Capitale	None
Enzo Siffredi	house music
Enzo Siffredi  Minimal Kids	None
Enzo lo Conte	None
Ephrem Luechinger	None
Erasmus & Krieger	None
Eric Borgo	techno
Eric Fox	None
Eric Preston	None
Eric S	None
Eric de mars	None
Erika Fatna	None
Erobique	None
Ertu&Pushkin	None
Esben and the Witch	grave wave
Escape From Gravity b2b Introvert	None
Essex Groove	None
Esther Venrooy	None
EtN	None
Ethil o metre	None
Etn	None
Euphoria	None
Euphoria  CH vs UK	None
Evelinn Trouble	rock
Evento	None
Everest & Lcp	None
Everest on TT	None
Everstone	house music
Everydayz	abstract beats
Evil Moisture	None
Evil Oil Man	None
Evo & RST	None
Evolent	hip hop
Ewan Onou	None
Ex Labyrinth	None
Exium	techno
Expressions	soul
Extrastunden	None
Extrawelt	techno
Exzentric Showcase by DJ Fergie & Alan Fitzpatrick	None
Ezikiel	techno
F	classical
FABIEN	None
FACE DESIGN	None
FELIPE PUERTES	None
FKJ	house music
FLAVIO	channel pop
FLAVIO CALZADO	None
FLOOR A	None
FLOOR B	None
FM Belfast	electronic rock
FOXY	hip hop
FR	None
FRANK C	folk
FRANZ KARL Visuel	None
FRANZ KARL visuel	None
FRAnk K	None
FREE ENTRANCE	None
FREEZER	hardcore
FRIDAY NIGHT	pop
FRQNCY	None
FRST	None
FaFa	None
Fabien	None
Fabio Papa	None
Fabio Siverino	None
Fabio Tamborini	None
Fabio Tamborrini	disco
Fabrizio Maurizi	None
Fabø	trap
Face Design	None
Facebook  Pascal Visacardi	None
Facit	None
Fact	None
Fagins Reject	None
Fakear	house music
Fantastic Friends	None
Fantastic Friends  Lausanne	None
Fantastic Friends Rec  Time As Changed Rec	None
Fantastic Friends rec  La Ruche	None
Far East Network	None
Far Too Loud	uk garage
Farbenklang	None
Fat Sushi	techno
Faul	house music
Faux Couture	None
Favila & Valentine	None
Favila&Valentine	None
Feadz	techno
Fedde Le Grand	house music
Feed Me	uk garage
Feel X	None
Fehlfunktion	None
Feldermelder	None
Felipe & Gusto	None
Felipe & gusto	None
Felipe Acevedo	None
Felipe Puertes	None
Felipe Puertes b2b Robel Volkshaus	None
Felix Acaso	None
Felix Et Chat cest un peu comme Starsky et Hutch mais en mieux	None
Felix Kröcher	schranz
Felix Laband	None
Fenomen	hip hop
Feodor	deep opera
Feola	None
Feshmint	None
Festmacher	None
Fever	electronic rock
Fiat Bux	None
Fiber	None
Fich	None
Fichtre visuals	None
Fictionizer	None
Fiedel	scorecore
Figure	rock
Fiji	polynesian pop
Filastine	None
FinalX Alex Pro	None
Findling	house music
Finnebassen	house music
Fionom	None
First Claz	None
First Deck	None
Fiumejunior	None
Flako	abstract beats
Flappers records	None
Flavio	channel pop
Flexfab	None
Flexibelle	None
Flexus vs Joe Panic	None
Flieder	None
Flohmi by Gilda	None
Floor 1	None
Floor 2	hi-nrg
Florian Hecker	idm
Florian MSK	None
Florian Meindl	techno
Florian Oberhauser	None
Florian Rawyler	None
Florian Schmid	None
Flow	reggaeton
Flow Box	chill groove
Flowbastard	None
Flowbuster	None
Flumroc	None
Flux Pavilion	uk garage
Flying Lotus	hip hop
Foals	electronic rock
Food For Ya Soul	None
Forest People Patrick Becker	None
Foupoudav	None
Four Roses	None
Frabon	None
Frag Maddin	disco
Fran Serrano	techno
FranG	violin
France	gypsy jazz
Francesco Ballato	None
Francesco Mosca	None
Francesco Rossi	disco
Francio	None
Francisco	None
Francisco DJ  Techno Room From 330 to 500	None
Franco Bianco	techno
Franco Mento	disco
Francois Antico	None
Francois K	house music
Francy Cap	None
Frango	techno
Frank Storm	None
Frank Storm & Ivan Alvarez	rap
Frank Vespari	None
Frank Vespari b2b Litte Victor	None
Franz Carl	None
François Bayle interpreted by François Bonnet	None
FreakBoutique	None
Freaky Charly & Oscar Niczzo	None
Fred 34	None
Fred Licci	None
Fred Lilla	big room
Fred Linger	disco
Fred P	house music
Freddi Hintenaus	None
Freddjset	None
Fredomat	None
Fredski	None
Fredy S	rock
Free Entrance	None
Free entrance	None
Freitag ab 2300	None
Frenchwerk	None
Fretzki	None
Freudenreich	None
Freundchen	None
Friede Freude Freitag	None
Friede Freude Freitag  FFF Events ZH	None
Frittenbude	german
Fritz Kalkbrenner	house music
Frivolous	house music
Frogoroth	None
Fucking Stupid Idiots	None
Full programme of Music	None
Fumiya Tanaka	techno
Fun&Floor is a clubnight which takes place every 2nd saturday of the Month in Hacienda Sierre	None
FunkYaMind	None
FunkinEven	disco
Funkyamind	None
Fur Coat	techno
Future Islands	electronic rock
Féline	None
GALLO	None
GARDEN	rock
GARFLD	disco
GASTON  MAHMOOD  VLAD  IANOO	None
GATAN	None
GE	gospel
GER	None
GET PHYSICAL BERLIN  ANTS IBIZA	None
GILLES Aubry	abstract
GIRL	mashup
GLITTER	rap
GMCA All Stars	None
GMCAAllstars DerSchlechteEinfluss	None
GREG LA BRELLE	None
GRISE	None
GUCCI	rap
GUS BE	None
GaLaBar  WFmusik	None
Gabidou	None
Gabriel Ananda	house music
Gabriel Dor & Bordoy	rap
Gabry C	None
Gag Smile	None
Gaiser	techno
Galoppierende Zuversicht	None
Gameboy	None
Gamma dee Meo	None
Gangsta	None
Garance	techno
Garance & diSoul	techno
Garibovic  DefinitionMusic  WKND	None
Garlo	None
GarÃ§on	None
Garçon	None
Gaspard	None
Gaspard de La Montagne	techno
Gaston	mbalax
Gayle San	schranz
Gecko	None
Geepunkt	None
Geisha	None
Gemini from Pyra all Stars	None
General Wolf	None
Genetic Dysfunction	techno
Geneva	grave wave
Geneva Street Food Festival dès 18h00	None
Georg Stuby	None
George Lamell	None
Gera	None
German Brigante	house music
Germany	post-disco
Geronimo	opm
Gerry Fresh	None
Gertrude Tuning	None
Gerwald Rockenschaub	None
Gesaffelstein	house music
Get Physical	None
Ghetto Po	None
Ghetto Po 237 FamilyVD	None
Ghettophiles	None
Ghettopo	None
Ghettopo & Jacqui	None
Ghoster	None
Gianlukino	None
Gianni & more	None
Gianni Callipari	disco
Gianni Mori	None
Gianni Palumbo	rap
Gianni Parrini  Rimini  Italia	None
Gianni Sabato	rap
Giavier	None
Gichou	None
Gigi Fabiani	None
Gill&Gill	country
Gilles Peterson	downtempo
Gilles Peterson & more TBA	hip hop
Gilles Peterson Worldwide Festival Talent Search 2009	None
Gin Tonic Soundsystem	None
Ginevra	czech folk
Gio Amenkov	None
Giomar	classic peruvian pop
Gion  Chris Ahn	None
Giorgio Gigli	dub
Giorgio Maulini	disco
Giorgio Vergani	None
Giovanni Verrina & Germano Ventura Aka Howl Ensemble	rap
Girl	mashup
Girl  3	None
Giulia Regain dj	None
Giulio Corsi	None
Giuly	hardcore
Giuseppe Visciano	techno
Giusy S	None
Gleichschritt	None
Gleichtackt	None
Glen Porter	downtempo
Gloria Bulsara	None
Goa Face	None
God Made us Funky Records	None
Goetzlich	None
Golden Gate	None
Goldfish	house music
Goldfrapp	electronic rock
Gomorra	techno
Gordan Starr	house music
Gorge	house music
Gorgon City	house music
Government Alpha	None
Graham Lambkin	None
Gramatik	downtempo
Grand passionné de musique	None
Grandmaster Flash	hip hop
Grant Nelson	uk garage
Grauwind b2b SYOM	None
Gravina	techno
Gravina & omar	rap
Gravitas Recodings  FR	None
Gray Chalk	None
Greeen & Moeraki	None
Green Velvet	house music
Greg Iaia	None
Greg Iala	None
Greg La Brelle	None
Gregor Tresher	techno
Gregory Whitehead	None
Gregorythme	techno
Grillmaster	None
Groonvalsky LIVE	None
Groove Defenders	None
Groove Junkies	house music
Groteske	None
Guest DJs	None
Guest Djs from AF Records	None
Guest Simone Liberali	None
Guest de Berlin	None
Guests	None
Guido Rami	None
Guido Schneider	techno
Guido aka FreeJ Rumi	None
Guillaume & The Coutu Dumonts	techno
Guillaume P	None
Guillaume and The Coutu Dumonts	techno
Guipei	None
Guitar Wolf	rock
Gulasch Mafia ZH	None
Gurtz	dub
Guti	disco
Guts	downtempo
Guy From Downstairs	house music
Guy Joshua	None
Guyus	uk garage
Gwyn Wurst	None
Gypstrip	None
GÃ¡bor LÃ¡zÃ¡r	None
Gábor Lázár	None
GöteborgSE	None
HARKAM	None
HEIKO MSO	techno
HERR TERZ	None
HISTORIA Trance Classics Stage	None
HJ Roedelius	None
Hack & Nick	None
Hainberg	None
Hallenstadion Foyer	None
Hallenstadion Frontline  Hardstyle	None
Hallenstadion Mainfloor Arena	None
Hallenstadion Rang 1  Trance Floor	None
Hallenstadion Rang 2  House Electro I	None
Hallenstadion Sound Restaurant  House Electro II	None
Hallenstadion Storage Ost  Hotter Than Hell	None
Hamburg	None
Handan	classic turkish pop
Handbandits	None
Hanfry Martinez	disco
Hang	new tribe
Hanna Hais	None
Hansaplast live JU	None
Hansim GlÃ¼ck	None
Hansim Glück	None
Hantise	None
Hard Droppers	None
Hardcore Masterz Vienna	hardcore
Hardsoul  Greg Van Bueren	None
Harry Klein	None
Hatcha	uk garage
Hatsune Kaidan	None
Hatti Vatti	substep
Hatzler	techno
Havana Cultura	None
Haya Mottarek	None
Haydn	classical
Hazzard Boys	None
He starts being a child With only 8 years and with a keyboard	None
Headbanger	hardcore
Headless Horseman	dub
HeadmanRobi Insinna	None
Heartthrob	techno
Hecht & Zander	None
Hector Couto	techno
Hedoromeruhen	None
Heiko	coverchill
Heimat	hip hop
Heimat Peer Kusiv	None
Heinz Music	None
Heinz Music  Berlin	None
Heiser	None
Helder	techno
Helder Costa & Lee Low	None
Helder b2b Joram	None
HeliOn	None
Hellquist	deep psytrance
Hemmann & Kaden	techno
Hendrikz	None
Henning Richter	disco
Henrik Schwarz	techno
Henrique	sertanejo universitario
Henrique Delamare	None
HenriqueMatthew Adamas	None
Henry Pass	None
Henry Wu	indie jazz
Herkul	None
Herman	show tunes
Hermansson	None
Herr Johann	None
Herr Mehr	None
Herr Meyer & Sentio	None
Herr Vogel	None
Herrrouine	None
Herzschwester	techno
Herzschwester  Gelbes Billett Musik	None
Hetan	None
Heymoonshaker	None
HiGHFi	None
Hidden Peaks	None
HighLive	None
Highgrade	jump up
Highgrade Disharmonic Orchestra	disco
Highgrade Rec  Pokerflat Rec	None
HighgradeRec  ClockArt  La Ruche  Recycle  Gimmick  Villa magica  Caduceus	None
Hiivemind	techno
Hinterzimmer	None
Hinterzimmer Steve Cole	None
Hito	techno
Hive	indie poptimism
Hive  ZH	None
Hive Audio	None
Hive AudioZurich	None
Hobbs	christian christmas
Hobo	None
Holic Trax  Berlin	None
Home Park	disco
Honey Dijon	house music
Honey K	None
Honoree	techno
Hood Regulators	None
Hopen	None
Horasse	None
Horatio	techno
Horn Richterswil	None
Hot Creations  Barcelona	None
House	None
House poudrée et pas chassés	None
HouseElectro	None
Housedelivery	None
Huazee	None
Hudson Mohawke	vapor twitch
Human Garden Music  ITA	None
Humangigz	None
HunterGame	techno
Hypercolour	None
Hypnotic	afrobeat
Härterei 1	None
IG Culture	breakbeat
IG CultureNSMZen Badizm	None
INTRODUCING MINIMAX BERN	None
IROO	None
ITee	None
IVVVO	house music
Ian Pooley	house music
Ianoo	None
Ibolya Zombory	None
Idealist	ambient
Idriss D	disco
Ieva	None
Igor Blaska	None
Igor Blaska & The Mad Family	None
Igor Blaska feat Lik &	None
Ikke	house music
Ilario Alicante	techno
Impact	None
Imperial Tabasco	None
Imperial Tiger Orchestra	ethiopian pop
In4mation	None
Inderrock	None
Indiana Tones	None
Infinity	None
Info comming soon	None
Ink	pop
Inside Floor	None
Inspiration	None
Instabil  Köln DE	None
Instant Rave	None
Intacto  Amsterdam	None
Intro by Andersen	None
Introducing Minimax BE	None
Introvert	None
Introvert KonterBass	None
Invincibile	None
Ion Ludwig	None
Irreversible	atmospheric post-metal
Isambard Khroustaliov	None
Isolated Lines	techno
Isolée	house music
Issa MaÃ¯ga	None
Issa Maïga	None
Ital Tek	uk garage
Italo Buisness	None
Italo Business	None
Itchi & Scratschy	None
Ivan Alvarez	None
Ivan Alvarez b2b Kenny Ground	None
Ivan R	None
Ivan Stantoro	None
Ivo Christow	None
Ivo Cristow	None
J Fab	None
J ROCC	turntablism
J Velez AKA Professor Genius	None
JACKSMIN	None
JAKSMIN	None
JANNI SALPINGIDIS  DurstlÃ¶scher	None
JANNI SALPINGIDIS  Durstlöscher	None
JASHARI	None
JAVIER LEMA	None
JAY SANDERS	techno
JAZZANOVAs Alex Barck	None
JCUSH	None
JEHROMM	None
JEREMY ELLIS	breakbeat
JESSE HACKETT live	None
JESSE JAY	rock
JFTH  Minimal Kids	None
JG Thirlwell aka Foetus	None
JK Flesh	mandible
JNS DJ Team vs Execute DJ Team	None
JO	scorecore
JO SINCLAIR	None
JOE VENDETTA  MinimalFraktion  GrÃ¼nwerk Rec	None
JOE VENDETTA  MinimalFraktion  Grünwerk Rec	None
JONE & Max Nero	None
JOne	hip hop
JP Gross	None
JPN	None
JPTR	None
JR	hip hop
JSebK  many more	None
JU	cantopop
Ja Gern	None
Jack & the Jerk	None
Jack Pattern	techno
Jack Pryce	None
Jack Scagnetti	None
Jack Slaughter	None
Jackie Greco	None
Jacob Groening	house music
Jacque	None
Jacques Obsone	None
Jacques Palminger	None
Jacqui	jazz christmas
Jacquit	None
Jagged	pop
Jah Shaka	dub
Jake the Rapper	house music
Jako	groove room
Jam Pesko	None
Jama	house music
James Bay	pop
James Mc Hale	None
James Mc Hale  Tanzkarusell	None
James Mc Hale B2B SHE NIONIKA	None
James Yuill	electronic rock
Jamie Berry	electro music
Jamie Jones	techno
Jamie Lewis	disco
Jamie Lidell	funk
Jamie Shar	techno
Jamie White	techno
Jan Blomqvist	deep
Jan Jelinek	electronica
Jan Krueger	None
Jan Penarrubia	techno
Jan Raphael k	None
Janis	rock
Janiz	None
Jann Bronsky	None
Jannik Schaller	None
Jaques Palminger	None
Jaser Mushkolaj	None
Jaset	None
Jashari	None
Jason Lescalleet	lowercase
Jauss	None
Javier Moreno	techno
Jay Cassius	None
Jay Decay	None
Jay Hardway	house music
Jay Mack	None
Jay Phonic	techno
Jay Veedee	None
Jay Veedee & Malek	None
Jaybee feat Sandman & Appenzeller SängerFREUNDe	None
Jaymo & Andy George	techno
Jazmin Ng	None
Jazzanova	downtempo
Jean Baptiste	classical
Jean Charles De Monte Carlo	None
Jean Charles de Monte Carlo	None
Jean Clef attache une attention particulière à la selection de ses morceaux Il est capable de commencer un set avec des sonorités Soul	None
Jean Toussaint	None
JeanFranÃ§ois Laporte	None
JeanFrançois Laporte	None
Jeans for Jesus	None
Jeckos	None
Jeff	video game music
Jeff Mills	techno
Jeff Mills  CINEMIX FUTURISTE	None
Jeff Swing	techno
Jello Biafra & le Dernier Cri	None
Jembo62 & Lindon	None
Jena	idol
Jennifer Cardini	microhouse
Jens Bond	techno
Jens Lissat	techno
Jens Zimmermann  FRANKFURT	None
Jeremias	pop reggaeton
JeriJeri	None
Jerome Le Baron	disco
Jerome Le Baron invites	None
Jerry Jerome & Jan Ehlen	None
Jessie	pop
Jestics	None
Jet Himiko	None
Jeudi Records	None
Jevne	house music
Jewl	None
Jichael Mackson	None
Jim ORourke	None
Jimi Jules	disco
Jimmy Edgar	idm
Jin Chillah	None
Jinxx b2b Muck	None
Joachim Spieth	disco
Joe Bless	None
Joe Claussell	rap
Joe Ferretti	None
Joe Galen	None
Joe Mckechnie	disco
Joe Mckechnie & Will Sergeant	rap
Joe90	None
JoeFarr	techno
Joel Fabrice Volkshaus	None
Joey	rap
Johann S	classical
Johannes Heil	techno
Johannesburg	None
John &	rock
John Boston	None
John Haden OnOff Recording	None
John Hegre	electroacoustic improvisation
John Mad b2b Björn Lomar	None
John Paul Jones	None
John Player	None
John Roberts	house music
Johnita Lemonetta	None
Johny Holiday	None
Jokari	disco
Joker	trap
Joker feat Mc Nomad	None
Jon Donson	techno
Jon Gaiser	None
Jon Hopkins	electronic
Jon Kennedy	downtempo
Jonas Kopp	techno
Jonathan Brown	None
Jonathan Brown  Strange People	None
Jonny Miller	breakbeat
Jools vs Kid Baba	None
Joram	disco
Jordan & AslanKan	techno
Joris Belzin	None
Jorven	None
Jose De Divina	None
Jose Maria Ramon	disco
Jose Wated	disco
Joseph Hammer	None
Josephine de Paris	techno
Josey Rebelle	techno
Josh Tree	None
Josh Wicks	None
Josh Wink	techno
Joxx	None
Jstar	house music
Juan Atkins	house music
Juan Veloz	None
Juen	None
Juen & Bach	None
Juice Crew	None
Juicy julz	None
Juke Trax	None
Jukebox Champions	None
Juli N More	None
Julian Jeweil	techno
Juliano Lopez	disco
Julien Aubert	None
Julien Valentini	None
Juliett	disco
Julietta	vapor soul
Julio Bashmore	house music
Junior B	None
Junior Boys	electronic rock
Justin Fidèle	None
Justin Martin	house music
Jutzi	None
JÃ¼rgen Dobner	None
Jürgen Dobner	None
Jürgen&Ich  Visuals  Köln	None
KACKMUSIKK	None
KAI HILLMANN	None
KAIN&GABEL	None
KALVIN BERG	None
KARLSRUHE	None
KD Music Pacha	None
KEIKOWASGREAT	None
KEN Live	None
KEVIN GE  FOOTLOOSE	None
KEYS	pop
KISS ROOM	None
KLANGBANANE	None
KLAUS	scorecore
KMS	techno
KONPIUTA LIVE	None
KONZERT BIG PAPA LORENZO	None
KONZERT GEORGE VAINE & PRADER	None
KONZERTE THE FRIDGE	None
KRamba	None
KSandra	None
KTL	drone
KUAGE live	None
Kabale und Liebe	techno
Kablam	fluxwork
Kackmusikk	None
Kackmusikk b2b Cockboy	None
Kadebostan	None
Kadebostan & Laolu	rap
Kafka Kaya	None
Kaiser & Giraffe	None
Kalabrese	house music
Kalabrese & Rumpelorchester	house music
Kalabrese & The Rumpelorchester	house music
Kalabrese and the Rumpelorchestra	None
Kalk Pets  GE	None
Kalles Kaviar	traditional ska
Kalmou	None
Kalvin Berg	None
Kantarik	hip hop
KaraMaehl	None
Karash LIVE	None
Karera	None
Karla	rock
Karmina	techno
Karocel feat Mathias Kaden	None
Karsten Pflum	intelligent dance music
Kartel Klub	None
Kashink	None
KasselDE	None
Kassem Mosse	techno
Katakomben	None
Katalyst	hip hop
KaterBlau	None
KaterBlau  Hive	None
KaterMukke  Berlin	None
Katermukke	None
KatermukkeDE	None
Kath Harding	techno
Kathrin de Boer	None
Katsching Kollektiv	None
Katta	None
Kavinsky	electronic rock
Kejeblos	None
Kellerkind	deep
Kellerkommando	None
Ken LIVE	None
Ken live JU	None
Kenel & Sonne	None
Kengbang und Kelstroem	None
Kenny Ground	house music
Kenny Ground b2b Riccardo Farina	None
Kent Brockmen Digital Frequenz Rec Human Revolution	None
Kerri Chandler	house music
Ketev	mandible
Kev the Head	None
KevKev	None
KevKev & Mahlermeister	None
Kevin Matthews	None
Kevin Over	techno
Kevin Pohl	None
Kevin Shala	techno
Khaderbai	abstract beats
Khainz	progressive psytrance
Ki Yota	None
KiNK feat Rachel Row	None
Kia Mann	None
Kibitz	None
Kid Fonque	None
Kid Koala	downtempo
Kid Konzoom	None
Kid Konzoom Berlin	None
Kid Sublime	hip hop
Kidkanevil	idm
Kiki	rock
Kiko C Esseiva	None
Killian Noorlander	None
Kim Kemi	techno
Kim Prevedello	hip hop
Kim Prevedello 22h at 2h	None
Kim Prevedello est un DJ dorigine cubaine qui allie musique Ã©lectronique et rythmes traditionnels pour des	None
Kim Prevedello est un DJ dorigine cubaine qui allie musique électronique et rythmes traditionnels pour des	None
King Doudou aka Douster	None
Kinky Beats	None
Kinny	downtempo
Kiste	None
KlangFormer	None
KlangKuenstler	house music
Klangdruide	None
Klaudia Gawlas	techno
Klein und Lang	None
Klement Bonelli	house music
Klimperei	None
Kling Klong	None
Klingande	house music
Klingande mit Live Saxophonist	None
Klischee	electro music
Knackeboul	hip hop
Knobs	techno
Knor	None
Knotweed  CH	None
Knox  Zurich	None
Knuff&Knuff	None
Knut	metal
Knäckebröd	None
Kodbar	None
Kode 9	hip hop
Kollektiv Turmstrasse	techno
Koma Dub	None
Koma dub	None
KombÃ©	None
Kombé	None
Komplex 457	None
Konrad Dycke	None
Konzert	None
Kooperative Röschtigraben	None
Koreless	uk garage
Kormac	electro music
Korsett Kollektiv	None
Kosta Dee	deep freestyle
Kotelett&Zadak	None
Kowton	house music
Kraak & Smaak	disco
Kracoon	None
Krankenzimmer 204	None
Kreisprozess	techno
Kreissprozess	None
Kreuzton	techno
Krill Music	None
Krink	electronic rock
Kristel Morin	house music
Kristian Harting	None
Krizzli	disco
Kroman Celik	techno
Krumelur	None
Kruse & Nürnberg	None
Kubin	None
Kuhlmann	deep pop edm
Kun	None
Kunstraum Walcheturm  Kanonengasse 20  8004 Zürich	None
Kurilian Kratz & The Rah	rap
Kurilian Kratz b2b nole	None
Kutmah	idm
Kyodai	techno
Kyoka	mandible
Kyrill & Redford	groove room
Kyros	None
KÃ¶nig der Fischer	None
Köln D	None
KölnDE	None
Kölsch	house music
König Balthasar	None
König der Fischer	None
LA BAAZ	progressive psytrance
LA VITAMINA	None
LCMDF  Le Corps Mince De FranÃ§oise	electrofox
LCMDF  Le Corps Mince De Françoise	electrofox
LCP	None
LDS	None
LE FRÉRE	None
LE ROI	None
LE ROI & DJ 7	None
LEAFCUTTER JOHN	drum and bass
LEE N EFFE	None
LEEO	None
LEONARDO	ranchera
LES	show tunes
LEWIS	None
LEXIS	schranz
LFT live	None
LILY & GREG SHEPHERD	None
LINE UP	None
LITCH	None
LITTLE D	None
LIVE	christian christmas
LIVE AT SET	None
LIVE Dollar Mambo	None
LIVE Konpiùta	None
LIVE Ryan Hawkin	None
LNF	hip hop
LOKD ALLSTAR TEAM	None
LONDRES	None
LONE	indiecoustica
LSM Productions	None
LU	vallenato
LUC MASERA	None
LUCA GEROSA	None
LUCAS RAMIREZ	None
LUFT	techno
LV	None
LVis 1990	None
LXIR	None
LYE	rock
La Cava Stage	None
La Duracelle	techno
La Fleur	techno
La Foret	techno
La Forêt	None
La Fée Verte	None
La Gale	None
La Luciole	None
La Mine Express	None
La NuiT	None
La Rochelle Band	electro music
La Ruche  Lausanne	None
La Ruchet	None
La Vie Cest Facile	None
La Vitamina	None
La mine express	None
Labrador City	None
Lady NooN	None
Lady Noon	None
Lady Noon vs De Feo	None
Ladybruce	None
Lakker	mandible
Laolu	techno
Lapalux	post-disco
Lara Valentina	None
Larcenist	None
Laris Alexander	None
Larry Les Vannes	None
Lars Lindenberg	None
Larytta	techno
Laser Lele	None
Lastest mix  Take it as it is  Vinyl	None
Late	disco
Laura Jones	disco
Laurel Halo	house music
Lauren Garnier	None
Lauren Lane	disco
Laurent Charbon	disco
Lausanne	None
Laut & Luise	None
Layer V	None
Lazare Hoche	dub
Lcp	None
Le Bal 2 vieux	None
Le Baron	house music
Le BÃ©rger	None
Le Bérger	None
Le ChatMan	None
Le Chiffre	None
Le Citadin	None
Le Frère	None
Le Horla	None
Le Spectre	tekno
Le collectif genevois CNSTL a été crée en 2011 Il est composé de 4 djs	None
Le1f	indie r&b
Lebensfreude	None
Lee Burridge  Akowa	None
Lee Curtiss	techno
Lee Fraser	None
Lee Jokes	disco
Leenpee & Effe	None
Lefripon	None
Lefto	hip hop
Lega 237 FamilyMoscou	None
Legowelt	techno
Leif Elggren	lowercase
Leipzig	classical
Leisure Options	None
Leke da Loco	None
Lele DeeJay	None
Lemark	None
Lemonick	disco
Len Faki	techno
Leo	techno
Leo Gretener	dub
Leon Licht	house music
Leon Steve Massive	None
Leonardo	bolero
Leonardo Crespi	None
Leone Music  Suruba X  London UK	None
LeonxLeon	disco
Les Chicklettes	None
Les Diplomates aka Mambo Chick & Jean Toussaint	None
Les Mon Treux	None
Les Yeux Orange	disco
Lesnicar	None
Letabli	None
LethargyZH	None
Levela	drum and bass
Leventino	None
Levin	rock
Lexfinger	None
Lexis	schranz
Lexx	disco
LiVe	christian christmas
Liam Butler	None
Licht Lichtdeffekte	None
Lichtsport vs Bruno Tait  Visuals  DE	None
Lil Silva	uk garage
Lila Hart	house music
Lim Giong	None
Limited Brothers	None
LinG	None
Lindon & Jembo62	None
Lindstrom	electronic rock
Line Up Dienstag 162	None
Line Up Montag 152	None
Line up	None
Ling	None
Lionel Early Sounds	None
Lionel Stephan D	disco
Litch	None
Little Louie Vega	house music
Little Lu	None
Little Lu b2b Jon Donson	None
Live	world worship
Live Dread J	None
Live Familie Schweizers Wohnzimmer	None
Live Jagged	None
Live Jeans Team	None
Live Suspect One	None
Live t	None
Livia Wallace & Manish	None
Living on the Outside	None
Livingroomfm	None
Liviu Groza	disco
Llorca	downtempo
Locloise Ãlectro NE	None
Locloise Électro NE	None
Loco Dice	techno
Lolo	indie poptimism
London	classical
London Nebel	None
London UK	None
Look Like	house music
Loops Haunt	idm
Loquace  Yamen & EDA	None
Lorenz Rhode	house music
Lorenzo Chiabotti AKA IENA SAW	None
Lorik B2B Whim	None
Loris Scaglia	None
Lorn	idm
Los Abstractos	None
Los Cruzeiros	disco
Los Suruba	house music
Los Wenamigos	None
Los Wenamigos & After party w Alex Niggemann	rap
Lost & Found	None
Lost Heritage	None
Lou ReedUlrich Krieger	None
Louie Liköör	None
Louie Vega	house music
Louisahhh	techno
Lovebirds	disco
Low Jack	house music
Low Tales	house music
LowTales & Vanita	house music
Lowrel & Hardy	None
Lu K	None
Lu K & Dubstep	None
Lu K vsFionom	None
LuK	estonian pop
LuLúxpo	None
LuLúxpo La Forêt	None
Luc Ringeisen	house music
Luca Agnelli	disco
Luca Bacchetti	house music
Luca Barletta	None
Luca Barletta  Oliver von Mentlen	None
Luca Carletti & Michael Prize	None
Luca Castagna	None
Luca Eminenti	None
Luca Fiorelli	None
Luca Fioretti	None
Luca Firrincieli	None
Luca Gerosa	None
Luca Lozano	disco
Luca Rinardi	None
Luca Torre	techno
Luca de Grandis	None
Lucalain	None
Lucas Aliu	techno
Lucas Monème	None
Lucas Ramirez	None
Lucerne	None
Luciano	canzone napoletana
Luciano b2b Ernesto Ferreyra	None
Lucien Dubuis	None
Luciover	None
Lucky Duke	None
Lucky Duke b2b Giavier	None
Lucretio	disco
Lucy	pop
Ludo	pop punk
Ludovic B	None
Ludwig Van Electro	None
Luft	techno
Lui Young	techno
Luigi Forte	electro music
Luigi Forte B2B Vellum	None
Luigi Tozzi	dub
Luis Cunha	disco
Luis Radio	disco
Lukas Kleesattel	techno
Lukas Siegwart	None
Lukas Walker	None
Lukastel	None
Luke Le Loup	None
Luke Redford	None
Luke Vibert	techno
Luki	None
Luluxpo	disco
Lumpex	None
Luna City Express	techno
Luna City Express  Moonharbour Berlin	None
Lurob	house music
Lusine	post-disco
Luzern	None
LuzernCH	None
Lvov	disco
Lwrnc	None
Lynda Phoenix	breakbeat
LÃ© Berger	None
Lé Berger	None
Löwenherz	None
MAD ART	None
MADWAVE	None
MAIN ROOM	None
MANDY	pop
MANDY  Philip Jung	None
MANIAK	None
MANNA	None
MANUHEME	None
MANZI b2b SOCI	None
MARCO	grupera
MARTON DI KATZ	None
MAS RICARDO	None
MATHIO	None
MATTHEW HALSALL live	None
MAUDITE & LE HORLA	None
MAURO CAPITALE  Enzo Pianzola	None
MAUY	None
MAX KLEBSON	None
MC Delinquent aka Waterboy	None
MC Fave	None
MC Honeybrown	None
MC Ksailev  Sekoïa	None
ME	metalcore
MEL Y  Stuttgart	None
MES	quebecois
MESS NOIR	None
MF Jaeger	None
MIA	electronic rock
MIAN	None
MIGL	None
MIKE T	deep pop r&b
MIL WAUKEE	None
MINIMALLOUNGE	techno
MIRCO CARUSO	hip hop
MISCHKULTUR BERN  BAILE MUSIK  TIP TAP RECORDS	None
MISS POLANSKY	None
MISTIKK	None
MITEINANDER MUSIK	None
MInidetail artist	None
MNÃVR	None
MNØVR	None
MONTAGMORGEN	None
MRJUKE	None
MRS JONK	None
MSBK	None
MTA  UK	None
MTDF	house music
MTPDelemont	None
MUMTIS & DADBALLS	None
MUSIC	ccm
MYND	None
Maag Event Hall	None
Maag Halle Area 1	None
Maag Halle Area 2	None
Maag Halle Area 3	None
Maag Halle Area 4	None
Maayan Nidam	techno
Macadam Dive	None
Macromism	techno
Mad House  USA	None
Mad Katz DJ Team	None
MadKatz DJTeam	None
Madame Kenel live	None
Madame Patate	None
Madame la Belge	None
Maddslinky	breakbeat
Madfunk	None
Madhouse Records	None
Madnax	techno
Madwave	None
Maertini Broes DJ Team  more	None
Mafou	None
Magda	techno
Magnetic	indie
Mah Mood	None
MahMood	None
Mahi	disco
Mahlermeister	None
Maickel Esse	None
Maickel Esse AKA Inlunius Locus	None
Main Floor	None
Main Floor  EDM	None
Main Room	None
Main Room Ambivalent	None
Main Stage	None
Mainfloor	None
Maja Ratkje	laboratorio
Makau	techno
Makhno	hip hop
Makorokosmos AG	None
Makossa & Megablast	disco
Malicious Joy	None
Malik	pop
Maloon TheBoom	None
Mambo Chick	None
Man of Tomorrow	None
Mandrax	None
Mangali	None
Mani	dancehall
Manic Mike	techno
Mannequine	disco
Mannequine from Zurich	None
Manoletto	None
Manon	techno
Mantocliff	None
Manu Chaman	disco
Manu Gonalez	None
ManuHeme	None
Manuel De La Mare	techno
Manuel Fischer	None
Manuel Mind	None
Manuel Moreno	None
Manuel Sahagun	house music
Manuelle Music	None
Manuelle Musik	None
Mar Cel	None
MarT	swedish punk
Marbert Rocel	house music
Marc Benz	None
Marc DArrigo	house music
Marc DArrigo & Simian Keiser	rap
Marc DArrigo b2b Guy Joshua	None
Marc Evans	house music
Marc Feldmann	None
Marc Fuhrmann	None
Marc Houle	techno
Marc Klein	None
Marc Loin	None
Marc OTool	None
Marc Robert	None
Marc Romboy	techno
Marc dArrigo	techno
MarcIntosh	None
Marcel	r&b
Marcel Hofer	None
Marcel Vogel	None
Marcellus Pittman	house music
Marché sans puces dès 16h00	None
Marcio	None
Marcism	None
Marco Adriano	brazilian gospel
Marco Bailey	techno
Marco Berto	disco
Marco Capone	None
Marco Carola	techno
Marco Da Mata	None
Marco De Rosa	house music
Marco Effe	techno
Marco Repetto	None
Marco Resmann	techno
Marco Rossi	None
Marco Trinkler	None
Marco Yanes	electronica
Marco Zenker	dub
Marco del Sol	None
Marcos Del Sol	None
Marcos del Sol	None
Marcow	None
Marcus Meinhardt	house music
Marek Hemmann Freude am Tanzen  DE	None
Margaret Dygas	dub
Mariachi	grupera
Maricha	None
Marika Rossa	techno
Mario Aureo	None
Mario Ferrini	None
Mario Ferrini feat Ylenia	None
Mario Neha	None
Mario Pietsch	None
Mark A Brook	None
Mark Ernestus	fluxwork
Mark Henning	techno
Mark Main	None
Mark Stone	None
Mark de Clive Lowe	indie jazz
Mark de CliveLowe	None
Mark off & Curtiss	rap
Markantonio	techno
Markova	pinoy alternative
Markus Homm	techno
Markus Kenel	house music
Markus haZe	None
Marlaude	None
Marlon	None
Marrocco	None
Marshall	rock
Martello Bros	None
Martha van Straaten	None
Martin Baur	techno
Martin Buttrich	techno
Martin Huergo	techno
Martin Ikin	house music
Martin Landsky	techno
Martin M	None
Martin Meier	None
Martin Neukom	None
Marvel Lane	None
Marvin & Valentino	rap
Marwin	None
Mas Ricardo	None
Masaya	hip hop
Mass Davey	None
Massimo Stefanelli	disco
Massive Jay	None
Master Margherita	world fusion
Mastra	deep
Mastra Live	None
Mat	pop
Matador	francoton
Mateo Morales	None
Matheiu	hip hop
Mathew Jonson	techno
Mathias Kaden	techno
Mathias Mesteno	techno
Mathieu	None
Mathieu Raetz	None
Matija	None
Matrixxman	house music
Mats LindstrÃ¶m	None
Mats Lindström	None
Matt Black & Jon More from Coldcut	rap
Matt Newman	None
Matt Prehn	disco
Matt Tolfrey	techno
MattX	None
Matteo Arcucci	techno
Matteo Melillo	None
Matteo Melillo  Techno Room From 200 to 330	None
Matteo Melillo DJ	None
Matteo Trippi  Luca Terzi	None
Matthew	None
Matthew Adamas	None
Matthew Dekay	deep progressive trance
Matthew Square	None
Matthew Styles	house music
Matthias Meyer	house music
Mattia Presta	None
Matto	j-dance
Matto Belmondo aka	None
Mattoo	rock
Maurice n Morris	None
Maverick Renegade	None
Max Albàn	None
Max B Grant	hardstyle
Max Cadence	None
Max Cooper	house music
Max Graef	house music
Max Klebson	None
Max Nero	techno
Max Orian Vs Rob Dolder	None
Max Power	None
Max Robbers	None
May Kay	None
Maybe	None
Me&her	rap
Medium	None
Medo	None
Meester Krizz	None
Megablast	None
Mehhr	None
Meikel	techno
Melanie Groley	None
Melchior	garage pop
Melodiesinfonie	abstract beats
Membrane	covertrance
Mendo	house music
Mental Groove	None
Merico	channel pop
Meridian Brothers	nu-cumbia
Merik & GStone	None
Merik& GStone	None
Merk	None
Mess Me	electro trash
Metaboman	microhouse
Metaphysical	hip hop
Metodi Hristov	house music
Mewa Moog Lee	None
Mexico	cumbia
MexicoGE	None
Mi Manos	techno
Mia	electronic rock
Mia Kaltes	None
Mia Kaltes  Finefood rec	None
Miami Dave	None
Miami Room Resident Djs Paolo Di Mirò	None
Miami Room with Anthony Dandrea	None
Miau Studio Floor	None
Michael Calfan	house music
Michael Fresh	None
Michael Gull	None
Michael Placke  Exquisite Berlin  Shitlabel  Deine Lieblingsraver  Suicide Circus	None
Michael Placke Exquisite Berlin  Shitlabel  Deine Lieblingsraver  Suicide Circus	None
Michael Reinboth	hip hop
Michal Ho	None
Michel Cleis	None
Michel Degen B2B Atila	None
Michel Degen b2b Atila	None
Mick Sick	None
Mickail	None
Micky Monzza	None
Miett	None
Miguel Campbell	disco
Miguel Puente	disco
Miguel Rendeiro	techno
Mihael Simic	None
Mihai Popoviciu	house music
Mihalis Mavros	None
Mik Maroo	None
Mika Vainio & FRANCK VIGROUX	None
Mike & Nika	None
Mike Candys	house music
Mike Huckaby	house music
Mike Kay	None
Mike Peters	disco
Mike Steez	None
Mike Väth	None
Mike Wall	disco
Mike Waulie	None
Miky Merz	None
Mil Waukee	None
Millivolt	None
Milos D	None
Milosz	None
Mimanos	house music
Mimmo	None
Min	pop
Min King	None
Mind Against	techno
Mind Candy	hardcore
MindX Snowman	None
Mindfuture	None
Mindsurfer	None
Mini Floor by Schwarzmatt	None
MiniGui98	None
Minidetail VD	None
MinidetailLausanne	None
Minimal	None
Minimalwasser	None
Minimat & nanard	techno
Minimetal	None
Minishake	None
Minus 8	downtempo
Mira	classical
Mira Calix	intelligent dance music
Mirco	house music
Mirco Caruso	hip hop
Mirco Esposito	None
Mirco Many	rock
Mirco Many dj	None
Miriati	None
Mirio Live	None
Mirko Di Florio	house music
Mirko Loko	techno
Mirko Molinari	house music
Mirko Paoloni	disco
Mirus & Hazy	rap
Mischkultur	None
Miss Duckin	None
Miss Flora	disco
Miss Flower vs JudgAnn 20 Years Of Hardcore Special Anniversary Cut A Kaos vs LemX The Massacre vs	None
Miss Ly One	None
Miss Polanski	None
Miss Shine	house music
Miss Sunshine	techno
Miss TessX & Emo	None
Mista Mista	trap
Mistamista	None
Mister Desolation	None
Mister Softy	None
Mister smoke	None
Mister smoky	None
Miteinander Musik	None
Mitikal	None
Mitsutek	techno
Mitura	None
Mix	pop
Mixing up styles and moods	None
Miyagi	house music
Mlive and Saver	None
Mlk  Dnh	None
Mln	None
Mo Kolours	abstract beats
MoTek	rock
Mobilee showcase	None
Mobylette	None
Mode Of Motion	None
Moderat	electronic rock
Modestep	uk garage
Modestino & Ed Luis	None
Modulaw	None
Modulove	None
Moe&Zard	None
Mole	indiecoustica
MonNsta	None
Moniak	None
Monica X  TOM VIBE	None
Monika Kruse	techno
Monkberry Moon Orchestra	None
Monkey Breeders	None
Monkey Coops	jungle
Monkey Freaks	None
Monkey Maffia	techno
Monkey Safari	deep
Monkeys Beatz	None
Monoblock B	None
Monocline  Planet Rhythm	None
Monoplage	None
Monoteque	None
Monotox	None
Monowatt live	None
Moonbootica	house music
Mop Mop feat Ange Da Costa	None
Morard	None
Morb	None
Morbid Sound	None
Mord	uk garage
Mordax	techno
More	metal
Morgan Button	None
Morgan Geist	None
Morgan Hammer	disco
Moritz & Max	rap
Moritz Praxmarer	None
Moro & Floro	None
Motherland Soundsystem	None
Motor City Drum Ensemble	house music
Mouchou	None
Mountain People	techno
Mouse On Mars	ninja
Moxie	techno
Mozart	classical
Mozzy	trap
Mr Deecz	None
Mr Friction	None
Mr G	None
Mr Hobbs	None
Mr Pigman	None
Mr Pnk	None
Mr Raoul K	techno
Mr Riddler	None
Mr Rod	None
Mr RoxOn & Simon	None
Mr V	electro jazz
MrCheeky	None
MrDaNos	None
MrFiction	None
MrLucky	house music
MrParanoia	None
MrTimeless	None
Ms Hyde	None
Ms Hyde  Fabelhaft  Lady Bruce & YaYa	None
Mucho Stylez	techno
Mukatsuku	None
Mule Musiq	None
Multivitamins	None
Multivitamins  Argentina	None
Munich	classical
Munir Nadir	None
Murciano	house music
Murcof	ambient
Murcof & Philippe Petit	None
Muri	None
Murphy	rap
Mushrooms Project	disco
Music by	None
Musique Large	None
My Favorite Robot	disco
Myah	None
Myah  CA	None
Mykki Blanco	fluxwork
Mynightlifefm	None
MÃ¶rk  CH	None
Médiateur Electronics  F	None
Mörk  CH	None
München	None
NADER	techno
NAHSTE ONER  MUSIQ REC	None
NDKj	techno
NDroo	None
NE	pop
NEBAT Drums	None
NEMO	rock
NESHA  MinimalFraktion	None
NEWCOM	None
NICOB	None
NICODISCO	None
NILS	modern
NIP	rap
NL	house music
NOIR	house music
NOISE	None
NOOMA	None
NOX & DADBALLS	None
NOXS BEAT Live	None
NS Kroo Sound System	None
NTO	techno
NU	kompa
Naca	None
Nachtstrom Schallplatten	None
Nader	techno
Nahste Oner	None
Naikido	None
Nakadia	techno
NamRon N rtingenDE	None
Nanodio	None
Nash	folk
Nast Le Chat	None
Natan H	disco
Natch	techno
Nate Young	uk garage
Nath	None
Nathansbraten	None
Ndee booking	None
Nebukat Nezar	None
Nebukat Nezar b2b Nicola Noir	None
Ned ONeal	None
Ned ONeal  MinimalFraktion	None
Neekee	None
Neet	techno
Neevo	None
Nekow	disco
Nelson De Jesus	None
Nelson Garcia	dominican pop
Nemelka	None
Nenad J	None
Neo Mds	None
NeoMds	None
Neon Golden VJ	None
Nervös	rap
Netsky	house music
Never	pop
Never Die	None
Neverending	canadian indie
New York  Berlin	None
New York Room DJ pitch	None
New York Room with Pitch	None
Newcom	None
Ngoc Lan	vietnamese pop
NiKo	techno
Nic Fanciulli	house music
Nicc Johnson	trap
Nici Faerber	hip hop
Nick Evans	None
Nick Frankenberg	None
Nicko	None
Nickodemus	downtempo
Niclas	None
Nico	pop
Nico B	None
Nico Calado	None
Nico Mariani	None
Nico Massa	None
Nico Morano	disco
Nico Pusch	house music
Nico Sonne	dub
Nico Wilde	None
Nicola Kazimir	disco
Nicola Koch	house music
Nicola Noir	None
Nicolaj	None
Nicolas Bernier & Martin Messier	None
Nicolas Duvoisin	rap
Nicolas Eisbär	None
Nicolas Harver	None
Nicolas Jehouda	None
Nicolas Lutz	None
Nicolas Masseyeff	house music
Nicolas Ruiz	disco
Nicole Moudaber	techno
Nicone	house music
Niconé & Sascha Braemer	house music
Niels van Gogh	techno
Nightmares on Wax	downtempo
Nik	rock
Nik Frankenberg	None
Nik Weston	disco
Nik dj	None
Nikitch	indie jazz
Nikola Kotevski	None
Nils Frahm	modern
Nima Gorji	techno
Nina Kraviz	techno
No Mercy	hi-nrg
Noah Pred	disco
Nobee	house music
Nobodys Perfect	None
Noctambulo	None
Noedweisz	None
Noiiises	None
NoirDE	None
Noise	None
Noiz	dubsteppe
Nolé	None
Nonchalance	None
Nonsdrome	None
Nooncat	None
Norbert Möslang	lowercase
NorbertTo	None
Norbertto	None
Nori	techno
Norway	rock
Nova Materia	None
Nozinja	None
Noé Weigl	None
Nu Disco ou encore Indie dance	None
Nu Pulse	None
Nuemp	None
Nukem	disco
Nutters	None
NØ TWINS	strut
OBF Sound System ft Shanti D	None
OFF Recordings  UK	None
OLIVER M & SMER	None
OLLIN	None
ONNO	techno
OSSIE	uk garage
OY	hip hop
Ockham	None
Octave	techno
Octopus  New York	None
Off Rec	None
Official Powers of Ten Album Tour	None
Og Spiritual Godess	None
Ohrstrom	None
Ojié	None
Ok Vancouver Ok	None
Okram	None
Olafson	techno
Olafson  MATTHEW SQUARE  Damian Deroma	None
Olga Kokcharova	None
Oliver & Buzz	None
Oliver Aden & Luis Cruz	None
Oliver Eich	techno
Oliver Huntemann	techno
Oliver K	re:techno
Oliver Klinghoffer	None
Oliver Koletzki	house music
Oliver Koletzki Stil vor Talent  DE	None
Oliver Schories	house music
Oliver Stumm	None
Oliver von Mentlen	None
Olivier Kolly	disco
Ollin	None
Omar Souleyman	arab pop
On the wheels of steel	None
Ondrej	techno
OneFootStep	techno
Oneothrix Point Never	None
Onory	None
Onra	downtempo
Onur Gokhan Gokcek	None
Onur Özer	techno
Onur Özman	deep
Openair Sven Väth	None
Opening 2300  0500	None
Opossumini	None
Opuswerk	techno
Oracy	house music
Oram Modular	None
Oscar C	disco
Oscar Der Winzige	None
Oscar Niczzo	None
Oscar Schubaq	techno
Ostkost Djkollektiv	None
Osunlade	house music
Otavio	None
Otis Ango	techno
Outside Terrace Floor	None
Outstrip	techno
Overless	None
Ovum	None
Oxensa	techno
Oy	hip hop
Ozan	turkish
Ozelot & Lizerd	None
P0gman	zapstep
PASCALLA	None
PASCI	None
PATRIQUE	None
PBecker	None
PBell	None
PCC	None
PHIL RISS & ALI C	None
PHURPA	None
PIERICK	None
PIERICK & Bfly Steiner	None
PIGMAN	None
PLASTIQUE DE REVE	techno
POL	None
POLONIUM 8879	None
POSITIVE FORCE	post-disco
POSSA	None
PSYCHO WEAZEL	None
PSYCO WEAZEL	None
PTess	None
PTess dj	None
PYLONE	electronica
Pablo Bordon	None
Pablo Einzig	techno
Pablo Mateo	techno
Pablo Nouvelle	house music
Pablo Nouvelle Live	None
Pachanga Boys	None
Pacifica	string quartet
Paco	cuban rumba
Paco Osuna	techno
Pad Beryll	house music
Painted Palms	indie dream pop
Pako S	house music
Palms Out Sounds	None
Palnoise	None
Pampa Records  Stockholm	None
Pan	trap
PanPot	None
Pandallougi	techno
Pandour	None
Panevino	None
Pantha Du Prince	electronic rock
Paolo Di Mirò	None
Paolo Mentonelli	None
Paolo Montenelli	None
Para One	house music
Paride Saraceni	None
Paris	uk garage
ParisFR	None
Parquet Rec	None
Parris	techno
Party Killers	None
Pasa	None
Pascal Inc	None
Pascal Oliver	None
Pascal Strambini	None
Pascal Tockar	None
Pascal Tokar vs Jerry	None
Pascal Viscardi	disco
Pascal Wirz	None
Pasci	None
Pask	None
Pasquale C Peak	None
Paste 20	None
Pat Farrell	None
Pat K P	None
Pat KP	None
Pat Particia	None
Pat Patrisha	None
Patric la Funk	None
Patrice Bäumel	house music
Patrick Becker	disco
Patrick Kunkel	techno
Patrick Podage	groove room
Patrick Wolf	chamber pop
Patrick Zigon	techno
Patrique	None
Patrique B2B Luca Vallante	None
Patrischa	house music
Paul A	None
Paul Kalkbrenner	techno
Paul Mac Bonvin  Sun Sessions	None
Paul Mad	techno
Paul Thoma	None
Paul Trouble Anderson	None
Paul Van Dyk	trance music
Paul Woolford	house music
Paula Temple	dub
Paulo CÃ©sar  Strange People	None
Paulo César  Strange People	None
Paulo Oliveira	None
Pavel Plastikk	disco
Pavel live	None
Pawas	techno
Pawlikowski	classic polish pop
Pazkal	techno
Peak	None
Pech & Schwefel	None
Pedram	None
Pedro Andrade	None
Pedro Voice	None
Pendler	None
Pendulum	drum and bass
Pentagonik	None
Pepe Brogna	None
Pepito Lindo	None
Perc	techno
Perigoso	None
Perlon	None
Perlon  Amsterdam	None
Perrine En Morceaux	None
Perry Pierce	None
Perspectiv GE	None
Pesoa & cie	None
Pete & Pete	hip hop
Pete Lewis	None
Peter D	techno
Peter Kneer	None
Peter Lavelle	None
Peter Van Hoesen  time to express	None
Pettinato	None
Peven Everett	neo soul
Pezzner	techno
Phala	None
Phala b2b Lazy Mood	None
Phantom Island	None
Phil Asher	breakbeat
Phil Karg	None
Phil Kieran	techno
Phil Martins	None
Phil Riss & Ali C	None
Phil Riss & Ali c	None
Phil Weeks	house music
Phil Zviel	None
Philemon	None
Philipp Aregger	None
Philipp Rochard	None
Philippe Carson interpreted by François Bonnet	None
Philippe Jeanneret	None
Philippe Petit	techno
Philippe Petit all night long	None
Philippe Vilfroy	None
Phillip Inäbnit	None
Phillip Pirreguer	None
Philosophy	None
Phobiq  Italy	None
Phobos	None
Phoibass	None
Phonokiller	None
Phonosynthese live	None
Phrex	None
Phurpa	None
Phuture Traxx	disco
Pier Bucci	techno
Piero P	None
Piero P & Luigi Forte	None
Pierre & Jonathan	techno
Pierre Piccarde	None
Pierrot des Ballons	None
Pietro Mancini	None
PingPongRundlauf	None
Pino Arduini	None
Pion Tek	None
Pional	disco
Piratenkind	None
Pixelpunx	None
Pièrick	None
Plaid	techno
Planet Mu	None
Planetary Assault Systems aka Luke Slater	None
Planktom	house music
Plastic City Rec	None
Plastique de Rève	None
Platform	None
Play  Rex Club Paris	None
Play Lego Bitch	None
Playdoe	None
Player b2b Belcastro	None
Playlove	techno
Pleasurekraft	techno
Ploonz	None
Plus8  Marseille	None
Plusculaar	None
Plyone	None
Pokerflat  Berlin	None
Pokerphil	None
Pol Wise	None
Polonium 8879	None
Polydance DJs aka Alan Bolumar & Androo	None
Polydance Djs aka Alan Bolumar & Androo	None
Pomassl	idm
Pool party Stage	None
Pornbugs	disco
Portugal	rock
Post Scriptum	techno
Pow Low	disco
Powder & Louder	techno
Powell	scorecore
Powerplant  Berlin	None
Praslea	disco
Presales STARTICKET	None
Press C	None
Primal Scream	rock
Princess P	None
Prins Thomas	balearic
Prinzessin in Not	None
Prism	None
PrivilÃ¨ge Ibiza	None
Privilège Ibiza	None
Procid	None
Producteur de lombre pour le djs de ibiza	None
Professor Wouassa	afrobeat
Profilter	None
Profondo	None
Prog On Syndicate	None
Prommer & Barck	None
Proof of Concept	None
Proudly People	techno
Psyberpunk	None
Psychemagik	balearic
Psycho Weazel	None
Psyk	dub
Psykoloco	house music
Psypatrice	None
Public Possession	disco
Puma	house music
PumpNKing	None
Punch Drunk Music	None
Pupkulies & Rebecca	house music
Puppetmastaz	hip hop
Pure Ground	None
Purp	None
Purple Project	None
PushAnimal	None
Pyramides de Vidy	None
Qantiem aka Philippe Dunst	None
Qbig & Zenith B	None
Qebeq	None
Qebeq & special guest	None
Qix	techno
Quakers	None
QualityTime	None
Quantic	downtempo
Quentin Mosimann	None
Quesadillas Jr	None
Quinto Elemento	regional
Quitim	None
Quitim  Marcio  Dee Nelli  Stoga  Der Kleine Italiener  Dani S & Dilusso  Fabian Kozelsky	None
R San	None
RACKER	None
RAPHAEL RABAN	None
RBMA  CH	None
RED SKY	metal
REKLOK	None
REUNION	regional mexican
REVERSE	emo
REX & DUX	house music
RICCARDO DE CICCO	None
RINO	rap
RIVE MAGENTA & FRIENDS	None
RO	rap
ROCCA	None
ROGER23	disco
ROMANO THE ALCHEMIST	None
ROMEO	bachata
ROOFTOP	None
RTec	None
RZone	None
RabrÃ©	None
Rabré	None
Rabré & Les Petits Chats	None
Racker	None
Radi & Keith	None
Radio Slave	techno
Radro & Daniel Marrone	None
Rafeeq	None
Ragesh Nair	techno
Raijn Reed	None
Rainer	techno
Rainer TrÃ¼by	None
Rainer Trüby	None
Ralf GUM	house music
Ralf dj	None
Ralph Good	techno
Ralph Sliwinski	techno
Ramady feat ManuL	None
Ramin	scorecore
Ramin  Wuzztäzz	None
Rampue	deep
Ran Salman	techno
Randall M	None
Raphaello	None
Raphaël Belfiore	None
Rapu & Nekow	None
Rare Movement	house music
Rasael Herve	None
Rauschkraft	None
Raven Scott	None
Raw Operators	None
Raw Records  CH	None
Ray Douglas	None
Ray Jones	None
Raycito	None
Rayos de Sol	None
Razor	metal
ReAxis	disco
Rearte	None
Reas	house music
Reber	house music
Reboot	techno
Recarey	None
Recarey B2B Max Clebson	None
Recondite	house music
Red Jam	None
Red Sky Floor  Mash Up & House	None
Reese Bau	None
Reezm	None
Regenbogen	ostrock
Reggy Van Oers	techno
Regular	disco
Rejjie Snow	hip hop
Remady & ManuL	None
RemarK	None
Remote AreaVD	None
Renato Broccini	idm
Renè	grupera
Reset Robot	techno
Resident Advisor	None
Resident Dj	None
Resident WLD Djs	None
Resopal	None
Resorted Recordings	None
Reto Ardour	techno
Reto Ardour & Benja	techno
Retrocyclique LIVE	None
Revolvercanada	None
Rhadoo	None
Rhadow	None
Rheda Andrews Br  MatteoArcucci Ch  Fabio Guarriello It XLR Showcase	None
Rho	rap
Ricardo Santos	easy listening
Ricardo Villalobos	techno
Riccardo De Cicco	None
Rich	rap
Rich Miles	None
Richard Dorfmeister	downtempo
Richard Earnshaw	house music
Richie Hawtin	techno
Rico OBF	None
Rico Roso	None
Rider	lift kit
Riki Ustrell	None
Rina Lou	None
Rino	rap
Riot School	None
Riot School & KRamba	rap
Riotboy	None
Riotboy b2b Third2Second	None
Ripperton	soul
Riton	house music
Rizzoknor	None
Ro	rap
Ro&Mat	None
Robbie	pop
Robbie Naish	None
Robby Naish	None
Robel	None
Robert Henke Dust	None
Robert James	disco
Robert Nesta	None
Roberto Didio	None
Robin Martinelli	None
Robonaut	None
Rocco	disco
Rodney	country
Rodney Hunter	downtempo
Rodri	None
Rodrigo Rivera	disco
Roger MÃ¼ller	None
Roger Müller	None
Roger Torroni	None
Roger the Doger	None
Rogi	None
Roksonik	None
RolandSousa	None
Rolexx	None
Rolf Imhof	None
Rolf Saxer	disco
Rollin John	None
Roman	None
Roman Klinger	None
Roman Klinger b2b Murciano	None
Romano 4the groove	None
Romano Ciccone	None
Romano Corsini	None
Romano Forthegroove  urban structure	None
Romano Rapeso	techno
Romano The Alchemist	None
Romanov	None
Romeo	tropical
Ron Costa	techno
Ron Shiller	None
Ron7	None
Ronald Grauer	None
Rone	techno
Ronny Vergara	techno
Rootwords	None
Rootystep Selecta	None
Roque le Char	None
Rosalinda	None
Rossko	techno
Rostock	None
Rotary	jazz funk
Rotchopf	None
Round Table Knights	hip hop
Round Tables Knights	None
Rover	None
Rowboat Records	None
Roy Ayers	soul
Roy Misher	None
Rozzo	techno
Ruben Coslada	None
Ruede Hagelstein	techno
Rufio	punk
Rumlaut AFOXE	None
Rumpltanz	None
Rusconi	None
Ruy Hankil	None
Ryan Hawkin	techno
Ryan Sullivan	techno
Ræve	house music
RïmsN	None
RömsN	None
Rüssel & Pfeffer	None
Rüssel & Pfeffer  WORLD PREMIER	None
S S S S	pop
S S S S  Four S	None
SA 28  13H30  02H00	None
SAD Visuals	None
SALA VERSACE	None
SAM GENIOUS	None
SASDelémontCH	None
SAT 5t	None
SATURDAY NIGHT	None
SAUL	regional
SDANKE	None
SDANKE  SBAR  A TOUCH OF DEEP	None
SE	None
SE Dzogchen Rinpoche	None
SEBASTIAN WOJKOVSKI	None
SERGIO MESA	None
SERGIO MUSA	None
SHAKE YOUR BODY	None
SHE NIONIKA	None
SHE Spells Doom	disco
SHXCXCHCXSH	mandible
SIGMASIX	None
SIKK Project	None
SIMON	folk
SIOPIS	techno
SIS	hip hop
SKAI	disco
SKOR FEAT SNOOPY OVER THE HILLS	None
SKY JANSSEN anymany zurich	None
SLiCE	death core
SMALL ROOM	thai indie
SMEGMA	german oi
SMOG  DE	None
SNORK	None
SO 15082010 AFTERHOURS	None
SOPHIE LE MEILLOUR	None
SOSO	hip hop
SOULTOWN LOUNGE hosted by Audiotheque	None
SPACEPLANET	None
SPARGA	None
SPECIAL GUEST VOICE	None
SPHERE	house music
SPHINX	None
SPINL Live	None
SRubinfeld	None
STAGGA	uk garage
STEFAN BINIAK	None
STEPHG	None
STERAC aka Steve Rachmad	None
STEVEN JAMAL	None
SUN 6t	None
SUPERSHIRT live	None
SURPRISE SURPRISE SURPRISE	indie
SVKRE & SLODOWSK	None
SWE	zouk riddim
SWINDLE	uk garage
SWIT HONEY	None
Sa 2609 1200  100	None
Saalschutz	german indie
Sabb	techno
Saben Volkshaus	None
Sacha Robotti	techno
Sachi Toyama	None
Sachi Toyama &BaZZkd	None
Saigo No Shudan	None
Sajjanu	None
Sakro	hip hop
Salvatore Donnarumma	None
Salvatore Freda	techno
Salvatore Romeo	None
Salz & Pfeffer	None
Salzunpepper	None
Sam Carter	traditional british folk
Sam Divine	house music
Sam Genious	None
Sam Hauser	None
Sam Jog	None
Sam K	rap
Sam KDC	drumfunk
Sam Paganini	techno
SamHauser	None
Samanta Fox	disco
Sammy Gee	None
Sampayo	None
Samuel andre madsen	techno
Samuele Merk	None
Samy Boulbrima	None
Samy Demonti	None
Samy Fresh	house music
SamyDemonti	None
San Marco	deep orchestral
San Proper	techno
Sandro Augello	None
Sandro De Marco	None
Sandro Falletta	techno
Sandro Falletta & Dalibox	techno
Sandro Kuhne	None
Sandro KÃ¼hne	None
Sandro Kühne	None
Sandro ZH	None
Sandro silva	house music
Sante	house music
Santiago Cortez	None
Santoros	rock
Santos Resiak	techno
Santosh Khan	disco
Santé	deep
Sany Sanderson	None
Sarah Quartetto band	None
Saravah Soul	afrobeat
Sari	musica para ninos
Sarna	techno
Sasch BBC	hip hop
Sascha Braemer	house music
Sascha Cigrovski	None
Sascha Dive	techno
Sascha Funke	techno
Sascha Rohrer	None
Sascha Stohler	None
Sascha Stohler & Arnstroem	None
Sasha Carassi	house music
Sassy J	fake
Saty	None
Saved Records	None
Sayan	dub
Sayan Sobuth	rap
Scaloni DJ	None
Schaffhausen	None
Schall & Rauch	None
SchallLounge	None
Schallplatz	None
Schlaasss	None
Schlachthofbronx	house music
Schlechter Einfluss	None
Schmerol	None
Schnautzi	None
Schwedenparty	None
Schwer	None
Schwester Gill	None
Scody live	None
Scoopy	None
Scott Brown	hardcore
Scott Ferguson	house music
Scott Kemp	techno
Scratch Bandits Crew	electro music
Scream	trap
Sdanke	None
Sdanke & Style	None
Seb Blake	disco
Seb Blake & Albi	rap
Seb Zito	techno
Sebas O Verde	techno
Sebas O Verde vs Adam Winston	None
Sebastian Ingrosso	house music
Sebastian Mullaert aka Minilogue	None
Sebastian Spring	techno
Sebastian Wojkovski	None
Sebastian Wojkowski	None
Sebb Bash	None
Second Deck	None
Secret Garden Team	None
Secret Island	None
Secret Island Nation Special Guest	None
Sectio Aurea	dark psytrance
Sedna & Dubhe	None
Sedzed	None
Sedzed b2b El Alusinante	None
Seiji	orchestral
Sekoïa	None
Senking	techno
Senoo	anime score
Senor Calor	None
Sensient	psytrance
Sentiment	None
Seph	techno
Serafin	opera
Seranthony	None
Sergio Mauri	disco
Sergio Trillini	None
Serotonic	None
Servet Argin	None
Seteve	None
Seth Troxler	techno
Sevenstyler	disco
Several Definitions	house music
Sex Organs	None
Sezo	None
Sezo vs Artkill	None
Shabazz Palaces	hip hop
Shabba	reggae
Shabba & Daitan	None
Shades	techno
Shadi Megalla	None
Shadi Megallaa	None
Shaggy	pop
Shaka	grupera
Shaka aka Kurt Spichiger	None
Shake it maschine B2B MrPigman	None
Shanti Celeste	house music
Shawn Cloud	None
Shawnecy	techno
She DJ Vanita	None
She Dj Nionika	None
She Nionika	None
Shed	britpop
Sheila She Loves You	None
Shinedoe	techno
Shinichi Osawa	j-dance
Shivan & Medo	None
Shlomi Aber	techno
Shonky	disco
Shrubbn	disco
Shy Lajoie & Whisker	None
SidJoe	None
SideJoe	None
Sidgis	None
Sieber	None
Sied van Riel	trance music
Siegair	None
Sierra Sam	None
Sigmasix	None
Signori Misteriosi	None
Silat Beksi	None
Silent Neighbors	None
Silly Walks Soundsystem feat Patrice	None
Silvano	None
Silvision	techno
Simbad	breakbeat
Simbad and Gilles Peterson	None
Simian Keiser	None
Simian Keiser & Marc DArrigo	rap
Simian Mobile Disco	electronic rock
Similar Disco	None
Simo	house music
Simon & Shaker	deep uplifting trance
Simon Berz	None
Simon Effect	None
Simon Kwe	house music
Simon Lemont	None
Simon Slice	None
Simya & Grobi	None
Sinitrio	None
Sinjin Hawke	house music
Sinner DC	techno
Sins	None
Sins  WFmusik	None
Sir Colin	choral
Sir Kay	None
Sir Sway	None
Sirion	progressive psytrance
Skail Master M	techno
Skaos	ska
Sky & Anyken	None
Sky & Ezikel	None
Skyguide	None
Slap	house music
Sloven	techno
Slowly Rico & Looney Tune	None
Smallpeople	house music
Smalltown Collective	techno
Smart Monkeys	None
Smash TV	None
Snowstorm	None
So 2709 1200  100	None
Soame	disco
Soame Arosa Electronica	None
Sobuth&Weiss	None
Society	metal
Society Music Recordings	None
Soe	None
Sofa Tee	None
Soft Metals	grave wave
Soft b2b Mister Desolation	None
Softy	None
Solee	house music
Soliman	techno
Soloduo	classical guitar
Soloduo  Wuzztäzz	None
Solomun	house music
Solvane	techno
Some Truths	hauntology
Somtek & Jools	rap
Sonja Moonear	None
Sonny Catanese	None
Sonny Garcia	None
Sorgenkind Human revolution	None
Sossa	disco
Soul Clap	disco
Soul Minority	disco
Souldynamic	house music
Soulnotes Rec	None
Soulsonic	ambient
Soult	None
Soultronik	None
Sound Pellegrino	techno
Sound Pellegrino  FR	None
Sound of Stereo	techno
SoundSow	None
Soundcloud  httpssoundcloudcomfelixetchatmangolakedrive3	None
Soundcloud  pascalviscardi	None
Sous Sol	rap
Sous Sol & Dread J	rap
Sous Sol vs Martin Baur	None
Soussol	rap
Space	idm
Spain	None
Spartaque	techno
Special Guest	None
Special K	disco
Special Request	bass music
Special guest Euphoria	None
Special guest Murat Kilic	None
Special guest The Martinez Brothers	None
Specialivery	techno
Speedy J	techno
Spektre	techno
Spenzas Overdub Orchestra	None
Spenzas overdub Orchestra	None
Spice 52	None
Spielplatz Helden Basel	None
Spikers	None
Spitfire	techno
Spitfire & Tigris	techno
Spitfire & Xcess	techno
Sprout	rock
Spruzzi	None
Spudnix	None
SquarElectric	disco
Squep	techno
St Germain	downtempo
St Plomb	None
StPaul	None
Stairs	hip hop
Stallo	None
Starsand	None
Starshiptroopers	None
State of the Art	None
Static Frames	None
Station service	None
Stavroz	deep
Stay	stomp and holler
Steeve March	disco
Stefan Goldmann	techno
Stefan Roigk	None
Stefano Fodrini	None
Stefano Ghislieri DJ	None
Stefano Pedretti	None
Stefano Pedretti  Commercial Room From 200 to 500	None
Steff La Cheffe	hip hop
Steiner	soundtrack
Stendeck	industrial music
Stephan Bodzin	techno
Stephen Beaupré	None
Stephen Bodzin	None
Stephen OMalley	None
Stereo Express	house music
Stereo Total	electronic rock
Steve Active	None
Steve Bug	techno
Steve Cole	smooth jazz
Steve Massive	None
Steve Massive  TICINO	None
Steve OSullivan	techno
Steve Sanders	None
Steve Summers	house music
Steven Beyer	techno
Steven Engelmann	rap
Steven Jamal	None
Steven Stone	None
Steven Wallace	None
Stig	hip hop
Stiglitz&Bernstein	None
Still Pitch	None
Stockholm  SE	None
Stoga	None
Stoga saugstauber	None
Stonato	None
Stony Ahead & Soe	None
Stony Ahead & SortE	None
Storlon	None
Strahlemann & TÃ¶ne	None
Strahlemann & Töne	None
Strassenmajor	None
Strb	None
Strb b2b Nemelka	None
Strobetech	None
Stube Hosted By	None
Studer TM	None
Style & UniT	None
Styro 2000	None
Styx Recordings  UK	None
Stéphane Attias	breakbeat
Suara	visual kei
Sub Secret	techno
Sub Zero	hardstyle
Subban	None
Substance	techno
Sue Ann	None
Suffix	None
Suffix support	None
Suffix visuals	None
Sugarcraft	None
Suibheallan	None
Sumo	None
Sunday Breakfast	None
Sundro  TheFamily  CH	None
Super Flu	house music
SuperFlu	None
Supermafia	None
Supermafia Vjs	None
Supermario	None
Superpoze	disco
Suport PBell	None
Support	None
Support DJ Tray	None
Support Maurice de la Falaise	None
Support Tchicky Monky	None
Surgeon	techno
Suspect One	None
Sutsche	None
Sven Kerkhoff	techno
Sven Ninneman	None
Sven The Freak	None
Sven Väth	techno
Svenskj	None
Swan H	None
Swit Honey	None
Swithoney	None
Sydney dry	None
Symoh Sares	None
Synapson	house music
Syndrome WPW	None
Synergee	None
Syntec	industrial music
Syracuse	disco
System  UK	None
SÃ¶ren Klanken	None
Sören Klanken	None
T Raumschmiere	hip hop
T Raumschmiere  WÄKS  HERR LIEBE  BADBEAT	None
T4L	None
TANZWIESE	None
TBA	techno
TBC for 2014	None
TBird	None
TECHNO UNDERGROUND	None
TECHNO WHYNOT	None
THE ALCHEMYST	None
THE FLYING MUSTARDS	None
THEK VOLZ	None
TICON	trance music
TICON Live	None
TIVE	house music
TM Juke	downtempo
TMOWOOD tv	None
TOASTY	bass music
TOBI DREIPOL	None
TOYBOYS	None
TR  dj	None
TRoy	pop
TRoy on the set	None
TSAK	None
TWO ME	None
TWilliams	uk garage
Tacteel	None
Tagedeep	None
Taiki Nulight	doujin
Takcom	None
Take Me Home	None
Tal Stef	None
Talentfrei Bern	None
Talentfrei Label	None
Talentfrei Official	None
Talentfrei Records	None
Tali Freaks  UK	None
Talin	None
Tambien	house music
Tania Vulcano	house music
Tanua	techno
Tanz  Tanz	techno
TanzTanz	techno
Tanzamt	None
TanzbÃ¤r	None
TanzbÃ¤ren	None
Tanzbär	None
Tanzbären	None
Tanzmuster	None
Tanzstunde	None
Tapirus	None
Tarco	None
Tarik	rap
Taucher	bubble trance
Tba	techno
Techno  Why Not	None
Techno Floor	None
Teebs	bass music
Teenage Mutants	house music
Teki Latex & DJ Orgasmic	uk garage
Teki Tekua	None
Telepathie & Pendler	None
Telepathie & pendler	None
Telepathie&Pendler	None
Temiri	None
Tempa  UK	None
Teo Fionom	None
Terra Nova	rock
Terranova	downtempo
Terrazza Floor	None
Terry	ambient
Terry Hunter	house music
Terry Pardini	None
Terzini Bros	None
Tesdorpf	None
Tetsuya Ura	None
Tevo Howard	house music
Texas	country
Tff	None
Tha Trickaz	trap
Thallulah	None
ThanatosSore	None
The Alchemist	hip hop
The Animen	None
The Bamboos	downtempo
The Bassment	None
The Bassment  PleasureLAB	None
The Chosen Two	house music
The Chronics	None
The Club	None
The Coup	hip hop
The Cruzaders	rock
The Cube Guys	disco
The DJ	trap
The DJ Milieu Mauri	None
The Deadline	None
The Dj Marathon	None
The Doors Revival	None
The Drifter	hip hop
The Essentials	None
The Greg Foat Group	indie jazz
The Groovebrothers	None
The Hacker	electronic rock
The Hall Floor  House & Future House	None
The Haxan Cloak	drone
The Hole	None
The Housecreamers	house music
The Japanese Popstars	disco
The Jezabels	australian
The Kid Fonque show	None
The Kooks	pop
The Legendary Lightness	None
The M & B Experiment	None
The M&B Experiment	None
The Mind Opener	None
The Mole	techno
The MorningSounds	None
The National Fanfare of Kadebostany	None
The Ripper	None
The Robot Scientists	disco
The Soul Combo	None
The Sprawl aka Mumdance x Shapednoise x Logos	None
The Stepkids	None
The Sweet Life Society	electro music
The Toxic Avenger	house music
The Toyboys	None
The Two	None
The Wild Cowboys	disco
The Zimbabwebird	None
Theo Parrish	house music
Theo Pas Riche	None
Thesis Social	None
Third2Second	None
Thom Nagy	None
Thomas AS	None
Thomas Herb	techno
Thomas Muller	disco
Thomas Schumacher	techno
Thomas T	rap
Thomas Zopf	None
Thorsten Hammer	techno
Thris Tian	hip hop
Throne	None
Tiano Thomas&Pavel Prince	None
Ticket Prevendita 35Chf  30 Euro	None
Ticket price at the door 40Chf 35Eu	None
TictactoeCRO	None
Tief Records	None
TiefenRausch	euroska
TiefenRausch  MinimalFraktion	None
Tiefgeist	None
Tiefschwarz	techno
Tiefschwarz Souvenir  Basti	None
Tiesto	house music
Tiga Lily	None
Till Tape	None
TillTape	None
TillTape b2b Gray Chalk aka Colliding Fields	None
Tillup	None
Tim Exile	hardcore
Tim Green	disco
Tim Grothe	techno
Tim Knopf	None
Time Tarracho	None
Timid Boy	house music
Timmy K	None
Timnah Sommerfeldt	None
Timnah Sommerfeldt & Cephei	rap
Timo Maas  Rocket & Ponies  Coccon	None
Timoteo	brega
Tin Man	techno
Tissu	None
Titbit	None
Titonton Duvante	techno
Tiësto	house music
Toast Terry	None
Toasty	bass music
Tobas	None
Tobey Lee	None
Tobi More	None
Tobi Neumann  cocoonnet  Berlin	None
Tobias Thomas	disco
Tocadisco	house music
Todd Bodine	disco
Todd Terje	electronic rock
Toffee	substep
Toilet Acoustic	None
Tokoloten	None
Tokyo JP	None
Tolga Kéz	None
Tom Alemanno	house music
Tom Alemanno b2b Divalvi	None
Tom Brunner	None
Tom Clark	techno
Tom Mandolini	None
Tom Novy	disco
Tom The Godfather Brunner	None
Tom Vibe	None
Tom Wineman	None
Tomcraft	techno
Tommy Four Seven	dub
Tomy Gips	None
TonTon	None
Tonbohrer	None
Tonfa	None
Tonfa & Dan B	None
Toni May	None
Toni Tanzbei	None
Tonic	rock
Tonstau	None
Tonton	None
Tonwerk feat Bagheera	None
Tony White	blues
Too Late Productions	None
Tool & DieRecords	None
Torentus	None
Torn Hawk	house music
Torsten Kanzler	schranz
Torsten Kern & RAR	None
Tortured Soul	house music
Totally Enormous Extinct Dinosaurs	electronic rock
ToxinOhm	None
ToxinOhm BE	None
ToyO	rock
Traffic Jammers	None
Trakt 10 E Floor IV	None
Trakt 9a	None
Trakt 9a Floor III	None
Trakt9a	None
Trance	None
Trapez	None
Traumer	None
Trauminic	None
Traumtief	None
Treibstoff	None
Tremendo	house music
Trentemoller	electronic rock
Trentemøller	electronic rock
Tresor	None
Trevor Jackson	slow game
Trik	rap
Trinidad	rap
Trio Heinz Herbert	None
Tripitaka	None
Tristan Bohn	None
Tropical Continent Soundsystem	None
Tropical Continent SoundsystemZH	None
Troste	None
Troy Pierce	techno
Troy Pierce  Minus  Detroit USA	None
True	None
Truedat & AlÃ¦	None
Truedat & Alæ	None
Truncate	techno
Trunkline	techno
Truss	dub
Truth Is Light	None
Tryphon	None
Tschernobyllies	None
Tsuba  Cannes	None
Tuccillo	techno
Tunay Can	None
Tuncay Celik	rap
Tuned	None
TurKo	hip hop
Turistica	None
Turntablerockers	None
Twerking Class Heroes	None
Twinsmatic	rap
Tzinah Records	None
UBIK Sound System	None
UG BÃ¼lach ZH	None
UG Bülach ZH	None
UK	zapstep
UKIce	None
UMUT	None
UNDFND	None
UP HIGH COLLECTIVE	None
URBAN FLOOR	None
URSL	None
USA	None
UVB	dub
Ueno Masaaki	None
Ugly Kids	None
Ulli & Maesoo	None
Umami	house music
Umbe Nalle	None
Umberto Nalle	None
Umek	techno
Umut Yasin	None
Unbe Nalle	None
Unborn  FR	None
Undercatt  Diynamic Music	None
Underground Chronicles	None
Underground Connexion	None
Underground Resistance	techno
Underground Stage	None
Unfoundsound	None
Universal Dog	None
Uno  Dos	rap
UponYou	None
Urbanbassic	None
Urbantribe	None
Urla Ender	None
Us and Sparkles	None
Uschi & Hans	None
Uto Karem	techno
Uzi & Ari	slc indie
VACINTOSH	None
VD	None
VETO	danish
VISUAL	None
VISUAL ARTS	None
VISUALS by	None
VIVEK & Dego Ranking	dub
VJ Akinetik et Azadeeh	None
VJ Akinetik et Azadeeh Martin	None
VJ Bildspur	None
VJ Gremi	None
VJ LeinaD	None
VJ Sebastien Faivre	None
VJ Stereolux Auto Pilot	None
VJ Viggo	None
VJing by Projektor Kollektiv	None
VJs	None
VLT Mannequine	None
VOMIR	noise
Vacca Ft G Nano	None
Vaghe Stelle	electronica
Vakant	None
Valentino	rap
Valentino Mora	None
Valerio Raponi	house music
Valgeir SigurÃ°sson  Paul Corley  Nadia Sirota  Liam Byrne	None
Valgeir Sigurðsson  Paul Corley  Nadia Sirota  Liam Byrne	None
Valo	None
Van Bullet	None
Vanessa Sukowski	None
Vanilla Ace	hip hop
Vanita	disco
Vario Volinksi	None
Vario Volinski	house music
Varoslav	techno
Vatsgoed	None
Vaudou Game	afrobeat
Vegetative Wachstumsphase	None
Veli	trap
Velvet Two Stripes	None
Venom	house music
Venus	None
Vera	deep australian indie
Veronika D	None
Versace Privè Locic	None
Verveine	None
Vibronics	dub
Vico Dinami	None
Victor L	None
Victoria Engel	disco
Viking Music	None
Viktor Marek	None
Villa Bosso	hip hop
Vince	christmas
Vince & DJ Mile	disco
Vince Vella	None
Vincent Lemieux	None
VincentIulian	None
Vinyl Club	None
Violett	techno
Visual  Vj Mus	None
Visual Arts	None
Visual Sensation By Van Nutt	None
Visual by Nan Absurda	None
Visuals	None
Visuals TimowoodTV uvm	None
Visuals by  MN	None
Visuals by  Veni vidi vj	None
Visuals by Gertrude Tuning & Pamela popo	None
Visuals by LOON	None
Visuals by Litemotif Crew	None
Visuals by Palnoise	None
Visuals by Sophie Le Meillour	None
Visuals by VJ Bad Chance	None
Visuals by VJ Luna	None
Visuals by VJ Team Die Optikker	None
Visuals von Kollektiv Packungsbeilage	None
Visuel by	None
Visuel par VJ Badbeat	None
Visuels par FRANZ KARL	None
Visuels par sophie le meillour	None
Vitronic & Yvan Genkins	None
Viva Music	None
Vkee	None
Vlad	None
Vladimir Corbin	house music
Vlnolam Kawumski	None
Volkan Ocak	None
Volta	neo-psychedelic
Voodoohop	None
Vouipe	None
Voyeur	house music
Vrank Pauer	None
Vulgaris	None
WAEV	None
WAKE & DJ BRUNO	rap
WARM UP	None
WESTD	techno
WILDLIFE	electroacoustic music
WILL	rap
WILLI P	None
WT Records	None
WTBRK SOUND SYSTEM  Live	None
WTF	None
WURZELFLOOR	None
Waev	None
Waldherr	None
Walk Off the Earth	viral pop
Walls	None
Walt & Allen Rich	None
Walter Albini	None
Walter Wolf	None
Wandervogel	None
Wandler	techno
Wankelmut	house music
Wasabidelux	None
Wasabideluxe	None
Washerman	disco
Watergate Records	None
Watermät	house music
Wax de Molf	None
We Dig Underground  Mad Rey	None
We Invented Paris	rock
We Love Machines	rock
We stand for	None
Wed Techno  CH	None
Weekend Phantom	None
Weith	None
Werft	None
Whim	techno
White Perception	None
White Wall LIVE	None
Whitehouse	None
Whos next	None
Why Be	korean pop
Wicked Wilma	None
Wild & Surf	None
Wild Belle	electronic rock
Wild Surf	None
Will Sergeant	None
William Britelle & Basel Sinfonietta	None
William Medagli	disco
William Selmo	None
Willie Graff	None
Willow	pop
Wirrwarr	rock
Wla Garcia	techno
Wolf Eyes	experimental
WolfLamb	hip hop
Wolfgang Voigt presents Rückverzauberung	None
Worakls	deep
Wunschkinder	None
Wuzz TazZ Boys	None
Wuzz Täzz Boys	None
WuzzTazzClan	None
WuzzTäzZ Boys	None
XCess & Spitfire	None
XLR8R	None
XTAJ	None
XV KILIST & Rocco	None
Xander Valley	None
Xavier QuÃ©rel	None
Xavier Quérel	None
Xetal	None
Xhin	dub
Xose	None
YAYA DEEJAY	None
YM	vocaloid
YONI BANKS & YAN KA	None
YOSKO	None
Yan Jun	rock
YanKa	None
Yann Detroit	None
Yann Detroit fondateur du Label Intimist Records	None
Yann Kulovsky	None
Yann Ou	None
Yannick Müller	None
Yannik Cserhati	None
Yapacc	techno
Yarah Bravo	None
Yass	japanese city pop
Yasunao Tone	lowercase
YokoO	house music
Yoni Banks	None
Yosko	None
Yosko & Volta	None
Yougene	None
Youn Caro	techno
Young Marco	house music
Yuen Chee Wai	None
Yuksek	house music
Yvan Genkins	techno
Yàn	None
ZANO P	None
ZH	None
ZITTO & SPLENDINI	None
ZaJazza	None
Zajazza feat Illspokin	None
ZanoP	None
Zayonne	None
Zebopunkt	None
Zebra Katz	indie r&b
Zed Bias	uk garage
Zenker Brothers	None
Zeno	christian relaxative
Zepherin Saint	house music
Zero	downtempo
Zero b2b Razha	None
Zh	None
Zodiak	None
Zombidou	None
Zomboy	uk garage
Zoo	None
Zozo	techno
Zrk	techno
Zukunft	None
Zurich	None
Zwei mit Stil	None
Zweikommasieben	None
Zähler & Nenner	None
Zähler &Nenner	None
Zøla	vapor
Zürich	None
adlib	house music
aerophobica	None
all Night long	None
analsticks	None
and Movel Traxx Hes received press coverage from DJ Mag	None
and New York Citys Turrbotax and Momas PS1 events	None
and cosongwriter for Led Zeppelin	None
and ghetto tech together with a knack for creating sparse	None
and many more	None
and many more Danny soon realized that his future lay inmusic	None
and more	deep freestyle
and others	None
and summer activities on the website	None
and tba	None
andri	deep
andri live	None
anima	vapor soul
arco  dj amnesy	None
are you electrified	None
areage	disco
aron	acoustic pop
arā	pop
as well as Rip It Up Additionally	None
as well as had featured remixes on BBE	None
audiomiditweaker	None
audiotheque	disco
avant denchainer sur lelectro	None
b2b CARLO L	None
bagghera	None
be	rock
benne	german
blacout	None
blad & beard	None
boogie et soulfoodmusic Un large spectre que les 4 jeunes artistes abordent avec passion	None
bprodukt	None
broken beat	None
buraq aka LEKE DA LOKO	None
buraq aka Leke da Loco	None
but always focused firmly on the dancefloors needs anddesires	None
bwhat	None
cadenzaBerlin	None
chat & felix	None
checkon	None
chrysalide live	None
cityfox	None
cityfox zürich	None
cmc & silenta	funky breaks
created his own label	None
cut and paste diverse sounds Danny took to the decks at the age of 16 afterexperiencing sets by visiting European DJs Inspired by the likes of SatoshiTomiie	None
dAn from Bern	None
dans cette recherche du son juste qui simpose avec évidence Nétant pas à leur coup dessai et sétant produits dans la plupart des clubs à Genève	None
das Krause Duo	None
de la Deep House à la Techno Mais audelà des mots le meilleurs moyen de le découvrir est de venir lécouter	None
deep house	None
deep house  tech house	None
diSoul	techno
disco	emo
dj Khalab	None
dj Lynn Jordan	None
dj bod	None
dj jonny sender	None
dj rize	None
djMagda Polasnky	None
dotSTRIPE	house music
duble	rock
dzanin	None
eRikm & FM Einheit	None
eco	trance music
ecological and sustainable developpement	None
electrodudes	None
electronic  deep house  tech house	None
elias3O8	None
etc	indie
exotiques et pointus PassionnÃ© dÃ¨s lenfance par cette musique festive et motivante	None
exotiques et pointus Passionné dès lenfance par cette musique festive et motivante	None
feli & pedro	None
fish & bone	techno
floppy funk	None
formbar bern	None
from  130 to 330 Simone Fusco	None
from  2300 to 130 Dj Codex	None
from 330 to 500 Sandy C	None
from New York	None
funk	None
gabor	soul jazz
gallo	None
ghetto house	None
girl	mashup
great stuff münchen	None
greets Baur & Cherry	None
guest	electronic rock
gun club münchen	None
he beginsto record	None
hes headlined parties such as Londons Night Slugs	None
hidden trainer	None
hive & zukunft zurich	None
hosted by Thomas Brunner	None
httpssoundcloudcomdremusicgva	None
httpssoundcloudcomjeanclef	None
httpwwwmyspacecomdjleventino	None
idle	comic
ieva	None
il a beaucoup travaillÃ© pour arriver Ã  ce style dÃ©calÃ© qui lui correspond parfaitement Les musiques traditionnelles telles que la salsa	None
il a beaucoup travaillé pour arriver à ce style décalé qui lui correspond parfaitement Les musiques traditionnelles telles que la salsa	None
il produit sur divers labels internationaux	None
incite liveAV	None
joey	rap
juke	None
keyboardist	None
krystyna	classic polish pop
la deep	None
la luciole	None
la samba et	None
la tekhouse Fondateur en 2010 du crew BOOM FACTORY	None
last time Rohstofflager after a Street Parade	None
le horla	None
les sonoritÃ©s tribales sont Ã  la base de ses	None
les sonorités tribales sont à la base de ses	None
liebe detail	None
liebedetail	None
lights by Ariel	None
limbus revolution	None
line up Interlop	None
line up KQC	None
live	christian christmas
live Buvette	None
live FELL	None
live Isolated Lines	None
live ZACHOV	None
live art & VJ Projection	None
live pitapat	None
locuteur de radio	None
léo b2b yosko	None
m50	None
ma	trap
magdesign	None
manolo & shoko	None
many more	None
marco k f	None
mathis	vocal jazz
mauy	None
mentalgroove	None
mickey monza	None
mimetic	industrial music
mimetic & Sigmasix	rap
minitek	None
mnusF	None
mobilee	None
mobilee records	None
monsieur juste	None
more	alternative metal
more TBA	None
more TBA soon	None
more soon	None
more tba	None
morris audio	None
motionlabch	None
mtpCH	None
murphy	rap
music and related art forms	None
musik krause	None
mynightlifefm	None
nemoy	None
nervmusic	None
newcom	None
nika	spanish pop
noch nicht bestätigt Les Yeux sans Visage	None
nopi aka Alberto Pino	None
nthng	None
nudevinyl vinyl	None
nuit 1	None
nuit 2	None
olan	drone
omar	reggaeton
pasci	None
peacefrog	None
pendler	None
place du Tunnel 12	None
pmo shock	None
precision and most of all	None
prog house	None
quality and safety	None
qui vagabondent entre microhouse	None
quincy jointz	funky breaks
raa	sinhala
racker	None
raoul	None
reverse	emo
revolvercanada	None
ruben estevez	None
sCs	None
sCs  Genève	None
sammy senior	None
sascha cigrovski	None
sco	None
sebasoverde	techno
seranthony	None
shsha	techno
snappy tracks that manage to convey a physicality and funk with spectacular precision	None
son sons minimal deep techno dub hypnotic	None
soon	progressive psytrance
soul	hip hop
soul Hailing fromMadrid	None
sovaBerlin	None
spiderb  djane emily heaven	None
stil vor talent	None
stplomb	None
strictly on vinyl	None
support Spank Rock	None
swit honeyCH	None
sydney	None
t	hip hop
t Danny Serrano	None
tINI	hip hop
tant est grand le soin quils apportent à leurs sélections	None
tat1	None
tat2	None
tbc	None
techno	None
techno machine	None
terry pardini  happy  solothurn	None
tictactoe	None
tolerance and networking in the culture scene	None
tolga köz	None
tom tek	None
tomkay42	None
tsacK	rap
tt	bmore
tuningspork & leena	None
undef	None
violinist Elsa	None
visuels by Sophie Le Meillour	None
vocalist singer Monika Kiss	None
von Allmen	None
von Allmen b2b DGRZ	None
w Plusculaar & Primr aka Temiri	None
w Temiri	None
wankäla	None
x Frango	None
x Girl	None
x Mastra	None
x Miles b2b Ab&Artig b2b Moezard	None
x Profondo	None
yAn	techno
yoni banks	None
zenon rec	None
zuckerstÃ¼ck	None
zuckerstück	None
zweikommasieben	None
zürich	None
Âme	None
évoluant dans la Techno	None
ΚΕΜΑΛ	None
