	None
&	pop
& more TBA	None
0100  End KombÃ© & Mafou	None
0100  End Kombé & Mafou	None
0130  0330 Agonis	None
0330  End Jeff Mills	None
2 FLOORS	None
2300  0130 Jamie Shar	None
2TAKT	None
2nd Floor	None
3 LIVE Bands	None
3024WASHINGTON	None
35plis	None
808 State	house music
A	trap
A LiveDJJam reinterpreting some of Dumb Units best pieces from the last 10 years	None
A Made Up Sound aka 2562	None
A&F	None
ADRIANO live bern	None
AFTER 5PM  OPEN END	None
AFTER HOUR bis 1200	None
AKA AKA	hip hop
AKN & DITEK	None
ALAIN ROY & Dirty Larry	None
ALAN LECTOR	None
ALEXI	indie
ALLP ch wallis	None
ANDRI LIVE	None
ANDRI Live  Cityfox  Highgrade ZÃ¼rich	None
ANDRI Live  Cityfox  Highgrade Zürich	None
ANNA ULLRICH	None
ASSH	None
ASVF b2b Bodom	None
AT	pop punk
ATOMITA	None
AUSTRIA	None
Aaron Khaleian	None
Abdel Hady	disco
Abel	indie
Abnormal Boyz	None
Absolutive	None
Abstrhytmik	None
Adam Beyer	techno
Adana Twins	deep
Adrian Martin	disco
Adrian Martin b2b Albi	None
Adriano	disco
Adriano Mirabile	disco
Adriatique	techno
Adva & Purpurea	None
Affani	disco
After Grauer	None
After Grauer & Phil ZViel	None
Agaric	techno
Agonis	None
Ajele	None
Al Tourettes	techno
Alain Szerdahelyi	None
Albee	None
Albi	None
Alci	salsa
Alec Trusk	disco
Alek X	techno
Ales	None
Alex Celler	techno
Alex Dallas	None
Alex Flatner	techno
Alex Kostik Teknologik Rec	None
Alex Neri	chill lounge
Alex T Rauch	None
Alexandre Navarro	abstract
Alladin K	None
Alphatronic live	None
Amaro	reggaeton
Ambivalent	techno
Amelie	disco
Amiant	None
Amine Edge & DANCE	house music
AmsterdamNL	None
An den Decks	None
AnGy KoRe	techno
Anatol  cosili  P45  zurich  CH	None
And Hazel	None
AndHazel	None
Andaloop	disco
Andhim	house music
Andre	techno
Andre Jimenez	None
Andrea Oliva	house music
Andreas Ramos	disco
Andri	house music
Android muziq	None
AndrÃ©s Marcos	None
André Lodemann	techno
Andrés Marcos	None
Andy Catana	house music
Andy Dee	hardcore
Andy Katz	None
Andy Purden	None
Anek	house music
Angelica Fravi	None
Angemi	deep big room
Angy Dee	None
Animal Trainer	house music
Anja Schneider  mobilee  berlin  D	None
Anthik	house music
Anthony Naples	house music
Apollonia	None
Archie Hamilton	techno
Ariol & Pawlikowski	None
Arnika	None
Aromamusic	None
Art & Weise	None
Asic	None
Association Specimen EventBookingLabel	None
Aston Martinez	None
Atomita	None
Audino	None
Audiofly	house music
Audiologism	None
Audion	techno
Audionatica  Gon Records zh	None
Audionatica Gon Records	None
Audiovisual techno set	None
Aula magna	None
Autonome Essenz	None
Ayhasca Ernesto	None
Azabeats	hip hop
BANOPROD	None
BAROZ  elektrostubete	None
BBC Radio1	None
BE	rock
BE  Finefood Records	None
BE  Legend Club  Ohm10  djanthonyvegacom 1030  1200 Play Time	None
BE  Ohm10  Tunnelenergych	None
BOMB DISPOSAL SQUAD RITCHIE PITCH	None
BOOGIE JACK & NAT	None
BORN  BassOnRepeatNetwork	None
BPitch  UK	None
BROUQADE	None
BS	None
BUQS	None
Baalsaal	None
Bach	classical
Back2Back Mr Jonk and DJ Schield	None
Backspin Boys	None
Bakermat	house music
Balance Alliance	None
Bambounou	bass music
Bang Goes	None
Bar25	None
Barcelona	dreamo
Bardo	rock
Barem	techno
Bari	trap
Barker & Baumecker	house music
Bas Ibellini	None
Basel	consort
BassbÃ¼ro	None
Bassbüro	None
Bassforscher	None
Bassjackers	house music
Bassport	None
Baumeister	None
Beda	disco
Beda  DekaDance	None
Belair	None
Bella Sarris	None
BellaBerlin	None
Ben Kaczor	rap
Ben Parris  foundsound  baltimore  USA	None
Ben Parris  more TBA	None
Ben UFO	uk garage
Ben Yoo Suk	None
Benja	None
Benjamin	alternative
Benjamin Damage	house music
Benno Blome	house music
Benotmane	house music
Berlin	house music
BerlinJapan	None
Bern	None
Bernardo Zitto & Roberto Splendini	None
Betoko	house music
Bfly Steiner	techno
Bfly Steiner and friends	None
BigenericMarco Repetto	None
Bio & Larkian & Les Poissons Autistes	None
Bird	indie
Bird  sirion  Bern	None
Bishop & Goldberg	None
BitTuner	None
BitTuner live	None
Bjoerng	None
Black Coffee	house music
Black Cracker  spoken words	None
BlackCat	None
Blaqq & Whyd	None
Bleepsequence	None
Bloody Mary	techno
Bogota	rock
Bohnenblust	None
Bonny & Clyde	None
Booka Shade	house music
Borderline	antiviral pop
Boris Werner	techno
BoyAn	house music
BoyAn  Fery  Diese Jungs brillieren	None
BoyoomConnective	None
Bradd  cafe mambo	None
Brainstorm  ohm 10n tunnelenergych	None
Brian Burger	techno
Brian Sanhaji	hip hop
Britta Arnold	house music
BrokenEnglishManchester	None
Bruderherz	None
Bryan Black aka Black Asteroid	None
Budenzauber	None
Bugsy	techno
Bunga Bunga	indonesian pop
Bunny Over Money	None
Butane  alphahouse  st louis  USA	None
Butch	neo mellow
C Forza	None
CARI	None
CEZAR	techno
CH	None
CHRIS LOUD	None
CHRISTOPHER S	None
CITYCAT	None
CITYFOX	None
CLAUDIO MAURMO	None
CLIFF	reggae
CRIS ALLEGRO	None
CYLS	None
CYRIL LEGER	None
Cadenza LausanneBerlin	None
Calado	None
Camea	house music
Canson	house music
Canson  handheld  zurich  CH	None
Cantina Brothers	None
Carl Cox	house music
Carlos Russo	house music
Carola Pisaturo	None
Caru Brown	None
Central Rodeo	disco
CepheÃ¬	None
Cepheì	None
Cessman	uk garage
Channel X	house music
Charles Bohmann	None
Charlie Gold	None
Chaton  plak records  geneva  CH	None
Cheeky Choice ZÃ¼rich	None
Cheeky Choice Zürich	None
Cheers	shimmer pop
Chez Damier	house music
Chicago	hip hop
Chicco Green	None
Chien Andalou	None
Chinny	None
Chris Carrier	techno
Chris De Rebel	None
Chris Dubflow	ambient
Chris Liebing	techno
Chris Loud	None
Chris Rockwell	techno
Chris SchwarzwÃ¤lder	None
Chris Schwarzwälder	None
Chris Tietjen	disco
Chris Tietjen GER  cocoonnet  Frankfurt	None
Christian Burkhardt	techno
Christian Burkhardt live	None
Christian&Raphaël	rap
Cio	None
Circle	rap
Circumflux	None
Cityfox	None
Cityfox  ZÃ¼rich	None
Cityfox  Zürich	None
Clats	None
Claudio Carrera	None
ClekClekBoom	None
Clem	ambient
Click  Click	pop
Click Box	techno
Clink	None
Clique of Two	None
Clv	None
Cobeia	disco
Cocoon	chanson
CocoonZürich	None
Colours Audio	None
Como Damar	None
Corin	None
Correspondant	None
Cosili & Gabriel Roth	None
Craig Richards  Fabric London	None
Cristian Tamborrini	house music
Cristian Varel	None
Crossworld Records	None
Crowdpleaser	techno
Crux	oi
Cubex	house music
Cutkachi	uk garage
CÃ©cile	None
Cécile	None
D	rock
D Cosmo	None
D Lewis	techno
DARREN LAWS	None
DAVE WALKER	None
DAVID MORENO	None
DE	norteno
DEJAN	None
DEJAN  Cityfox ZÃ¼rich	None
DEJAN  Cityfox Zürich	None
DEJAN cityfox zürich	None
DELAYED PROJECT	None
DINKY	techno
DIRTY FLAV	None
DISCO DAVE jackpoint zürich	None
DIncise	abstract
DJ	trap
DJ BOOBY	None
DJ Devcon	None
DJ Dub	dub
DJ EPI	None
DJ Fab	techno
DJ Fuse	hip hop
DJ Headstorm	None
DJ Hell	electronic rock
DJ Hirpus	None
DJ Jay Sanders	None
DJ JooLs	None
DJ Junior	None
DJ Kev the Head	None
DJ Koze  kompakt  germany	None
DJ Larson	None
DJ Le Baron	rap
DJ Le Roi	hip hop
DJ Little Miss	None
DJ Marky & XRS	drum and bass
DJ Ombres	None
DJ PAD	None
DJ Phil	None
DJ QOOL MARV	None
DJ SAM	None
DJ Sassy J	None
DJ Tiago CORTEZ   DJ FURITEC AKA PASCAL PROSPER	None
DJ Tony Big	None
DJ Yoda	downtempo
DJ Zimmbi	None
DJLINEUP	None
DJs	new jack swing
DJs Chic Brown	None
DLM	rock
DOG	indie
DVS1	techno
DVW & Marc Feldmann	rap
DVW & Marc Feldmann  Trinidad	rap
Dada Life	house music
Daegon	None
Damián Schwartz	None
Dan Ghenacia	techno
Dandy Jack	techno
Dani Castillo algo Mas Duro Barcelone	None
Dani Nydegger	None
Daniel Dreier	techno
Daniel Steinberg	deep
Danielson & Norbertto	None
Danielson & norbertto	None
Danielson vs norbertto	None
Danny Coleman	None
Danny Faber	techno
Dantze	None
Daparec	techno
Dapayk	techno
Dario DAttis	rap
Dario Zenker	techno
Darkening	None
Darrien	hardcore
Das Balz	None
Das Pferd	None
Das Schiff	None
Das Volca Massaker Orchester	None
Dauwalder  NEAT	None
Dave Gin Tonic	None
David Armada	disco
David August	house music
David Carbone	None
David Delgado	hip hop
David Durango	techno
David Eye	house music
David JimÃ©nez	None
David Jiménez	None
David Styloso	None
David Torr	disco
Davide Squillace	techno
De La Maso	disco
De La Porter	None
De La Porter Skorpionkinder Rec  Cube Resident	None
De La Porter Skorpionkinder RecCube Resident	None
De La Porter Skorpionkinder Records  Cube Resident  Electroradio	None
De La PorterRoom RecSK RecCube Resident	None
Dead Poets	None
Deadly Avenger	breakbeat
DeeVerso	None
Deecoy	None
Deenee Muetr	None
Deep House	None
Deep n Dub	None
Deepwave	None
Deetron	techno
Deetron & Petar Dundov	techno
Definition	screamo
Dejan	None
DekmantelAmsterdam	None
Delsin	None
Demetrio Giannice	house music
Der Effekt	None
Der Held	None
Der Schuft	None
Der Schuft aka Luca de Grandis	None
Der hut	None
Derick May	None
Derrick May	techno
Detroit	None
Die Antwoord	rock
Die Grimen	None
Die Grimen & Maty Palc	None
Dieses Mal besucht uns ein Freund aus Berlin  Marco Effe Seine ImpressParty in Berlin spricht für sich Jeweils Mittwochs beschallt er zusammen mit diversen Künstlern aus verschiedenen Genres den weltweit bekannten Watergate Club	None
Different Drummer	None
Difracctive	None
Digitaline	techno
Digitaline  cadenza  lausanne  CH	None
Digitalis	dub
Dimitri	house music
Dino Amas	None
Dino Pergola & Gusto	None
Dirty Channels	disco
Dirty Doering	deep
Dirty Flav	None
Disco	pop punk
Disco & Tanzstube	None
Disco Channel	None
Disco HalalBerlin	None
Disco mit Mute DrumnBass	None
Disco mit Stil vor Talent	None
DiscoD	None
Diskomurder	None
District2	None
Divided	None
Divinity	None
Dixon	soundtrack
Dj Alastair Electroradio  Cube	None
Dj Anthony Vega	None
Dj Flo	None
Dj Guz	techno
Dj Magicstorm	None
Dj Mia Kaltes	None
Dj Michael T Fresh	None
Dj Never Die	techno
Dj Never Die & NICOB	rap
Dj Noise	None
Dj Phil	None
Dj Puma	None
Dj Robr	None
Dj Skaos	None
Dj Tony Big	None
Djebali	techno
Djeniz  WaldgeflÃ¼ster	None
Djeniz  Waldgeflüster	None
Djs Bob Rock	None
Doeasy Rec	None
Dominik Auderset Schallrausch	None
Dominik Burkhalter  drums	None
Dominik Eulberg	techno
Dominik Eulberg  Cocoon	None
Dominik Trieb  Suberplastic ag	None
Don Dario	house music
Don Ramon	argentine reggae
Don Ramon  Friedas BÃ¼xe	None
Don Ramon  Friedas Büxe	None
Don Tetris	None
Don Tetris  subsTANZ be	None
Doomwork	techno
Dottore Monkey Jam  Cube	None
Doublescore	None
DoubtingThomas	disco
DrPsyche	None
Dragosh	techno
Drea	None
Dreiklang	None
Dreksler & Haerle	None
Dreksler&Haerle	None
Dreksler&Haerle live  elektrostubete be	None
Drilon	opm
Drumcode	None
Dub Tales  Off Mind rec be	None
DubNoir	None
Dubfire	techno
Dubokaj	None
Dubspeeka	None
Dubvadsion	None
Duskid	None
Dust 21	None
Dustin Zahn	techno
Dynamics	None
Dzann	None
DÃ¼rerstuben	house music
Dürerstuben	house music
E	pop
EMERSON	classical
Eazy M	house music
Echo 106	house music
Ed Luis	None
Ed Luis vs Albi	None
Edward	indie
Edward Ean	techno
Ein wachsendes Netzwerk in Sachen Künstler elektronischer Musik Qualität vor Quantität  ein Produkt	None
Einzelkind	techno
Einzig & Faerber	rap
Ekkohaus	techno
El Alusinante	None
El Grego	None
El Rey	None
Electrofraise	None
Electromcfly	disco
Electroradio Crew Alastair & Houserockers	None
Elektroschneider	None
Eli Verveine	techno
Eli Verveine  scandal   switzerland	None
Elliot Eastwick	None
Elvis Cassetta	house music
Emanuel Satie	house music
Emanuele Errante	nu age
Emanuele Inglese	None
Emanuele de Raymondi	None
Emely& Scum	None
Emendy	rap
Eminor	None
Emix	techno
Emmanuel K	None
England	rock
Enterbt	None
Enzo Lo Conte	None
Enzo Siragusa	techno
Equinox	slavic metal
Erase	rock
Erhalder	None
Eric Borgo	techno
EricP	None
Erol Alkan	hip hop
Escargot with	None
Eskimo Live	None
Eurokai	None
Even Tuell	None
Everest on TT	None
Evolent	hip hop
Extrawelt	house music
Ezikiel	techno
Ezikiel  DekaDance	None
Ezikiel  Unite ZÃ¼rich	None
Ezikiel  Unite Zürich	None
F	classical
FABRI	None
FABRI MUSIQ	None
FABRIZIO DI SANDRO	None
FABRi	None
FD	deep liquid bass
FERY	None
FLEXIBELLE bern	None
FR	None
FRANK SICCARDI	None
FREAKBOUTIQUE	None
FREAKY FUNKY BEER DOZE	None
FRED 34m2 lausanne	None
FREIBERG elektrostubete bern	None
FRENCH FRIES	house music
Fabio Alampit	None
Fabio Dante	None
Fabio Florido	techno
Fabr	None
Fabri	None
Face Design	None
Fact	None
Falda	None
Falling in Love EP	None
False Friends	None
Fat Sushi	techno
Faul	house music
Feldermelder	None
Felipe Valenzuela	techno
Felix KrÃ¶cher	schranz
Felix Kröcher	schranz
Felix Kröcher Abstract	None
Felxibelle	None
Feodor	deep opera
Fernando Lagreca	dub
Fictionizer	None
Filewile	rock
Fingathing	nu jazz
Finnebassen	house music
Fis	fluxwork
Fitzgerald & Rimini	None
Five Club	rock
Flappers	None
Flash	hip hop
Flavio	channel pop
Flexibelle	None
FlicFlac	house music
Floor 1  Intec Digital	None
Floor 2  Intec Digital	None
Floor 3  clrnet	None
Floppy Funk	None
Fortyone Rec	None
Francesco Ballato	None
Francesco Parla	None
Francis Mallo	None
Frango	hip hop
Frango sirion bern	None
Frank Vespari	None
Frankfurt	None
Franky Fourfingers	None
Fred Licci	None
Freiberg	None
Freiburg	classical
Freitag 06042012	None
Friedas Neffe	None
Fritz Kalkbrenner	house music
Fritz Zander	techno
Frohlocker	funky breaks
Frontlin	None
Fumiya Tanaka	techno
Fuse  Ohm 10	None
FussgÃ¤nger 9	None
Fussgänger 9	None
GForce aka Markus haZe	None
GIUSEPPE CRUZ	None
GL Everest	None
GOGO	jazz
GOGO MUSIQ	None
GRAND PIANORAMAX FT Black Cracker	None
Gain Tom	None
Galoppierende Zuversicht	None
Garance	techno
Garibovic	disco
Garibovic BE  DefinitionMusic  Draft	None
GarÃ§on	None
Garçon	None
Gebrüder Ritalin	None
Germany	indie dream pop
Geronimo  Flinke Finger	None
Get Physical	None
GhostlyUS	None
Giacomo Lombardo	None
Gianni Callipari	disco
Giardino Unplugged with	None
Gimmick Rec	None
Gin Tonic Soundsystem	None
Giom	house music
Girl	mashup
Giulia Paradiso	hardcore
Gleichschritt	None
Gleischschritt	None
Gogo	jazz
Golani Bros	None
Gomorra	techno
Grant Nelson	uk garage
Gravina	techno
Gravina & Omar	rap
Gravina & omar	rap
Green Velvet	house music
Greg Beato	house music
Gregor Tresher	techno
Grndloop Agency	None
Guts Pie Earshot	None
Guyus	uk garage
Guze	None
Guzy	None
Gynesh Bakir	None
HANZ BEATER tanz	None
HEIDI	country
HENRY Riton SMITHSON	None
HERMANSSON & MARTINEZ	None
HOBO	None
HOSH	house music
HOSH  Diynamic Rec	None
HVOB	house music
Haiir	None
Hamburg	None
Haneef Raisani	None
Hansim GlÃ¼ck	None
Hansim Glück	None
Hashman Deejay	None
Hatti Vatti	uk garage
Heartthrob  mnus  paris  F	None
Hector	cumbia
Heiko	coverchill
Heiko MSO	house music
Helder	house music
Helios & Hess	None
Henry Clausen	None
Henry Pass	None
Henry Sure  Friedas BÃ¼xe ZÃ¼rich	None
Henry Sure  Friedas Büxe Zürich	None
Hermanez	techno
Herodot	disco
Herr MÃ¼ller	None
Herr Müller	None
HerzblutEdinburgh	None
Herzschwester	techno
Herzschwester & Thom Nagy	techno
HighLive	None
HighLive & Gravina	rap
Highgrade	jump up
Highgrade Afterparty	None
Hinterhof	None
Hinterhof Bar	None
Hito	techno
Honoree	techno
Horizontal  Chile	None
Hos & Pacoco	None
Hot Waves	None
House	None
House & Tech House	None
House Rockers Electroradio  Cube	None
Huazee	None
Huerco S	house music
Hug & Schiemann	None
Human Garden Records	None
Husky	deep australian indie
Hyrez	disco
I	hip hop
IDLE HANDSBRISTOL	None
IT	rap
ITALY	None
Ich & Du	None
Ill Dubio	None
Ingo Boss	disco
Ink	pop
Ink aka Nik	None
Installations and guided tours through the botanic garden by	None
Italien	None
Italy	None
Ivan Alvarez	None
JAMES MC HALLE tanzkarrusell bern	None
JAUSS  CRASH DELAY	None
JAVI MUNOZ	None
JD	rockabilly
JEAN BAPTISTE	renaissance
JEUDI Records	None
JOHN PLAYER 7b zürich	None
JP Chronic Ibiza	None
JUNKSOUND MOVEMENT	None
JWalk	None
Jack Jenson	None
Jack Norris	None
Jackathon  London	None
Jacqui  MiniShake Music  Sion	None
Jael	None
Jam Janiro	None
James Lavelle	hip hop
James Mc Hale	None
James Mc Hale b2b Mia	None
James Taylor	rock
Jamie Shar	techno
Jan Penarrubia	techno
Jan Penarrubia BE  Off Mind	None
Jaser Mushkolaj	None
Jauss	None
Jax	house music
Jaxon	None
Jay Joe	None
JayJo	None
Jazz T	hip hop
Jeem Collins	techno
Jeem Collins Feection	None
Jeff Mills	techno
Jehst	uk garage
Jen Morris	None
Jennifer Cardini	microhouse
Jeremy De Koste	house music
Jeremy P Caulfield pres UNIT  dumb unit	None
Jerry Joxx	None
Jessica Diaz	None
Jim Rivers	house music
Jimi Jules	rap
Joachim Pastor	house music
Joe Feretti	None
Joe T Vannelli STAR DJ	None
Joel Brites	None
Joel Mull	techno
Joel Ruck	None
John Clats	None
John Daly	None
John Deere	house music
John Dimas	disco
John Haden	None
John Power	None
Johnny Haway	None
Jon Donson	techno
Jon Donson burgdorf	None
Jon Rundell	techno
Jonn Melchiat	rap
Joop Junior	techno
Joram	disco
Jose De Divina	None
Josh Wink	techno
JosÃ¨ Parra	flamenco
Josè Parra	flamenco
Joèl Ruck	None
Jubairo	None
Juen	None
Julian Jeweil	techno
Juliano Lopez	rap
Julius Abel	house music
JuniorC	None
Junksound live	None
Justice Rivah feat Iyah Ranx	None
Justin Robertson	house music
Jutzi	None
Jutzi  subsTANZ be	None
Jutzi & Don Tetris	None
Juzz	disco
Jyx	None
KKToy	None
KRamba	None
KW32	None
Ka & Ge	None
Kadebostan & Laolu	rap
Kahuna	breakbeat
Kalabrese	microhouse
Kalabrese  stattmusik  switzerland	None
Kalabrese perlon zürich	None
Kamil Pawel	None
Kantarik	hip hop
Karan Shah	techno
Karl Gustav	None
Karl Tonschänder	None
Karotte	techno
Kassem Mosse	techno
Katermukke	None
KatermukkeBerlin	None
Kaylee	None
Keen	country
Keinemusik	None
Kellerkind	house music
Kellerkind  stil vor talent  bern	None
Ken Wan	house music
Kenny Ground	house music
Kenny Larkin	techno
Ketchup	None
Kev the Head	None
Khainz	progressive psytrance
Kim Prevedello	hip hop
Kittie	metal
Klang	disco
Klangkosmetiker	rock
Klangwelt  Geneve	None
Klaudia Gawlas Abstract	None
Klockwork	electronic rock
Kms	techno
KnÃ¤ckebrÃ¶d	None
Knäckebröd	None
Koko Chanel	None
Kolbe	None
Kollektiv Turmstrasse	techno
KompaktSão Paulo	None
Komplex Klub	None
Kong Rec	None
Konverter	None
Kopenhagen	None
Kornél Kovács	house music
Kortex	None
Kowton	house music
Krafty Kuts	breakbeat
Kruse & NÃ¼rnberg	None
Kruse & Nürnberg	None
Kultig	None
Kyrill & Redford	groove room
KÃ¥re Kyl	None
KÃ¶nig Balthasar	None
Kåre Kyl	None
König Balthasar	None
LA LUCIOLE	None
LABO M	None
LAD	disco
LAIN  techno merveilleuse	None
LCAW	house music
LIME	freestyle
LIVE	christian christmas
LOKD  Basel	None
LONE	pop
LOUH	None
LS & Massuro Takashi	None
LUCA BERTO	None
La Vitamina	None
Lain	None
Lampert	None
Laolu	techno
Laps and more	None
Lara Valentina	None
Laris Alexander	None
Larry	regional
Larzo & Sebus	None
Lauren Lo Sung	None
Lcp	None
Le BÃ©rger	None
Le Bérger	None
Le Roi	None
Le Slap	None
Lee	country
Lee Burridge	house music
Lee Curtis	rock
Lee Curtiss	techno
Lee Van Dowski	techno
Lefty	country
Lehar	romantic
Leo Tardin  piano	None
Leon	rock
Lesnicar	None
Levi	broadway
Lexer	house music
Lexx	disco
LiWell Project Ruum Records	None
Liebkind	None
Lil Gee	None
Lilith	spanish punk
Lionel Stephan D aka Little	None
Little Jacob	None
Little Lu	None
Little MIss	None
Little Miss	None
Liv Stone	disco
Live	worship
Live Elekfantz	None
Live Gui Boratto	None
Live Lcio	None
Live Nick Dow	None
Live Tape Five	None
Live Umami	None
Live Visuals by BildstÃ¶rung	None
Live Visuals by Bildstörung	None
Live Visuals by Blauton	None
Live areage	None
Live countdown by The SugaZz & Sacha Unger	None
Lo mid High	None
Lobe Records	None
Loco & Jam	house music
Lolo & Romeo	None
London	classical
Lou Bellucci	None
Lounge	None
Lounge Mo Kitchen & Mo Bar	None
Low Tales	house music
Lowris	hip hop
Lp	None
Luca Agnelli	house music
Luca Castagna	None
Luca Leiser	None
Luca Morris	techno
Luca Torre	techno
Luca de Grandis	None
Lucas Aliu	techno
Luciano b2b Carl Craig	None
Lucky	rap
Ludal	None
Luigi Afterhour	None
Lukas Kleesattel	techno
Lukas Kleesattel bern zÃ¼ri	None
Lukas Kleesattel bern züri	None
Luke Redford	None
Luke Slater	techno
Lux Rec  Schwyz	None
LÄUFT	None
MANDY	pop
MANON desolat züri	None
MARCO TEMESTA	None
MARLON	None
MASSIMO GERARDI	None
MASTRA mit TRAUMADUO bern	None
MATT SMOOTH	None
MATT TRIGGS	None
MDMO	None
MELON	rock
MGness	techno
MIA MILANO	None
MIA tanzkarrusell mulhouse	None
MIGUEL	hip hop
MIKE FATAL & NIKA NIKITA	None
MIKE TEIXIERA	None
MIKE VÃTH  Gon Records zh	None
MIKE VÄTH  Gon Records zh	None
MILK RESIDENTS	None
MIO zÃ¼ri	None
MIO züri	None
MISS DUCKIN	None
MONOTEQUE zÃ¼ri	None
MONOTEQUE züri	None
MONTREAL	electronic rock
MORE TBA	None
MR LOATHING	None
MTDF	house music
MaMe	None
Maalva Cruz	None
Mad Resident	None
Madnax	techno
Madteo	house music
Maho	None
Maickel Esse	None
Mainfloor	None
Makam	None
Make the Girl Dance	electrofox
Malente	breakbeat
Malicious Joy	None
Manaré	techno
Mandar aka Lazare Hoche	None
Mannheim	christmas
Manon	techno
Manual  Terminus	None
Manuel Fischer	None
Manuel Moreno	None
Marc DArrigo	house music
Marc Houle	techno
Marc Romboy	techno
Marcism	None
Marco Basso	None
Marco Capone	None
Marco Carola	techno
Marco Da Mata	None
Marco Damata	None
Marco De Rosa	house music
Marco Effe	hip hop
Marco Navarro	None
Marco Trinkler	None
Marco Zenker	dub
Marcow	None
Marcus Intalex	drum and bass
Marcus Meinhardt	house music
Margaret Dygas	dub
Margaret Dygas  underlne  london  UK	None
Mario Tamasi	dub
Mark Faermont	rap
Mark Henning	techno
Markus Homm & Mihai Popoviciu	house music
Markus Kenel	house music
Markus Lindner	techno
Markus Lindner  Cityfox	None
Markus haZe  save the vynil	None
Markus haZe BE	None
Marlon	None
Marocco	None
Martelli	channel pop
Martin Baur Index  Underdog Luzern	None
Martyn	folk
Marvin & Guy	rap
Masters of Disaster	schranz
Mastra	deep
Mathew Square	None
Mathias Kaden	techno
Matija	None
Matrixxman	house music
Matt Manik	None
Matteo Arcucci	techno
Matthew Styles	house music
Matthias Tanzmann	techno
Mattoo	disco
Matu	rock
Maty Palc	None
Mauro Venice	None
Mauy	None
Maya Jane Coles  hypercolour  mobilee  London	None
Meienberg	None
Meikel	techno
Mekas0	None
Memoria  Belgium	None
Mental Groove	None
Mercury	rock
Merz Feat Julian Sartorius	None
Mescene	None
Messiah	reggaeton flow
Meta Marie Louise	None
Mia Kaltes	None
Miajica	rap
Michael Canzian	None
Michael Schwarz	techno
Michael T fresh  0800 till end	None
Mick Wills	techno
Mickey Morris	None
Miguel	pop
Mihael Simic	None
Mik Maroo	None
Mike Machine	None
Mike Shannon  CYNOSURE	None
Mike Shannon  cynosure  valencia  ES	None
Mike Teixeira	None
Mike Teixeira bern	None
Mike Vamp	None
Mike VÃ¤th  Audionatica  Dreksler & Haerle  Dub Tales	None
Mike Väth  Audionatica  Dreksler & Haerle  Dub Tales	None
Mikee	drum and bass
Milk Klub resident  Geneva	None
Milo Häfliger	None
Min	pop
Minidetail	None
Mio Martini	disco
Mira	classical
Mirco Esposito	None
Mirco Mendosta	None
Mirk Oh	None
Mirko Loko	techno
Mirkovich  minimouse Rec NE	None
Miskate  unfound  usa	None
Mismo Konzum  Hive  Minirampe  ZH	None
Miss Fitz  circus company  israel	None
Mistakes Music	None
Mit dabei sind die talentierten Locals Francesco Parla	None
Mobilee	None
Mobylette	None
Modeselektor	electronic rock
Modular Club	None
MoirÃ©	None
Moiré	None
Moldavius	None
Monika Kruse	techno
Monoloc	techno
Moon	pop
Morb	None
Moscoman	house music
Mother	indie
Motoguzzi	None
Mr Scruff	downtempo
Mr Thing	scratch
Mubarek	None
Mucho Stylez	techno
Multitask	None
Murciano	house music
My My	pop punk
MyNightlifeFM FLOOR	None
MÃ¶we	house music
Möwe	house music
München	None
NADER  Party Garantie ZÃ¼rich	None
NADER  Party Garantie Zürich	None
NED O NEAL	None
NEMO	neo-progressive
NEWCOM B2B Guyus	None
NICO MASSA	None
NUKEM	disco
Na Noon	None
Nader	techno
Nadja Stoller	None
Nahste Oner	None
Nakadia	techno
Naked lunch Bosphorus	None
Namito	techno
Naomi Bowler	None
Ned ONeal	None
Neferiel	None
Nekow	disco
Nelson De Jesus	None
Nemo  All Night Long	None
Nemo and Friends	None
Nenad J	None
Neo Mds	None
Neto	regional mexican pop
Neverdogs	house music
Newfact Music	None
Niall Redmond	hip hop
Nice Nine	None
Nici Faerber	hip hop
Nick Nasty	house music
Nick Nasty bern	None
Nico Lahs	disco
Nico Stojan bar25 berlin	None
Nico Sun	None
Nicola Kazimir	disco
Nicola Koch	house music
Nicolaj	None
Nicolas Duvoisin	disco
Nik	rock
Nik Frankenberg	None
Niko Schwind	deep
Nikola Kotevski	None
Nikola Kotevski& Patrick Podage	None
Nils Fraser	None
Nima Gorji	techno
Nimmersatt	None
Nixon & Blackbird	None
Noir Music	None
Noir MusicOslo	None
Nole	None
Nolé	None
NonSenseCorporation aka Mikall Svender & Alan Lector	None
Norbertto	None
Nordstern	None
NoÃ© Weigl	None
Noé Weigl	None
Nukem	disco
OCTOBER RUST	None
ORGANIC STUFF	None
OSI	progressive
Oase & Sainte Harare aka Foupoudav	None
Ohm 10	None
Ohm10	None
Oliver Aden & Luis Cruz	None
Oliver K	hip hop
Oliver Koletzki	house music
Oliver van der Miescher	None
Omar	reggaeton
Ona rec	None
Ongaku	None
Opuswerk	techno
Opuswerk  techno prÃ©natale	None
Opuswerk  techno prénatale	None
Oram Modular	None
Oscar Niczzo	None
Ostwind	None
Osymyso	mashup
Otist Riddim	None
Ovski	None
Ovum	None
Oxia	techno
Oxide and Neutrino	uk garage
PASCAL TOKAR	None
PASCI zÃ¼ri	None
PASCI züri	None
PAT A  PROVINZMUSIK	None
PBell	None
PETER SZANTO  mischkultur	None
PK Squared	None
PLASTIC FM	None
PRISMA live biel	None
PRIVARFESTLI	None
PROJEKTIL VISUAL EFFECTS	None
PROJEKTIL Visuals	None
PTess	None
Pablo Anastasia	None
Pablo Einzig	techno
Pablo Einzig & Nici Faerber	rap
Paco Osuna	techno
PajÃ¶rn  2Takt	None
Pajörn  2Takt	None
PanPot	None
Pandour	None
Panorama Bar	None
Panoramabar  Berlin	None
Paolo Trovato	None
Paraklang	None
Paris	uk garage
Pascal Inc	None
Pascal Tokar	None
Pasci	None
Passion2Elements	None
Paste 20	None
Patife	None
Patrick Podage	groove room
Patrick Podage & Nikola Kotevski	rap
Paul C & Paolo Martini	rap
Paul Eg	techno
Paul Lomax  Deepflight Ibiza	None
Paul Mad	techno
Pawlikowski	classic polish pop
Pazkal	house music
Peak	None
Pender Street Steppers	None
Perc	techno
Performances by Life is a Bitch Crew	None
Peter D	techno
Peter Szanto	None
Petitjean	None
Phantom Project	None
Phantom Project l Minimal	None
Phil Cole	disco
Phil Garner	house music
Phil Garner What Else	None
Phil Riss & Ali C	None
Philipp Weibel	None
Phrex	None
Physical	None
Pig & Dan	house music
Pikaya	house music
Pilocka Krach	rap
Pinch	uk garage
Piratenkind	None
Pisa	None
PistolPete	hip hop
Pièrick	None
Plastikman	techno
Play it Loud	None
Playlove	techno
Pleasurekraft	techno
Plus many more TBC	None
Pochatz	None
Pointillisme Musique	None
Pokerflat	None
Pokerphl	None
Princess P	None
Profondo	None
Progamode	None
Progressiv minimal minimalhouse Techhouse	None
Proudly People	techno
Putah Wild	None
PÃºrpura	None
Púrpura	None
Question & Exclamaton Mark	None
Quitim	None
RAOUL murg	None
RATIO  AMSTERDAM	None
RICHARD HECTORJONES	None
RINA LOU	None
RINO	rap
RINO  Cityfox ZÃ¼rich	None
RINO  Cityfox Zürich	None
RINO cityfox züri	None
RINO zÃ¼ri	None
RINO züri	None
ROB BRIGHT	electro jazz
ROGER M	None
ROLF IMHOF	None
Racker	None
Radi Tabasco	None
Raf Daddy	None
Ragaz Inc	None
Ralf 10100	None
Ralph Good	techno
Ramon Tapia	house music
Raphael Raban	None
Raphaello	None
Rapu	None
Rapu & Nekow	None
Raw Operators	None
ReUP	None
ReYou	disco
Reben	None
Rekids  Berlin	None
Reloading	None
Renato Broccini	idm
Rene Bourgeois	house music
Rene S	None
Rennie RÃ¸yma	None
Rennie Røyma	None
Resident  De La Porter  Skorpionkinder Records  Cube Resident	None
Reto Ardour	techno
Retrocyclique	None
Return	pop
Return b2b Patrischa	None
Rich Braker	None
Richard Dorfmeister	downtempo
Richard Earnshaw	house music
Richi Spielmann	None
Rico Loco	None
Rico Rausch	None
Rino	rap
Riot School	None
River Ist Böse	None
River ist Böse	None
River ist böse	None
Rob Birch	None
Robbie	pop
Robel	None
Robert Babicz	techno
Robert Dietz	techno
Robert Johnson	blues
Robert Owens	house music
Robin Schulz	house music
Robin Sukroso	techno
Rodri  audiotheque  bern	None
Rodriguez Jr	techno
Rogi	None
Rolf Imhof	None
Rollende Beats	None
Roman Klinger	None
Romano Alfieri	techno
Romano Rapeso	techno
Romano Rapeso Teknologik Rec	None
Romeo	bachata
Ron Morelli	house music
Ronald Grauer	None
Ronny Vergara	techno
Ross Allan	None
Rotkeller	disco
Rotterdam	None
Round Table Knights	hip hop
RoyGreen & Protone	None
Rozzo	techno
Rumlaut	None
Rusconi	None
Ryan Crosson	techno
Ryan K	None
Rynecologist	techno
RÃ¦ve	house music
RÃ¸dhÃ¥d	techno
Ræve	house music
Rødhåd	techno
S A M & Malin GÃ©nie	None
S A M & Malin Génie	None
SBTRKT	electronic rock
SCHEINIZZL	house music
SCNTST	techno
SCP Dance Project	None
SENOMA	None
SHABBA luzern	None
SKay	None
SO  Private Sams  Ohm10	None
SOLOK	None
Sadar Bahar	None
Safari & Zielony	techno
Sampayo	None
Samsara	electronic rock
Samstag 07042012	None
Samuel Gfeller	None
Samuele Angelo	None
Samy Boulbrima	None
San Marco	deep orchestral
San Proper	techno
Sandro Kuhne	None
Sandro Kuhne Official	None
Sandro KÃ¼hne	None
Sandro Kühne	None
Santacruz	regional
Santis	techno
Santoro & Blair	None
Sarah Main  Jade residents	None
Sascha Braemer	house music
Sascha Cawa	house music
Sascha Dive	techno
Sascha Stohler	None
Sassy J	fake
Saul & Murphy	None
Saxo	romantico
Schiffsbauch	None
Schnauz & Brot	hip hop
Scum	horrorcore
Seb Blake	disco
Seb Zito	techno
Sebastien C	None
Sebo K	techno
Sepp	disco
Serafin cadenza zürich	None
Sergio Jimenez	None
Sergio Mesa	None
Sergio Trillini	None
Serioes & Legendaer	None
Sese	None
Seth Troxler	techno
Several Definitions	house music
Sexomodular live	None
Shaf Raisi	None
Shaka	norteno
Shaun Reeves	techno
She DJ Kaylee	None
Shed	madchester
Silky Raven	None
Silo Disko	None
Simi3001	None
Simian	electronic rock
Simon Lemont	None
Simon Stokes	techno
Sinden	house music
Sinner DC	techno
Sirion	progressive psytrance
Skail Master M	techno
Skankin Lion Tribe	None
Skaos	ska
Skinnerbox	ska punk
Slam	techno
Slou & Sam Pharell  MM rec	None
Smalltown Collective  Miguel	None
Smirre	None
So Solid Crew	uk garage
SoivÃ©	None
Soivé	None
Solomun	house music
Someone Else	techno
Somnambulance	None
Sonja Moonear	None
Sonja Moonear  karat  switzerland	None
Sonntag 08042012	None
Sonny Dima	None
Soukie & Windish	house music
Soulstar Syndicate	None
Soult	None
Souvenir Music	None
Soweto	world
Specimen	rock
Spencer Parker	techno
Spoony Talker	house music
Spor	None
Squep	house music
Squirrel	swing
Stacey Pullen	techno
Stadtpark	None
Stadtpark Wien	None
Stasis Recordings	None
Stefan Biniak	None
Stefan Nolic	None
Stefano Tropeano	techno
Steffen Sonnenschein	disco
Steffi	hip hop
Stephane Jusserand Alfonso Reyes	None
Stephane Lando	hip hop
Stereo tension	None
Steve Cole	smooth jazz
Steve Taylor	christian metal
Steven Stone	None
Steven Wallace	None
Stevie Ray Monkey Jam  Cube	None
Stil & Taktvoll	None
Stil vor Talent Hamburg	None
Stil vor TalentBerlin	None
Stil&Taktvoll	None
Strassenmajor	None
Strb	None
Strobetech	None
Strotter Inst & Flo Kaufmann	None
Studer TM l Freistil	None
Styro2000	None
Sub Bros	None
Subban	None
Suddenly Neighbours	None
Sulux	None
Sundance	None
Suol	None
Super Flu	house music
Superdisco	None
Supermarket	None
Supernature  Barcelona	None
Support DJs	None
Support Princess P & JSanders	None
Support Squep	None
Supsect One	None
Suspect One	None
Sven The Freak	None
Sven VÃ¤th	techno
Sven Väth	techno
Sven Wegner	disco
Sven Weisemann	techno
SwamThing	None
Symbiostic	None
Symoh Sares	None
Syntec	electronic rock
Sébastien Léger	None
Sören Klanken	None
T0DO	None
TBA	techno
THE KOLETZKIS LIVE	None
THE NUDGE AND MC KWASI	None
TITTO LA ROCKA	None
TOM WINEGARD plasurelap biel	None
TON IN TON	None
TSHEPITO	None
Taborka	None
Tadeo Doberska	house music
Tadeo Doberska bern	None
Tagedeep	None
TagtrÃ¤umerÂ²	None
Tagträumer²	None
Tale Of Us	techno
Tanzstube mit Mad Katz Techno	None
Tanzstube mit Schwerelos	None
Tanzsubstanz	None
Tarik	rap
Task Horizon	drum and bass
Tech House	None
Techhouse	None
Techrifice	None
Tectonic  Berlin	None
Tee Moe	None
Tension Festival	None
Terzini Bros	None
Terzini Bros  0500 till 0800	None
Terzini Bros  Perkussiv & positive music Sebian	None
The Advent	techno
The Bassment	None
The Bees	britpop
The CSC	None
The Checkup	house music
The Cruzaders	rock
The Knife	electronic rock
The Martinez Brothers	techno
The Nextmen	breakbeat
The Oh Nos	chicago indie
The Parallax	electro
The Phat Crew	electro trash
Thereal Demonti aka Samy Demonti	None
Thom Nagy	None
Thomas Melchior	None
Thomas Zopf	None
Thugfucker	disco
Tigerskin	techno
Till von Sein	techno
Tim & Puma Mimi	rap
Tim Engelhardt	house music
Tim Xavier	hip hop
Timnah Sommerfeldt	None
Timo Maas	breakbeat
Timoteo	brega
Timoteo & Fabri	rap
Tini	hip hop
Tino Kaufholz	None
Tino Kaufholz b2b Benjamin	None
Tobi Neumann	house music
Toffee	uk garage
Tom Bombadil	None
Tom Burclay	house music
Tom Nightowl Subtunes	None
Tom Sun	None
Tom Wineman	None
Tommy Four Seven	dub
Tommy J Gren	house music
Tomy Gips	None
TonTon	None
Toni Smash FX vs Hands Solo	None
Tonic	rock
Tonic  FreshnLoud	None
Tonka	hip hop
Tonknecht	None
Tony Nocera	None
Tony Smash FX	None
Topick  Jordan Hayes	None
Traffic Light	hi-nrg
Transmat  USA	None
Trashy Basstards	electro trash
Tre Rose	None
Tremendo  Mad Attitude	None
Trentemoller	electronic rock
Trinidad	rap
Troy Pierce  MNUS	None
Tryal	None
Tube & Berger	house music
Tucatz	None
Tuccillo	house music
Tujamo	house music
Tuncay Celik	hip hop
Tunnelenergy ch	None
Two Jeys and O	None
Two Suspects	None
UK	zapstep
UNKLE Sounds DecksnEffects	None
USA	None
Ulli & Maesoo	None
Umut	None
Underground Connection	None
Understand	None
Uner	techno
Unite	None
Unite Family	None
Unter Freunden	None
Uto Karem	techno
VANITA	disco
VID	None
VIDAL RODRIGUEZ	None
VISUALS by DARIO DESIENA	None
VITO LONERO	None
VJ Sophie le Meillour	None
VKawumski	None
VOLKAN OCAK	None
VS	pop
Valance Drakes	idm
Valentin Bösch	None
Valentin Jahn	None
Valentino	rap
Valetino	None
Van Nutt	None
Vanita	rap
Vanita & Low Tales	rap
Vario Volinski	house music
Vegetative Wachstumsphase	None
Vera	deep australian indie
Verliebt in Musik	None
Vid aka Egal3	None
Violett	techno
Virginia	disco
Visionquest	techno
Visuals by Bildstoerung	None
Visuals by Van Nutt & Kuka	None
Vitalic	electronic rock
Vitek	None
Vitek  Happy Bday	None
Vitek BE	None
Vlnolam Kawumski	None
Vocalist Lele Margot	None
Volkshaus	None
Voodookid	None
Voyage Direct	None
WAGON REPAIR  GENEVA	None
WE KILLED THE JUKEBOX	None
WWWDJSAMCOM	None
Wall music	None
Wandler	techno
Wandler  Cityfox ZÃ¼rich	None
Wandler  Cityfox Zürich	None
Wandler  MOTOGUZZI	None
Wankelmut	house music
Wareika	techno
Warmupper  Alex T  Rauch Club	None
We Are	anthem worship
We Reset	None
Weedz	None
Werner Hasler	None
Wien	None
Will Bankhead	None
Wonnow	None
Worakls	house music
Xela	ambient
Xenocracy DJs	None
Xfm SPECIAL GUESTS Claire Sturgess	None
YETTI MEISSNER	None
Yannick Barman	None
Yoni Banks & Yan Ka	None
Yuksek	electronic rock
ZH	None
Zapoff	None
Zavatta	None
ZerOKilled Music	None
Zero	downtempo
Zoe Xenia	techno
Zurich	None
Zustra	None
Zweitraum	None
ZÃ¼rich	None
ZÜRICH	None
Zürich	None
adriano aka adi	None
africaines	None
afro psyché rock	None
alli musikante chÃ¶mit us frÃ¶id und lust am ganze es herzlichs dankeschÃ¶n a alli	None
alli musikante chömit us fröid und lust am ganze es herzlichs dankeschön a alli	None
alongside MC DRS	None
and friends	None
and moore	deep texas country
apfall wieder mitnÃ¤ u entsorge	None
apfall wieder mitnä u entsorge	None
as to the manner born	None
be	rock
being ed  uk	None
berner oberland	british brass band
bertel gee	None
bescheren das Nachtleben jedoch mit hoch qualitativen Musikproduktionen und legen dazu sehr viel Wert auf solide Soundauswahl für ihre	None
bleepsequence	None
bold zh	None
bonsoir  bern	None
boogie	trap
buraq	None
by Cycle Opérant	None
chica and the folder  monika enterprise  germany  chile	None
chicago house Cobeia	None
chillout	None
chris de rebel	None
chrÃ¶sch	None
chrösch	None
cio  spezialmaterial  switzerland	None
classics	rock
comfortnoise	None
cutkachi	uk garage
dOP	techno
dan from illinoise	None
dan vo irgendwo & steffi sowieso	None
deco & visuals	None
deep	emo
deep medi	None
deepless records	None
deguds	None
destr  arm  switzerland	None
detroit	None
dickelauscher	None
disco	pop punk
disco funk	None
div	rap
diverse	None
dj lynn Jordan	None
djs	new jack swing
doma musique	None
dominic	pop
doubleare	None
drompojke	techno
druffnik & jacques horn	None
dxm soundsystem	None
eine vo mine lieblinge vo zÃ¼ri aus special	None
eine vo mine lieblinge vo züri aus special	None
entropie	None
ez raidler	None
fabien	None
flexibelle	None
freiberg	None
funk	None
fÃ¼rs liecht isch der timowood verantortlich	None
fürs liecht isch der timowood verantortlich	None
gallopierende zuversicht  bruckstuecke  switzerland	None
garage	columbus ohio indie
geneva	grave wave
hebet sorg zur umwÃ¤ut	None
hebet sorg zur umwäut	None
house	None
httpswwwfacebookcomClubSupermarket	None
httpwwwfacebookcomcircumflux	None
iDeep	None
infos naturapurach	None
jacqui	jazz
jon donson	techno
klangpunkt rec	None
lexx  drumpoet  switzerland	None
line up	None
litle lu	None
live	christian christmas
liveacts	None
llian Tape  Buenos Aires	None
loki	None
los refrescos  Dandy Jack  perlon  chile & Argenis Brito  senor coconut  venezuela	None
luc tonnerre  zurich  CH	None
manon	techno
marco repetto  inzec  bern  CH	None
mia	electronic rock
miniCLUB Timnah Sommerfeldt & Dubois	None
miniCLUB X HWSD Max Vaahs & Cedric Dekowski all night long	None
miniCLUB X LaMain	None
mit	a cappella
mit Manon	None
monolith Rec	None
more TBA	None
musiques caribéennes	None
nachtwelt  imploz  geneva  CH	None
nachtwelt  imploz  switzerland	None
nat  scandal   zurich  CH	None
nekÐ¯oBo  loungecore	None
nekЯoBo  loungecore	None
nhar  plak records  nantes  F	None
nick nasty	house music
nico bodbaiz	None
noe weigl	None
oO	None
ohm 10	None
ohni barbetrieb	None
packende Vibes  BORN & das SupiTeam verwöhnt seine Gäste mit Musik der Extraklasse  DER HouseLaden in Zürich Nicht umsonst steht im Supermarket eine der besten Soundsysteme  Kv2 Audio rundet das Hörerlebnis perfekt ab	None
peter stoffel  geneva  CH	None
peter stoffel  switzerland	None
planet mu	None
pompelmossap  plak  switzerland	None
profondo	None
raoul	None
reggae	reggae
restomas  switzerland	None
rino	rap
roberto  monokrak  geneva  CH	None
roberto  monokraknet  switzerland	None
savannah ibiza	None
see u at dancefloor	None
sinneswandel	None
socialmedia	None
soul	rap
special guest Chris Liebing	None
support Nik vjs Suffix	None
swamp81 bristol uk	None
t	pop
t t	hip hop
tadeo doberska	house music
taiken	None
tba	techno
tech house	None
technical knockout	None
triggerch  switzerland	None
udossonmredit	None
und  trapez  torino  I	None
und als DJs	None
ursprung	None
uvm	None
valerio spoletini  switzerland	None
van nutt  switzerland	None
vannutt  vannutt  zurich  CH	None
vo dir und fÃ¼r di	None
vo dir und für di	None
welches genau zu beobachten ist Hier tauschen sich Künstler untereinander aus und unterstützen sich gegenseitig in Sachen Musikproduktionen und Kooperationen	None
whatever	None
wo genau dÃ¶rt nÃ¤he sigriswil	None
wo genau dört nähe sigriswil	None
wortkarg	None
zerO	downtempo
zh	None
zip  perlon  germany	None
Âme Live	None
Ãme Live	None
ÐÐ¾ÑÐ½Ð¾Ð¹ Ð´Ð¾Ð·Ð¾Ñ	None
ÜNSAL KAPTAN sbar luzern	None
Ночной дозор	None
