	None
ANDREW THE GRAND	None
Actamin	None
Adolpho & Franky	None
Adva	None
Akt	None
Alma Negra	None
Andrey Pushkarev	techno
Ariane Effect	techno
Artikal  Black Box  NL	None
Aurora Halal	rap
Aust	None
Aware	None
Ayhasca Ernesto	None
Azimute	techno
BLACK TIGER Basel City	None
BOM	vapor pop
Baile Musik  DE	None
Basic Fingers	None
Beda	rap
Ben Kaczor	rap
Benjah	hip hop
Beppe Loda	None
Berber & Pasta	None
Bonafide 3000 ISR live Support FEA Soundsytem BE	None
Bufiman	house music
Bunte Bummler	deep
Byzance	None
CCO	rap
Cab Drivers	None
Cabinet Records	None
Caslau  Luke Haslau	None
Central Rodeo	house music
Cepheì	None
Cesar Merveille	techno
Chad Andrew	hip hop
Chaos In The CBD	house music
Chris Ahn	techno
Christian Elefante	None
Christian Schiemann	rap
Clearvision	None
Cold Colors	electronic rock
Cosmo & Faber	rap
Cutkachi  rest  dubtopia  Bern	None
D Cosmo	None
D Cosmo & Faber	None
DANIEL BROESECKE	None
DFA	None
DJ	trap
DJ Aunt One & Napoleton	None
DJ D	trap
DJ Dub	dub
DJ Fett Burger	None
DJ HERA	None
DJ Moishe	None
DJ PTess	None
DJ STEEL	None
DJ Tray	None
DJs Eli Verveine	None
DJs Nik	None
Dan Noel	house music
Daniel Branco	None
Daniele Cosmo	None
Danny Faber	techno
Dany Movida	None
Das HOUSE	None
Das Pferd	None
Dave Eleanor	disco
Davix	None
Deep n Dub	None
Delorian Cloud Fire	None
Der Dirigent	None
Did Low	None
Die Kistenkerle	None
Dj Montes  Goldfinger Brothers  Basel	None
Dj Never Die	techno
DoubtingThomas	rap
Drinks & Food	None
Dubhead  Istein	None
Echo 106	house music
Edward Classen aka EDI LE CHEF	None
El Tigre Sound	None
Elevated	None
Eli Verveine	techno
Elrino	None
Emre	turkish
Enzo Siragusa  Randall M  Chad Andrew  Hash Hendrex  Ferro  Kamran Sadeghi	None
EnzoMrTrendPianzola	None
FABIAN BINKERT	None
FRED LICCI	None
Faber	emo
Fabio Riccio	None
Faust	violin
Fehlfunktion	None
Flapjackers	house music
Frank Vespari	None
Gabriel Pellicano aka DJ Pellicano	None
Garance	techno
Garçon	None
Gel Abril	house music
Getting Any	None
Gold N Silver	None
Goldoni	None
Guel	None
Herman	show tunes
Hermansson & Martinez	None
Hfs Dub	None
Highlife	None
Hund Koecket	None
Idealist	ambient
Ikosa	None
Intro by Meschuggo	None
Iyad El Qirinawi aka EL Q	None
J Sayne	None
JOHNY BLAZE	None
Jack Demon	None
Jam On	None
Jame Mc Hale	None
Jame McHale	None
James Mc Hale	None
James Pants	hip hop
Jamie Lidell	soul
Jan Schulte	None
Jeff Swing	techno
Jerome Ferra	house music
Kaan Düzarat	None
Kairo Is Koming	None
Kaschemme Basel	None
Kejeblos	None
Khidja	house music
KiMi	None
Kombé	None
Kraftwerk	rock
Krizzli	rap
LAD	electronica
LIVE Alessandro Parisi	None
LUIS RODRIGUES	accordion
Lando	techno
Larry King	None
Larytta	hip hop
Lausanne	None
Lee Webster	rap
Lemonick	rap
Lesnicar	None
Lexx	rap
LichtDEFEKTE von Van Nutt	None
Lilith	spanish punk
Live	christian christmas
Live Pitsch & Magnano	None
Lord Kesseli & The Drums	None
MALEKOS BEUTEL & AMARU	None
MARQUE AUREL & MUSIC P	None
MRTREND	None
MTDF	house music
Madben	techno
Mafou	None
Magit Cacoon	rap
Mala  Digital Mystikz	None
Malik	pop
Manuell	hip hop
Marc DArrigo	house music
Marc Fuhrmann	None
Marc Hype	jump up
Marco Silva	None
Mark Lamski	None
Markus haZe	None
Mastra	deep
Mehmet Aslan	house music
Michel Mathis aka DJ Pun	None
Mike Kay	None
Minimo Imprint	None
Moscoman	house music
Mucho Stylez	techno
Mukuna	None
Music From Memory  Amsterdam	None
NINETOES	house music
Neevo	None
New Order	rock
Nicolas Duvoisin	rap
OLIVER K	re:techno
OTIST RIDDIM	None
Offen Music	None
Oliver Dollar	house music
Oliver K	re:techno
Oscar Niczzo	None
Oscar Schubaq	house music
Ostbahnhof	None
Ovum	None
PBell	None
PBen	None
PTess	None
Paul Eg	techno
Perlon  Berlin	None
Permanent Vacation	techno
Peter Hook	None
Peter Szanto	None
Philip Bader	house music
Philippe	choral
Playlove	techno
Pochatz	None
Priku	rap
Prop&Lean	None
Puma	house music
Purpurea	None
RP Boo	bass music
Raban	None
Radio Ghost Town  Basel	None
Rino	rap
Rio Wolta	None
Romar	rap
Roon	house music
Sandro Kuhne	None
Sanmon	None
Scott Kemp	techno
Serafin	orchestral
Sinjin Hawke	house music
Smos	None
Special Guest Mia Kaltes	None
Stassy	None
Stefan Goldmann	techno
Styro 2000	None
Subotagerecords  Density Radio X  Basel	None
TAF	neo metal
TBird	None
TMSV	uk garage
TNT	None
Tako & Jamie Tiller	house music
Tanua	techno
Teki Latex	techno
The Name Game	None
Time Has Changed	None
Timnah Sommerfeldt	None
Timothy J Fairplay	None
TomTeeT	None
Trauminic	None
Truce	None
Twoets	None
Underworld	breakbeat
VAlpen	hip hop
VAlpen aka Dachshund & Dave The Hustler	None
Valentin	cumbia
Valerio Raponi	house music
Venti	None
Vinyl Speed Adjust	rap
Vitronic	None
Vladimir Ivkovic	None
Wandler	techno
Wehbba	techno
Wicked Wilma	None
Wolf Müller	None
Yaroslav Lenzyak	house music
Zecher	rap
Zecher  Subotage Records  RadioX  Basel	None
Zora Jones	fluxwork
elias3O8	None
hypnorex	None
