	None
00010300  Bjorn Born DJ	None
03000500  Limic aka Lio M	None
2 Many DJs	techno
23000100  Pedro Andrade	None
23h05h00	None
4Line	None
ANGY DEE	None
ARCHIMEDE	None
Acktivism	None
Acoustic Nerds	None
Adrian Martin  Pazzoide	None
Agaric	techno
Air	electronic rock
Alex Di Stefano	techno
AnGy KoRe	techno
Andrea Oliva	techno
Andrey Pushkarev	techno
Andy Forrest	None
Angelo Gallo  Focus on Ibiza	None
Ast	None
Aubrey	disco
Aulay Fou	disco
Avatism	disco
B E Y O N D	disco
BANG GOES	None
BASCHGI SCHUUB	None
BE	rock
BLAIR	disco
BLEIMAGNET	None
BLight	slash punk
Barbir	None
Bassport	None
Bedran	None
Berlin	house music
Blair	disco
Bojan Milenkovic	disco
Born Bjorg	techno
Brainstorm	p funk
CHOREGRAPHY ANDRE MINKUS	None
CLAUDIO	classical performance
CRIS P	None
Cadenza	None
Ch	None
Channel X	house music
Chapelier fou	None
Christian Durdek	None
Christian Durdek  BLEIMAGNET  AG	None
Circus Company	None
Claudio Carrera  New Star Production	None
ConAction	None
Cosmic Bastards	None
Cosmokolor	disco
Cris P	None
DAN KOOK	None
DANIEL MARRONE & Radro	None
DAVID JIMEZ	None
DIRTYMADSOUND	None
DJ Dub	dub
DJ Dubstep	None
DJ Fever	None
DJ Zest	None
DJack Snyder	house music
DJs	new jack swing
DURDEK	None
Dalibox  Just like that	None
Dalibox  Salidamusic	None
Damien  White Lights	None
Daniel Marrone	None
Darek	None
Dario DAttis	disco
Dario Todorovic	None
Darius D	None
David Durango	techno
Davidovitch	techno
Dee Martinez	None
DeeJay Q	None
Deejay Q	None
Deeliver	None
Dejan	None
Dilek	None
Dj Albee	None
Dj TAG  Tresor  Berlin  TresorBerlin	None
DjaneLaRouge	None
Dlo  Harrem Resident	None
Don Davide	None
Dread J	techno
DrumnBass  Breaks	None
Dualism	techno
Dub Dummies	techno
Durdek	None
Dylan Casale	house music
Dysonc	None
EgoPhunk	house music
Eleminal	techno
Eleminal 4h Set	None
Enforce	perth indie
Entrée 10	None
Erol Alkan	techno
FRQNCY	None
Fabio Tamborrini  Cocomania	None
Fabric London	None
Federico Milani	techno
Franco Bianco	techno
Franco Bianco & Mike Wall present White Wall Live	techno
FreakBoutiqe	None
Freshmint	None
Fukuro	None
GL Everest	None
GOLD HANGOVER	None
Garibovic	disco
Gel Abril	techno
George Lamell	None
Goose	children's music
Groove	electronic rock
Groove On	None
Guisy S	None
Harry Klein Lausanne	None
Hecht&Zander	None
Heval	electronica
Hive	indie poptimism
Honeya	None
Hureca  Crazy Hours Italy	None
ITALY	None
Ibiza	house music
Ilanè	None
JORDAN & ASLANKAN	techno
JOne	hip hop
Jacqui	jazz
Jaime Fiorito	house music
Jan Penarrubia	techno
Jan Penarrubia  OFF MIND RECSIRION REC  BE	None
Jan Penarrubia b2b Mike Teixeira	None
Joe Janell	None
Juanjo Martin	electro latino
Just like that	None
Keith Worthy	None
Kim Prevedello	hip hop
KnackigSaftigWohltuned präsentiert	None
Kris Elements	None
Kubin	None
LINEUP	None
Le Spectre	tekno
Liebkind	None
Lil Fry	None
Luc André	None
Luca Albano	disco
Lui Young	techno
MARCO NAVARRO	None
MC Stone	None
MC Yasmine	None
MISS VIVIAN KANT	None
MODESTINO	None
MafiOzee	None
Mano Jay	None
Marcos del Sol  Noches con Sol	None
Marcus Werany	disco
Marek Hemmann	techno
Markus haZe	None
Martin Huergo	techno
Mas Ricardo	None
Masomenos	techno
Mathieu Kubin	None
Mathieu Kubin  REGIORAVE  AG	None
Max Nero	techno
Mc Annie Jacklin	None
Michael Deep	house music
Mickail	None
Mindtrip	None
Minimalfraktion	None
Mirco Many	house music
Mixhell	techno
NALAYA BROWN	None
NEW YORK	None
NICOLA SIMIONATO	None
NYC	beatdown
Ned ONeal	None
Ned ONeal  MinimalFraktion	None
Nenad J	None
Nooncat aka Alex Meshkov	None
Norbert Davenport	None
Noromal	disco
Noromal  SUNSUN REC  SO	None
Noromal & Durdek	rap
Noromal & Somi	rap
Nukem	disco
OXA	None
Oliver K	re:techno
On the wheels of steel	None
Ondrej	techno
Onkin	None
Opuswerk	techno
Oxyd	None
PAOLO BARDELLI	disco
PERFORMANCE YUNELLESKA	None
PHILIP BADER	techno
PanPot	None
Pascal Nuzzo	disco
Paul Chambers	jazz
Paul Eg	techno
Paul Eg  Ethnik GrooveMinimo ImprintDefinition Records	None
Peter D	techno
Philip Ort	None
Philipp Aregger	None
Philipp Ort	techno
Piratenkind	None
PolluX	None
Proud  White Lights	None
Pryus & Psyon	None
Quitim	None
Radro	None
Ramin	scorecore
Raphael Prest	None
Rice & Beans	None
Rodrigo Rivera	disco
Ryan K	None
S2 Records	None
SHAKE IT MASCHINE & MR PIGMAN	None
SPECIAL GUEST DJS	None
SPECIAL GUEST SHOW GIRLS VERNICE	None
SPECIAL VOICE	None
Sa 19 märz 2011	None
Salidamusic	None
Sam Ka	None
Sandro Falletta  Colludo Records	None
Shaka	grupera
Simon S	None
Sins & Temiri	rap
Skaos	ska
Smuda	None
Somi	vocal jazz
Soulwax	electronic rock
Starhouse	None
Steven Fox	None
Steven Traffic	None
SunSun Rec	None
Supermarket	None
Sweet Noise	polish punk
TAZ	None
TBA	techno
TITTO LA ROCKA	None
Tel Aviv Israel	None
Terminus Olten	None
Terry ONeil	None
The Acid hotel	None
The Chronics	None
The Cruzaders	disco
TiNTiN	house music
ToBe	None
Tolga Fidan	techno
Tom Bosson	None
Tonstau	None
Transport USA	None
Treibstoff	None
Tremendo	house music
Trentemoller	electronic rock
Trenton	None
Tuncay Celik	rap
VISUALS by motionblu	None
VISUALS by motionblur	None
VJs Namo & Dr Tintenblut	None
VOCAL LIVE	None
Volkan Ocak Official	None
WOLF	indie poptimism
Warm up	None
Wayne Harber	disco
Wuzz Täzz Universal	None
YANN STUCKI	None
ZH	None
Zongamin	None
dessous	None
dj lynn jordan	None
eintritt Fr 15	None
httpswwwfacebookcombassportcheckinfrefts	None
httpwwwfacebookcomdjandyforrest	None
httpwwwmyspacecomdjbrainstormmusik	None
httpwwwmyspacecomdjmasricardo	None
httpwwwmyspacecomdjskaos	None
httpwwwmyspacecomdjtintin	None
httpwwwmyspacecomnukemproduction	None
httpwwwmyspacecompositiveforce	None
long	new age
magnetisches feld aktiv 2200  0400Uhr	None
minimal techhouse Floor 2	None
minimal techno Floor 1	None
style techhouseminimaltechnoelectronica	None
ukem	None
