	None
& Mehr bald	None
& Special Guests	None
& many SURPRISE & SPECIAL GUESTS	None
& more TBA	None
& some more	None
& special guests	None
&ME	pixie
0100  0300 Schwarzes Gold	None
0130  0430 DJ Rush	None
0300  0500 Lars Lindenberg	None
0430  0530 Edelstahl	None
0500  Ende Jan B	None
0530  Ende Fredy S	None
1 floor	None
16 Bit Lolitas	house music
1st part 21h  00h	None
2 floor	hi-nrg
2020 Soundsystem	None
2020Soundsystem	None
2030	None
20h  21h30  ABOVE THE CLOUDS	None
20h30  21h30  SLAKBAR	None
21h30  22h30  VOLCANO THE BEAR	None
21h30  23h  JONNY SENDER	None
22h2h	None
22h30  01h  Cobeia	None
2300  0130 Mary C Jane	None
23h  01h  Prins Thomas	None
25616  2359 Uhr bis 800 Uhr	None
26616  ab 800 Uhr	None
2Takt	None
2econd Class Citizen	ninja
2headed	None
2nd part 00h  04h	None
3000 Records	None
3Some	None
45 AMPM live	None
451	None
47  FR	None
4am  Schwarzlicht  Elos & Vegas  Schwendix  Kyle Kyl	None
7th City	None
8Bit	None
8bit	None
A  AT	None
ADI	house music
ADVA  Playground	None
AFTER GRAUER	None
AFTERPARTY  Alte Kaserne	None
AJANIX	None
AKA AKA feat Thalstroem	None
AKAY	None
AKN & Ditek	None
AKUSTIK	None
ALBURT	None
ALES NAPS	None
ALL NIGHT LONG	None
AMochi	None
AN AN	hardcore
AN Aka Alexandre Navarro	None
AND SURPRISE & SPECIAL GUESTS	None
ANDREJ	None
ANDRI LIVE  Cityfox	None
ANDRI LIVE  Cityfox Zürich	None
ANDRI LIVE  Highgrade	None
ANDROO	None
ANFS	None
ANIMAL TRAINER  Pokerflat	None
ANTS	None
AOIDE	None
APaul	techno
ARG	None
ART&WEISE	None
ARTMAILLÃ	None
ARTMAILLÉ	None
ASI	spanish pop
ASMIAR	None
ASkillz	funky breaks
ATA	house music
ATMA	None
ATN	None
ATrak	house music
AUT	None
AVA ASANTE	None
Aaron Khaleian	None
Ab & Artig	techno
Ab 2300  18 Jahren	None
Abel	indie
Abelle ARMA17  Moskau	None
Abigail Bailey	None
About Clint	None
Accama	None
Access Denied	breakbeat
Achilles Moss	None
Achtung Kinder & DJ Tommy Lexxus	None
Acid Arab	techno
Acid Pauli	house music
Acousmie	None
Actress	electronic rock
Ada	techno
Adam Port	disco
Adam Shelton	house music
Adana Twins	deep
Addison Groove	uk garage
Adhmad Til	None
Adhmad Til & friends	None
Adi Nalin	None
Adi Shabat ReFeel	None
Adil Hiani	hip hop
Adimatique	None
Adolpho & Franky	None
Adon	world worship
Adon & Zafer	rap
Adrian Bergmann	None
Adriano Mirabile	rap
Adriatique	techno
Adriatique  Diynamic	None
Adriatique  Diynamic  Cityfox	None
Adriatique  Diynamic Music	None
Adriatique  Diynamic Zürich	None
Adverblaster	None
Aeon	death
Africaine 808	fluxwork
Afrilounge	house music
Afrilounge  Connaisseur	None
AfterParty mit Nicolas Kazimir	None
Afterhour 15082010	None
Afterhour Luigi	None
Afterparty Princess P	None
Agent C	None
Agnès	ambient
Agonis	None
Agoria	techno
Ahmet Sendil	techno
Ajele	None
Ajele Naturklang  Zurich	None
Aka Akha	None
Akirahawks	disco
Akkord	None
Alain Roy	None
Alan Bolumar	None
Alan Dente	None
Alan K	techno
Alan Kater	None
Alan Lector	None
Albee	None
Alburt	None
Alci	cumbia
Alci  Robsoul	None
Alden Tyrell	electro
Aldijana&Jorven	None
Alec Troniq	deep
Alejandro Mosso	techno
Alessandro Crimi	rap
Alessio Mereu	disco
Alex	pop
Alex Adair	house music
Alex Andher	None
Alex Bau	techno
Alex Belluscio	None
Alex Beluscio	None
Alex Beluscio &Marvin Meyer	None
Alex Dallas	None
Alex Dallas und Lexx	None
Alex Flatner	techno
Alex Gori	None
Alex Kostic	None
Alex Mendes	disco
Alex Niggemann	techno
Alex Picone	techno
Alex Silver	None
Alex Smoke	techno
Alexis Cabrera	techno
Alexkid	downtempo
Alfonso Leon	world meditation
All Day I Dream	None
Alle Farben	house music
Allen D & Shac	None
Alma	None
Along With  Zürich	None
Alphahouse	None
Alphatronic	None
Amanda Lepore	electronic rock
Amaro	reggaeton
Amaro  Dirty Larry	None
Ambient P	None
Ambient P  Pino Music	None
Ambient P & Friends	None
Ambient by Heiko	None
Ambienttechno by EFTN	None
Ambivalent	techno
Amelie  Talentfrei	None
Amiant	None
Amilcare	classical
Amine Edge	house music
Amine Edge & DANCE	house music
Amirali	disco
Amnesia Scanner	fluxwork
Amnésia	fluxwork
Amplidude	None
Amsel & Dohle	None
Amsterdam	None
AnGy KoRe	techno
Anatopia	None
AndId	techno
Andaloop	disco
Ander	techno
Anders A	None
Andersen	None
Andhim	house music
Andre	techno
Andre Absolut	None
Andre Lemont & Marius White	None
Andrea DAmore	None
Andrea Ferri	None
Andrea Oliva	techno
Andrea Oliva  Cadenza  Defected  BS	None
Andrea Oliva  Nordstern	None
Andrea Roma	techno
Andrea Terramossi	disco
Andrea Wenger	None
Andreas & Mathias	rap
Andreas Neufeld	None
Andreas Ramos	disco
Andreas Ramos  Rumlaut  Enzo lo Conte	None
Andreas Ramos & Schmerol	rap
Andreas Ramos Baked	None
Andreas Ramos Baked  ZÃ¼rich	None
Andreas Ramos Baked  Zürich	None
Andreas Volt	None
Andrei Stan	None
Andres Garcia	None
Andres Hernandez	None
Andrew	indie
AndrewGee	None
Andrey Pushkarev	techno
Andri	house music
Andri  2h Live Set	None
Andri live	None
AndrÃ© Hommen	house music
AndrÃ© Vincenzzo	None
AndrÃ©s Marcos	None
André Hommen	house music
André Uhl	None
André Vincenzzo	None
Andrés Marcos	None
Andrés aka DJ DEZ	None
Andy C	hip hop
Andy Daniell	None
Andy Gobeli VISUALS Style & Design GKZ	None
Andy Mader	None
Andy Struzek	None
Anemone Tube	None
Angelica Fravi	None
Angy Dee	None
Animal Swing Kids	None
Animal Trainer	house music
Animal Trainer aka Rx & Adrian Flavor	None
Animalist	None
Anja Schneider	techno
Anja Schneider  Mobilee Records	None
Anna Naklab	house music
Annakin	None
Anonym	techno
Antart	None
Anthea	techno
Anthik	house music
Antoine Chessex & Jérôme Noetinger	None
Antoni Maiovvi	None
Antonio Damato	techno
Antonio Mazar	None
Anyken	None
Aparde	house music
Apashe	house music
Apoll	None
Appleblim	uk garage
Apples & Pears	None
Arapu	rap
Archetype	christian
Archie Hamilton	techno
Arctika  Up Music	None
Area Remote	None
Argenis Brito	None
Argenis Brito  Ruta 5	None
Argenis Brito & Dandy Jack	rap
Argy	techno
Aril Brikha	techno
Aril Brikha & Franky Digital	techno
Ark	vapor soul
Ark & Lenny	rap
Ark live	None
Arkki	None
Armando	None
Armed Guys	None
Art & Weise	None
Art Department	techno
Art Department  Crosstown Rebels  Toronto	None
Art of Tech	None
Arth Goldau	rap
ArtmaillÃ©	None
Artmaillé	None
ArtundWeise	None
Arutani	None
Asphaltchild	None
Ast	None
Ast Alavista	None
Aston Martinez	None
Ata	house music
Attila	death core
Au salon 22h  3h	None
Audino	None
Audino Punkt  ZÃ¼rich	None
Audino Punkt  Zürich	None
Audio Tribe	None
Audio Werner	techno
Audiofly	techno
Audiofly  Get Physical	None
Audiomat	None
Audionatica	techno
Audionatica  Gon Records	None
Auf Dauerwelle	None
Aulay Fou	rap
Austra  Support	None
Austria	None
Autechre	techno
Avatism	deep
Avgusto	None
Avrosse B2B Louie Cut	None
Aware	None
Awesome Tapes From Africa	hip hop
Axiom	hip hop
Ayeko	None
Aïsha Devi	fluxwork
Aïsha Devi live	None
B Gahan	None
BABAJAGA	None
BABALU DANCERS	None
BABO	None
BAD BUG	None
BADBUG  LIVE	None
BANG GOES	None
BAREM  mnus  Argentinien	None
BASSFORSCHER & FACE DESIGN	None
BASSTHERAPY	None
BB PHOQUE	None
BCee	drum and bass
BE	rock
BEATIS & BASSHEAD	None
BEFORE WE SAY GOODBYE ALBUM TOUR	None
BELLOMZ	None
BIEBERS	None
BIG ZIS & MT DANCEFLOOR djteam	None
BIGENERIC	None
BIGT	None
BIZZARE CONTACT	trance music
BLACK ARTS LAB live	None
BLACK RABBIT	None
BLKND	None
BOCUSE & DER PFLANZER	None
BONAFIDE3000	None
BOTICO	None
BOTICO & ROSP	None
BOUNCE	indie dream pop
BRIAN SANAHAJI	None
BRUT	vaporwave
BTK	drum and bass
BTong	None
BUG	fluxwork
Baba	video game music
Babo	None
Bacalao	video game music
Bacalao & Sonne	house music
Bachstelzen  BERLIN	None
Backstube	None
Bad Chance	None
Badre	None
Bagatelle93	None
Baikal	disco
Bakerman	None
Bakermat	house music
Baltazzar	None
Balzklub	None
Balzklub Rollo Tomasi	None
Bang Goes	None
Bangko	None
Bar	soul
Bar 2130 Uhr	None
Bar 25	None
Bar25  Berlin	None
Barac	disco
Barbir	None
Barbir & Louh	None
Barbir & Nicola Kazimir	None
Barbir Punkt  ZÃ¼rich	None
Barbir Punkt  Zürich	None
Barcelona	dreamo
Bardo	rock
Bardo & Salazar	None
Barem	techno
Barem  Minus	None
Barenhvrd	trap
Baris K	None
Baroz	None
Bart B More	house music
Basel	consort
Basenji	aussietronica
Bashkim	None
Basil Bastard	None
BasilD & Hibrahim	None
Baskontrolle	None
Bass Clef	uk garage
BassbÃ¼ro	None
Bassbüro	None
Basskontrolle	None
Bassment	None
Batiment	house music
Bauchamp	None
Baumeister	None
Be Svendsen	house music
Beam Rec	None
Bear Funk	None
Bear the Eagle	None
Beardy Man	idm
Beardyman	idm
Beatamines	house music
Beats in Space  DE	None
Beatwitch	None
Beckers	None
Beda	rap
Beda  NAT	None
Beda & Pat Patrisha	techno
Beda und nader	None
Bedran	None
Bedrock	None
Beez & Simo	None
Bekka	None
Belfort	None
Bella Sarris	None
Bella Sarris tINI & the gang  London	None
Bellomz	None
Ben	neo mellow
Ben Ashton	None
Ben Kaczor aka BOM	None
Ben Klock	techno
Ben Moss	rap
Ben Murphy	None
Ben Rau Fuse  Berlin	None
Ben Yoo Suk	None
Beni Berger	None
Benja	None
Benja  Hive Audio  Zürich	None
Benja & Reto Ardour	None
Benja & Reto Ardour  Hive Audio	None
Benjamin b2b Peter Szanto	None
Benno Blome	rap
Benoit & Sergio	disco
Benotmane	house music
Berber & Pasta	None
Berlin	house music
Berlin D	None
BerlinDetroit	None
BerlinHamburg	None
Bern	None
Bernardo Zitto & Roberto Splendini	None
Bernoise	None
Bertel Gee	None
Bfly Steiner	techno
Biebers	None
Biesentales	None
Big Apple	None
Big T	None
Bigeneric Aka Marco Repetto & Mystessystem	None
BigenericMarco Repetto	None
Bildstörung	None
Bill Brewster	house music
Bill Kouligas	None
Bill Patrick	None
Billy Kenny	house music
Binh	vietnamese pop
Bio	None
Biologic Records  Tel Aviv	None
Bird	indie
Birmingham	orchestral
Biru	None
BitTuner	None
BitTuner live	None
Bitsculpter	techno
BjÃ¶rn Arryhl	None
BjÃ¶rn StÃ¶rig	house music
Björn Arryhl	None
Björn Störig	house music
Black Butter	None
Black Sun Empire	drum and bass
Black To Comm	warm drone
Blacksheep	techno
Blade SHEDHALLE Eli Verveine	None
Blair	house music
Blaise Deville	None
Blake Worrell live	None
Blanck Mass	fluxwork
Blank Tapes	None
Blankton & Sammelstelle	None
Blazer	breaks
Blondish	house music
Bloom	comic
Blubblubb	None
Blue Mystic	None
Blueberry	None
Blush Response	hardcore
Blvmenkind	None
Bob Bellerue	None
Bob Drop Dead	None
Bob Spiegel & Audiotekk	None
Bob&Bob	pop
Bobby Bella	None
Boddhi Satva	house music
Bodi Bill	electronic rock
Body&Soul	None
Bodymoves by Splashcats	None
Bojan Milenkovic	disco
Bomb The Bass	house music
Bon Vivants  Colliding Fields	None
Bonafide3000	None
Bondage DE	None
Bongo Joe Djs	None
Bonnie	rock
Bonny & CLyde	None
Bonny & Clyde	None
Bonobo	downtempo
Bons Vivants Records	None
Booby Night	None
Boogiemann	None
Booka Shade	house music
Boom boom floor	None
Boris	halloween
Boris Hilton Artwork	None
Boris Werner	techno
Born Bjorg	techno
Born Bjørg	None
Borussia	techno
Boston Bun	disco
Bottin	disco
Bouncerz	None
Bowmore	None
Boy George	new
Boy Next Door	None
BoyAn	house music
Brain & Device	None
Brandt Brauer Frick	microhouse
Branko live	None
Break New Soil	None
Bremen	None
Brett Jacobs	techno
Brian Python	None
BroKapella	None
BruderHerz	None
Bruderherz	None
Bruderzerz	None
Bruno Chaix	None
Bruv	None
Bryan	country
Bucharest	None
Buenos Aires	None
BuenosAires	None
Buko	None
Buko & Credo	None
Bunte Bummler	deep
Burnt Friedman	techno
Burt Cobain	None
Business2Business	None
Butch	rock
C Forza b2b Luca Leiser	None
CARLOS EVANGELISTA	None
CASTROMOORE	None
CCO	disco
CCut	None
CEZAR	techno
CH	None
CHILLOMANIE	None
CHIRI MOYA	None
CHRIS DE REBEL	None
CLARI ANN	None
CLFT Militia	techno
CLIFF & FABRICE	None
CLIT EASTWOOD & WINONA SLIDER	None
CLM	None
CMOS	None
CMOS & Kens	None
CMYK	None
CMYKollektiv	None
COH	idm
COMA	disco
COMFORTNOISE PLOY	None
CONDOM	electronic rock
COSMIC DJ	disco
CREATOR	hip hop
CRYPTEXMARBLE	None
Cabanne	None
Cabinet Records	None
Cadenza	None
Cadenza  CHILI	None
Cadenza Lausanne	None
Caleb Calloway	techno
Calpol B2B Traplo Picao	None
Camea	house music
Cameo&Jaxx	None
Canada	electronic rock
Canson	house music
Capcom	None
CapohLitch	None
Captain Teis	None
Cari Lekebusch	techno
Carl Craig	techno
Carlo Lio	house music
Carlos Jr	None
Carnage	trap
Casseopaya	hardcore
Cassy	microhouse
Caterina Barbieri	None
Cauliflower	None
Cause & Affect	house music
Cedric Zeyenne	groove room
Cem Demir	None
Central Rodeo	rap
Central Rodeo aka Cosmokolor & diSoul	None
Ceo Müller	None
CerealKillers live	None
Cesar Merveille	techno
Cesare vs Disorder & Quenum	techno
Cezanne	None
Chabud	techno
Chad Andrew	hip hop
Chad Andrew tINI & the gang  Orlando	None
Chak Besh	None
Chak Besh Katerholzig	None
Chak Besh b2b Svenskj	None
Chamalo	None
Channel X	house music
Chapelier Fou	None
Chapkmace	None
Charles Cohen	mandible
Charlotte de Witte	None
Chaton	None
Cheeky Choice	None
Cheesebeat	None
Cheibe Balagan	None
Chica Paula	techno
Chicks behind the decks showcase  Bern	None
Chill Bump	None
Chiri Moya	None
Chocolate	trap
Chocolatex1f	None
Chop & Suey	None
Chrigi G us Z	None
Chris Ahn	techno
Chris Clayton	None
Chris Colburn	techno
Chris Dubflow	ambient
Chris Lattner Moon Harboour	None
Chris Rockwell	techno
Chris Tietjen	rap
Chris Tietjen Cocoon  Frankfurt	None
Chris de Rebel	None
Chris de Rebel FlÃ¼gstund  ZÃ¼rich	None
Chris de Rebel Flügstund  Zürich	None
Christian Burkhardt	techno
Christian Schiemann	rap
Christine Live	None
Christo	house music
Christoph Woerner	techno
Christopher Lawrenz	None
Christopher Rau	house music
Chronic Fingaz	None
Chronophone	None
ChrÃ¼si Musique	None
Chrüsi Musique	None
Chuck Poland  Bernoise  Andy Struzek	None
Chukks	None
Cio	None
Cippi	idm
Circle	rap
Circle of Love	None
Circuit Diagram feat Derya Yildrim live	None
Cirkus	downtempo
Cityfox	None
Cityfox Ltd	None
Cityfox Wient	None
Cityfox showcase with  Markus Lindner	None
Civil Music  BE	None
Claire Chalut	None
Clapper	None
Claptone	house music
Clara	None
Clara Moto	techno
Claude Laurier	None
Claude Tarell	None
Claudio	classical
Claudio  Bassport	None
Claudio & Emre	rap
Claudio & Volkan Ocak	rap
Claudio Carrera	None
Claudio Masso	house music
Claus Voigtmann	None
Clay Wilson	texas
Clem  Specimen	None
Cleric	dub
Clit Eastwood	None
Clit Eastwood & Winona Slider	None
CloZee	idm
Closer	None
Clovis & Dan Campo aka The Dudes	rap
Club	electronic rock
Club 2300 Uhr	None
Club Cheval	disco
Cobeia	rock
Cobeia  Special no wave  post punk set	None
Cockwhore & Macho	None
Cocoon	chanson
Cocun	None
Codex Empire	techno
Colin Dale	house music
Collynization Soundsystem	None
Cologne	None
Colors of Sun	None
Comfortnoise Ploy	None
Comini	None
Comini GlÃ¼ckStÃ¼ck ZH	None
Comini GlückStück ZH	None
Comitissa	None
Commodo	uk garage
Como Damar	None
Condor	cumbia sonidera
Congorock	house music
Conker	None
Connaisseur Recordings	None
Container	None
Cooly G	uk garage
Corpataux	techno
Corpataux  Roach  Jutzi  Der Dirigent  EilÃ©ma	None
Corpataux  Roach  Jutzi  Der Dirigent  Eiléma	None
Corso	None
Cos	canterbury scene
Cosili	None
Cosili VISUALS Style & Design GKZ	None
Cosmic Baby	bubble trance
Cosmo & Faber	rap
Cosmo & Kramer	rap
Cosmokolor	disco
Cosnost	None
Coss	house music
Costas Papa	None
Coughy live actvisuals Beatrice Sommer	None
Courtney Storer	None
Covert Entertainment  USA	None
Coxswain	None
Craiova	manele
Cre8	None
Creaked DJs	None
Creaky Jackals	trap
Crimetekk	None
Cris Deep	None
Cris Lange	techno
Criss	uk garage
Cristal Fighters live	None
Cristian Tamborrini	house music
Crocodile Soup	disco
Crosstown Rebels	None
Crowdpleaser	techno
Crowdpleaser  Turbo Recordings	None
Cruz Jr	None
Ctwalk	None
Cuartero  Desolat	None
Cubex	house music
Cubixx	None
Culoe De Song	house music
Culprit	None
Culver	None
Cummi Flu live	None
Curtiss	None
Cut Hands	house music
Cutkachi	uk garage
Cuzzy Cuz	None
Cwalk	None
Cypolit	None
Cyril Léger	None
Czanne	None
D Brun del Re	None
D Club  Lausanne	None
D j Zest All night a long	None
DADA	house music
DAFNE & CEM	None
DAINSKIN	None
DANIMAL	video game music
DANWORK	None
DARIO DESIENA Visuals	None
DARKROOM GANG	None
DAY DIN	progressive psytrance
DAYDANCE	None
DAndy	rock
DCP	None
DE	banda
DEADCOOL	None
DEBBYS & Mickail	None
DEBRUIT live	None
DEEJAYS	house music
DEEP CHILLS	house music
DEJAN	None
DEJAN  Cityfox	None
DEJAN  Cityfox  Zürich	None
DEJAN  Cityfox Zürich	None
DER KUTSCHER UND SEIN GAUL live	None
DEYAN	None
DEx1f	None
DExp	None
DFA  San Francisco	None
DIAZ DJ	None
DICE	trap
DIDA	None
DIE Galoppierende Zuversicht	None
DIMI3	rap
DIMI3 & TT	rap
DIRTY APPLES	None
DIRTY HONKERS	electro music
DISASTERADIO	rock
DJ	trap
DJ 1901	None
DJ ATN	None
DJ Angel	None
DJ BALU	None
DJ Bazooka	None
DJ Big T	hip hop
DJ Bod	None
DJ Budai	None
DJ Byte	None
DJ CEM	None
DJ Chris Wi	None
DJ Claudio	None
DJ Corrine Wacker	None
DJ Crash	techno
DJ DACHSTOCK	None
DJ Deep	techno
DJ Diferenz	None
DJ Dodger Stadium	None
DJ Dub	dub
DJ Duorythm	None
DJ Emess	None
DJ Emok	None
DJ Energy	bubble trance
DJ F	None
DJ FERROX	None
DJ FMC	None
DJ Flashback	hardcore
DJ Flush	techno
DJ Fred Hystère	None
DJ GUMJA	re:techno
DJ Gemini	None
DJ Hachi	None
DJ Hedibear	None
DJ Hell	electronic rock
DJ Highman	hip hop
DJ JOAO DINIS	None
DJ Jack Slaughter	None
DJ Jamie Lewis	None
DJ Jamie Lewis EXCLUSIVE 5 HOURSE SET	None
DJ Jesse Jay	None
DJ Jihell	None
DJ Jonny Sender	None
DJ Koze	house music
DJ Krush	downtempo
DJ Le Baron	disco
DJ Le Roi	hip hop
DJ Le Roi  Get Physical  Noir Music  BS	None
DJ Line Up	None
DJ Loco	None
DJ Lucc	None
DJ Malza	None
DJ Manual  Noromal & Christian Durdek  Fabio Gullone	None
DJ Mary	techno
DJ Mastra & DJ Zukie173 Visuals by durchzweich	None
DJ Mathieu	makossa
DJ Mitch	None
DJ Mourad	deep rai
DJ Nicca	None
DJ Niclas	None
DJ OCTAN	None
DJ Overdose	electro
DJ Oxyd	None
DJ PHIL ZVIEL	None
DJ Reas	None
DJ Reas  Geneva	None
DJ Rolla	None
DJ Ruben Estevez	None
DJ Rush	techno
DJ Ryck	None
DJ SNES	None
DJ STYLE & DAITAN	None
DJ Sammy	europop
DJ Sassy J & DJ Alex Like	None
DJ Scape	None
DJ Scar	None
DJ Set Glue eyes & guest DJ Jerome Antony	None
DJ Show	None
DJ Simon Kwe & Zimbabwebird MC	None
DJ Sotofett	None
DJ Spire	None
DJ Sprinkles	None
DJ Style & Soe	None
DJ T  Get Physical	None
DJ Tekin	house music
DJ Thomas Luke	None
DJ Tonic & DJ Tremendo	None
DJ Triiad	None
DJ UNIT	None
DJ Vibe started mixing early It was back in 1983 that António Tó Pereira got his first ever club gig at Lisbons Bataclan spot Today he still dedicates his 30 talented years of music to all of us crowd people	None
DJ Wenzel Dashington	None
DJ Wld	None
DJ YORE	None
DJAIMIN	None
DJAZZ	None
DJEN KA FLOW	None
DJERRY C	None
DJJAMIE LEWIS	None
DJS	new jack swing
DJSet &Trauma Duo	None
DJamency	techno
DJs	new jack swing
DJs Ben Danger & Wenzel Dashington	None
DJs DJ Koze  Matija  Ptess  Nici Faerber  The Dean Soniks  Ulli & Maesoo  JSayne & Loo Mapper  MiMi  Des Wahnsinns Fette Beute	None
DJs DJ Madskillz  Acid Pauli  Matija  Mika Dutsch Sonik  Monome  Cio & Nat  Pat Patrisha  Ulli & Maesoo  Bob Drop & Mad Rose  Paul Heimweh  Dubexmachina Soundsystem	None
DJs Disco Ste	None
DJs Duo Meda & Medooza	None
DJs Frits Wentinik	None
DJs Girl	None
DJs Green n Brown	None
DJs Guyus	None
DJs Housefrauen	None
DJs Jolly Buoy	None
DJs Life is Live	None
DJs Louis De Fumer	None
DJs Lucky Charmz	None
DJs Mooqee	None
DJs Nik	None
DJs PBell  Styro 2000  Ida  Rumory  Bang Goes  Playlove	None
DJs Solid & Wenzel Dashington	None
DJs Spectron & Jay Sanders	None
DJs Tape	None
DJs The Dean Soniks	None
DJs Utah Jazz	None
DJs Zombie Disco Squad	None
DK	None
DM Free	None
DMX Krew	techno
DNox	techno
DO 0812 ELEKTROBAR Mit DJ Alastair & De La Porter	None
DOMINIC	k-pop
DOO GOOD	None
DOX2	None
DR BARESCO	None
DTC	None
DUB ROOTS	None
DUBNIUM	None
DY over DX	None
DYNAMIC BASTARDS	None
Da Ron	None
Dachshund	techno
Dachsund	None
Dadaglobal	disco
Dagalante	None
Dais & Duschek	None
Daitan	None
Dale Howard	techno
Damaru	hip hop
Damian Lazarus	techno
Dan Andrei	None
Dan Caster	deep
Dan Curtin	techno
Dan Ghenacia	techno
Dan Michaels	None
Dan Noël	None
DanWork	None
Dana Ruh	techno
Dana van Delden	None
Dancecode  France	None
Dandi & Ugo	techno
Dandy Jack	hip hop
Dani Casarano	techno
Dani KÃ¶nig	None
Dani König	None
Dani Nydegger	None
Daniel Bell	techno
Daniel Broesecke	None
Daniel Davidovsky	None
Daniel Dreier	techno
Daniel Lao	None
Daniel Steinberg	deep
Daniele Di Martino	house music
Daniele Gentile	None
Danielson & Norbertto	None
DanielÃ¨	None
Danielè	None
Danni B Collage Audio  Melbourne	None
Danny Faber	techno
Danny Krivit	hip hop
Danny Scrilla	None
Danny Serrano is one of electronic musics most exciting upandcomers	None
Danny sets have energy	None
Danse Noire Djs	None
Danse Noire djs	None
Dante	house music
Dantze	None
Daparec	techno
Daria	techno
Dario Camiolo	None
Dario DAttis	rap
Dario DAttis  Hive Audio	None
Dario La Mazza	None
Dario La Mazza & STEFANO RINALDI	None
Dario Lotti	disco
Dario Rohrbach	None
Darius Syrossian	house music
Dark Floor	None
DarkZ B2B Rekah	None
Darkening	None
Darkroom Gang  Jann Bronski  John Lemon & Christian  Aulay Fou	None
Darkstar	fluxwork
Darrien	hardcore
Darrien  ZH	None
Das Balz	None
Das Hutwerk	techno
Das Lineup fÃ¼r den Dancefloor Techno	None
Das Lineup für den Dancefloor Techno	None
Dash Deep Records	None
Dasha Redkina ARMA17  Moskau	None
Datendrang	None
Datendrang live	None
Dauwalder	None
Dave Canina	None
Dave Clarke	techno
Dave DK	techno
Dave Dinger	None
Dave Eleanor	disco
Dave Eleanor dj	None
Dave Eleanor presents LNR	None
Dave Neff	house music
Dave Phillips	psychobilly
Dave Vega	techno
David Armada  Specimen	None
David August	house music
David Aurel	None
David Cruso & Kary	None
David Gtronic	techno
David Gtronic tINI & the gang	None
David Kiesel	None
David Labeij	techno
David Mayer	idm
David Morales	house music
David Penn	techno
David Phillips & DAISY HEARTBREAKER	hip hop
David Steel	hip hop
David Suivez	None
David Torr	rap
Davide Cucchi	None
Davide Rucci	None
Dax J	techno
Daylight Floor	None
Dd King	None
De Hofnar	house music
De Posada	None
DeWalta	techno
Dead J live	None
Debal Sommer	house music
Deborah De Luca	techno
Deckmantel DJcollective	None
Dedans 23h  05h	None
Dee Nelli	None
Deejayridoo	None
Deep A	None
Deep Chills	house music
Deep White	None
DeepTek	None
Deepa & Biri  Tel Aviv	rap
Deepwhite	None
Deetron	techno
DefPlay	None
Defect X	None
Dehors  20h30  23h	None
Dejan	None
Dejan  Cityfox	None
Dejan  Cityfox Zürich	None
Deko & Light Timowood TV	None
Deko by Dario Desiena	None
Delano	pop
Delete	hardstyle
Delta Funktionen	techno
Dema & Paride Saraceni	techno
Demand	None
Dement3d	None
Demetrio Giannice	house music
Demotape Clinic  Zürich	None
Den Ishu  Desolat  Supernature	None
Deneha	house music
Denis Capizzi	None
Denker & Lenker	None
Denmark	None
Dennis Bader	None
Dennis Ferrer	house music
Denny	None
Denz	hip hop
Depeche Mode	new
Der Dirigent	None
Der Dirigent  anyideas	None
Der Dritte Raum	techno
Der Effekt	None
Der Gammler	None
Der Holländer	None
Der Mega Watt Clan	None
Der Minister  Silk Events	None
Der Schuft	None
Der Vogelwärter	None
Der Wanderer  Great Stuff	None
Der Wandervogel	None
Der Weisse Aya	None
Derrick May	techno
Design  Performance	None
Desolat	None
Detroit	None
Detroit Grand Pubahs	techno
Detroit Swindle	house music
Deviant Force	None
Deyan	None
Dhamuzien	None
Dialog	techno
Die Galoppierende Zuversicht	None
Die Wilde Jagd	None
Diego Surarez	None
Dietrich & Strolch	techno
Dietti & Project Acid	None
Digital Geist	dark electro-industrial
Digital Pirates	disco
Digitaline	techno
Digitalis	dub
Digitalist	dark psytrance
Digitizer	nu electro
Digitron	None
Dilek Bookings	None
Dilo	techno
Dim & Eevy	None
Dim Mak	brutal death metal
Dimette	None
Dimitri	house music
Dimlite	idm
Dimlite w Julian Sartorius	None
Dine	ambient
Dineo	None
Dinky	techno
Dino White	None
Dirty Disco Youth	house music
Dirty Doering	deep
Dirty Flav	None
Dirty Larry	techno
Dirty Larry b2b Tiano Thomas	None
Dirty Sound Magnet	None
Dirty Sound System Feat Pilooski	None
DirtyMadSound	None
Disagony	None
Discarga VS	None
Disco  Italo  reedits  Chicago House  DJ	None
Disco Ste	None
Disco floor	None
Disko Dario	None
Ditoska	None
Divalvi	house music
Dizco Joe	None
Dj	trap
Dj COBEIA	None
Dj Daparec	None
Dj DuArT	techno
Dj Estèphe	None
Dj Gibson Praise	None
Dj Girl	None
Dj Intec	None
Dj Kent	house music
Dj Mitch	None
Dj Mute	None
Dj Never Die	techno
Dj Notec	None
Dj POPULIST	None
Dj Plaza	None
Dj PorCus	None
Dj Reas	None
Dj Renato Broccini  Kei Ahnig	None
Dj S20	None
Dj Skaos all Night long	None
Dj Style	coverchill
Dj Volta	None
Dj Wutr3e	None
Dj fil	None
Dj girl & Flexibelle	None
Dj little & David Durango	None
Dj tsacK	None
DjPatrique	None
Djamency	techno
Djamin	None
Djazzy	disco
Djebali	techno
Djerry C	None
Djs	new jack swing
Djs Christo & Ramin	None
Djs La Foret	None
Djs Nik	None
Djs Ryan K	None
Djuma Soundsystem	techno
Doctor Dru	disco
Doctor Flake	downtempo
Dodobeatz	None
Dogukan ires aka Dodolove	None
Dolibox	house music
Dollar Mambo	disco
DomB	didgeridoo
Dominic	k-pop
Dominik	scorecore
Dominik Eulberg	techno
Don Camillo & Peppone	None
Don Diablo	house music
Don Malastas	None
Don Malastas B2B DJ Highman	None
Don Pino	None
Don Ramon	argentine reggae
Don Ramon  Cheeky Choice	None
Don Ramon  Friedas BÃ¼xe	None
Don Ramon  Friedas Büxe	None
Don Tetris	None
Don Tetris  subsTANZ	None
Donnacha Costello	techno
Doobious	None
Doppelpack	None
Dorian Paic	techno
Doris Stemmel	None
Dos Secondos	None
Dot	house music
Dottore	None
Dotz  Blacksheep  Brazil	None
Douala	None
Doublescore	None
Doublewave	techno
DoubtingThomas	rap
Douglas Andre	None
Douglas André	None
Douglas Greed feat Nagler & Kuss	None
Down by Concept	None
Down to the Bunker	None
Doze & Madink	None
Dr BARESCO	None
Dr Jones	tone
Dragon Suplex	None
Dre Skull	hip hop
Dread J	house music
Dream	rap
Dreksler & Haerle live	None
Dresden	classical
Driss	None
Drivepilot	uk garage
Drone Unknow	None
Dropout Agency	None
Dropout AgencySoundsystem	None
Dropout Rec	None
Drums Of Death	None
Drumsound & Bassline Smith	drum and bass
Dualism	techno
DubExMachina  Zürich	None
Dubbel Dutch	bassline
Dubfunk	techno
Dubokaj	None
Dubphone	dub
Dubspeeka	None
Duell	None
Duito	None
Dumb Unit  Berlin  Buenos Aires	None
Dumme Jungs	electro trash
Dunkelmuth	None
Dunkeltier	None
Duo Dumpf	None
Durdek	None
Durdek & Kubin	None
Durdek & Noromal	None
Durian Brothers	mandible
Duskid	None
Dyed Soundorom	techno
Dylan Casale	house music
Dylan Casale Ayeko Rec	None
Dylan Owl	None
Dyson C	None
Dysonc	None
Dzanin	None
DÃ¤ Kneter	None
Dä Kneter	None
Débruit	idm
Déepart	None
E Funker	None
EBONY BONES live	None
ECHOLOT Dub System	None
EClip	progressive psytrance
EDDIEKEY	None
EGÃ & SIMI	None
EGÜ & SIMI	None
EL DEAR	None
ELLEN SCHNEIDER live	None
EM&EM	hip hop
ENTLET	None
ENZO LO CONTE	None
EVA D	None
Earganic	None
East End Dubs	None
East End Dubs Moon Harboour	None
Ebony Bones	None
Echonomist Rotary Cocktail	None
Echoplex	techno
Eclectroplasm	None
Ed Function	None
Ed Luis	None
EddieKey	None
Edelstahl	techno
Edgar Jack	techno
Ednaski	house music
Eduardo de la Calle	dub
Eevy	None
Effortlessly balancing a will to experiment with an unwavering commitment to thefounding spirit of house	None
Egokind	house music
Egorythmia	trance music
EgÃ¼	None
Egü	None
Eigenwijs	house music
Einmusik	techno
Eintritt ab 18 Jahren	None
Einzelkind	techno
Einzig&Faerber  Miteinander	rap
Eisentanz	None
Ekkohaus	techno
El Diablo	None
El Kid and Ishan Sound	None
El Tigre	None
El Tigre Sound	None
Elastictrax	None
Electribe	None
Electric Minority	None
Electro Culture Records  Littlehouse Records	None
Electro floor	None
ElectroM	None
Electronic	new
Electrosexual	electronic rock
Elektro  TechHouse  Minimal	None
Elektro Guzzi	techno
Elektrobopacek	None
Elektrosized	None
Eli Vervain	None
Eli Verveine	techno
Elia Bösiger	None
Eliazar	techno
Elliver	None
Elly	None
Elos & Vegas	None
Elvis  Linaz  Kaspar Weiss  Syntosil  Space Works  Bildstoerung  VerInnerLicht	None
Elvis Cassetta	house music
Emanuele Inglese	None
Emanuele de Raymondi	None
Emely	None
Emil Berliner	house music
Emil Teiger	None
Emilie Nana	hip hop
Emilie Nana  Reas	None
Emill de Moreu	house music
Emmanuel Diffractive	None
Emmanuel K	None
Emmat	techno
Emre Bektas	None
Emre Bektas  Radio Moskau	None
Emre Bektas & Jaxon	None
Emre Bektas & Mouseen & Denny	None
Emre Bektas b2b Claudio	None
Endgame	None
Ensemble Economique	experimental psych
Ensemble Phoenix	None
Enzo Caprioli	None
Enzo Lo Conte	None
Enzo Lo Conte  TerraZza	None
Enzo Siragusa	techno
Enzo Siragusa Fuse  London	None
Eric Borgo	techno
Erik van Drumpt	None
Erika Fatna	None
Ernesto Ferreyra	techno
Ertu & Pushkin	None
Escape to Mars	None
Eskimo	metalcore
Esp Woody McBride Experience	None
Esperanto	None
Etienne Du Toit	None
Etienne du Toit	None
Eurokai	None
Eva D	None
Everest & Lcp	None
Everest on TT	None
Everstone	house music
Evi Beast	None
Evita	None
Exercise One Exone	None
Exploration	None
External Source	None
Extrastunden	None
Extrawelt	house music
Ezikiel	techno
Ezikiel  Cadenza extended	None
Ezikiel  Unite	None
Ezikiel  Unite Zürich	None
F	classical
FABELHAFT	None
FABIEN	None
FABIO & MOON	progressive psytrance
FABRIKTHEATER Sick Girls	None
FABRIKTHEATER Various Productions	None
FACE DESIGN	None
FALL	pop
FALL  SNTWN	None
FAUL & WAD AD	house music
FERDINAND WEBER	None
FERNANDO LEGÃERO	None
FERNANDO LEGÜERO	None
FERROX	None
FEUERHAKE	progressive psytrance
FIAT BUX & Le Citadin	None
FJAAK	None
FLESH	indie
FLORENTM	None
FLORIANO ALBERTINI	None
FLUK ENSEMBLE	None
FLUK ENSEMBLE EN FUMOIR	None
FLUX NEBULA	None
FOOL	None
FR	None
FRANCO FOLLE	None
FRANK C	folk
FRANTZ LORIOT	None
FRED LICCI	None
FREDDY Verano	house music
FS Bart	None
FaFa	None
Fabian Kozelsky	None
Fabiano	sertanejo
Fabien	None
Fabio Giannelli	techno
Fabio Guarriello	None
Fabio Gullone	None
Fabio Monesi	disco
Fabio Siverino	None
Fabio Tamborrini	disco
Fabio Zaccone	None
Fabr	None
Fabri	None
Facit	None
Fagins Reject	None
Fall	pop punk
Family Affair	None
Fango Packung	None
Fat Sushi	techno
Faust	classical
Favila & Valentine	None
Favila&Valentine	None
Feathered Sun	house music
Federico Molinari	techno
Fehlfunktion	None
Fehrplay	house music
Feldermelder	None
Felipe & Gusto	None
Felipe Puertes	None
Felix Kröcher	schranz
Feodor	deep opera
Fernando Costantini	techno
Fernando Soares	fado
Ferrari & Tomasi	None
Ferro	None
Festmacher	None
Fiat Bux	None
Fiedel	soundtrack
Fiji	polynesian pop
Fiji  electro pop live	None
Filastine live	None
Finn Johannsen	None
Finnebassen	house music
Fion 2000	None
Fish	punk
Fiume Junior	None
Flappers records	None
Flavio	channel pop
Flavius Tadeus	None
Flexibelle	None
Flexxi	None
Flighsh	None
Flight Facilities	disco
Flinke Finger	None
Flo	pop
Flo Kaufmann	None
Flohmi by Gilda	None
Floor 1	None
Floor 2 Föhn Wind of Music	None
Florent  M	None
Florian Hecker	idm
Florian Kaltstroem	None
Florian KaltstrÃ¸m & Emil Berliner	None
Florian Kaltstrøm & Emil Berliner	None
Florian Kunicke	None
Florian Kupfer	house music
Florian Meindl	techno
Florian Oberhauser	None
Florian Paetzold	house music
Flowbox live	None
Flying Circus	None
Flying Lotus	idm
Foolik & Pablo Einzig	None
Force of Nature	ambeat
ForecastHUN	None
Foreign Beggars	uk garage
Forest People Patrick Becker	None
Form	industrial music
Format B	house music
FormatB	techno
Fornax Void	None
Four Disturbed Civilians	None
Frag Maddin	disco
France	gypsy jazz
Francesca Lombardo	disco
Francesco Del Garda	techno
Francesco Rossi	rap
Francesco Tristano	microhouse
Francis Mallo	None
Francisco Meirino	None
Franco Bianco	techno
Franco Mento	hip hop
Francois K	house music
Frango	hip hop
Frango  Sirion Bern	None
Franjazzco	footwork
Frank Fonema	None
Frank Fonema & Al Emme	None
Frank Spirit  Bern	None
Frank Spirit aka Funk Bastard und Azul Loose Ties	None
Frank Storm	None
Frankfurt	None
Frankfurt am Main	None
Franz Bianchi	None
Franz White	None
François Antico	None
Frau Hug & Samsara	None
Fred HystÃ¨re	None
Fred Hystère	None
Fred Licci	None
Fred Linger	disco
Freddy K	techno
Fredi	None
Fredi B	None
Fredi Salomon	None
Fredi Salomon BunkerLe Local	None
Fredomat	None
Fredomat & Herr Mehr	None
Fredski	None
Fredy S	rock
Freiberg	None
Freiberg  Elektrostubete Bern	None
Frenchbreaks	None
Frenchwerk	None
Frenchwork	None
Fresh n Loud  SO	None
Freudenhaus	None
Freudenreich	None
Fri 2200  0600	None
Friendly Entry 25 CHF	None
FriendlyFire	None
Friends With Displays	None
Fritz Kalkbrenner	house music
Frivolous	microhouse
Fulldupblex live	None
Fulvio CalÃ 	None
Fulvio Calà	None
Fumiya Tanaka	techno
Fumuj	dub
Funk Bastard	hip hop
FunkinEven	rap
Funkstörung	idm
Funky Warmup inkl PingPongRundlauf	None
Fuse  Berlin	None
GABRIELA  Geneva	None
GATAN	None
GEORGE LAMELL	None
GESTALTUNG & PERFORMANCES	None
GIOMAR	classic peruvian pop
GL Everest	None
GOA FLOOR	None
GRÜNES BLAU	None
GS	None
GSN BE	None
GUS BE	None
GYMNASTYC	None
GaLaBar	hip hop
GaLaBar  WFmusik	None
Gablé	None
Gabriela	ambient
Gadjo Loco	None
Gag Smile	None
Gaiser	techno
Gallo	None
Galoppierende Zuversicht	None
Gangsta	None
Ganjaman LIVE	None
Garance	techno
Garance  Reas	None
Garance & diSoul	techno
Garibovic	rap
Garibovic  DefinitionMusic  WKND	None
Garlo	None
Gary Dex	None
Garçon	None
Garçon & Morard	None
Gaspard de La Montagne	techno
Gatasanta & Art Vega	None
Gaty Lopez	disco
Gavin Russom aka Black Meteoric Star	None
Gazelle Twin	fluxwork
Gecko  Secret Garden  Fribourg	None
Gecko Chamber	None
Geisha	None
Gel Abril	techno
Gelivan	downtempo
General Rush	None
Genf	None
Genève	None
Georg Stuby Naturklang  ZÃ¼rich	None
Georg Stuby Naturklang  Zürich	None
George Lamell	None
German Brigante  Get Physical	None
Germany	indie dream pop
Geronimo	opm
Get Physical	None
Get Physical  Barcelona	None
Get Physical  NL	None
Get Physical Amsterdam	None
Getting Any	None
Ghetto Blaster et Faute de Frappe	None
Ghost Box Film Retrospective	None
Ghost Engine	None
Ghoster	None
Gianluca Casnici	None
Gianni Callipari	rap
Gianni Milani	None
Gibraltar Vacuum	None
Gibraltar Vacuum live	None
Gichou	None
GigoloRomantico	None
Gill & Gill	None
Gill&Gill	country
Gin Tonic Soundsystem	None
Ginger Boss & Asian Eyez	None
Gio Red	None
Gion Gruenberg	None
Giorgia Angiuli	techno
Giorgia Anguili	None
Girl	mashup
Giulia Paradiso	hardcore
Giuseppe Cennamo	techno
Giuseppe Russo	None
Giusy S	None
Gleichschritt	None
Glen Porter	ninja
Gloria Bulsara	None
Gogo	jazz
Gold Finger Brothers	None
Golden Disko ship live	None
Golinski	None
Gomorra	techno
Goner	triangle indie
Good Groove records	None
Goodman	None
Gorge	house music
Goyav	None
Graf Olaf	None
Graf Olaf & Karl Gustav  Rina Lou  Thom Mayr	None
Gratis  Deep House  ab 1600	None
Gravina	techno
Gravitas Recodings  FR	None
Gray Chalk	None
Graze	None
Great Stuff	None
Green	rock
Greg Puppa	None
Gregor Tresher	techno
Gregorythme	techno
Gremino	house music
Greta Gratos	None
Grizzly	electronic rock
Group A	None
Guest	electronic rock
Guests	None
Gui Boratto	house music
Guido Möbius	None
Guillaume & The Coutu Dumonts	techno
Guillaume Delattre	hip hop
Guipei	None
Gunnar Guess	house music
Guti	disco
Guy From Downstairs	house music
Guy Gerber	techno
Guy Joshua	None
Guyus	uk garage
Gynesh Bakir	None
HAUS vol1	None
HELIOS & HESS	None
HFS Dub ECHOLOT Dub System	None
HIPOPULATION	None
HNQO	disco
HOBO	None
HOBO  mnus  Canada	None
HOFMANNSTRASSE	None
HOSH	deep
HUMAN ELEMENT	progressive psytrance
Hamburg	None
Hanfry Martinez	disco
Hang	new tribe
Hanne & Lore	house music
Hans Jung	techno
Hanz Beater	None
Hanz Beater   Tanz	None
Hanzbeater	None
Hard Coming Love	None
Hard Ton	None
Hard Ton Disco Queen	None
Hardly Booked	None
Harry Axt	house music
Harry Klein	None
Harvard Bass	house music
Hatcha	uk garage
Hatti Vatti	uk garage
He starts being a child With only 8 years and with a keyboard	None
Headless Horseman	shimmer psych
HeadmanRobi Insinna	None
Hecht & Zander	None
Hector	jazz christmas
Hector Couto	techno
Hector dMb	None
Heidi	country
Heidi  Get Physical	None
Heimlich KnÃ¼ller	None
Heimlich Knüller	None
Helder	techno
Henrique	sertanejo universitario
Henry Sure	None
Hepp	None
Hepp live	None
Herkul	None
Hermansson&Martinez	None
Hermine	None
Herr Mehr	None
Herr Mueller	None
Herr MÃ¼ller	None
Herr Müller	None
Herr Müller & Secondlife	None
Herr Vogel	None
Herr liebe	None
Herrrouine	None
Hertzz	None
Herva	techno
Hey O Hansen	None
Hieroglyphic Being	techno
HighLive	None
HighLive Miniload BS	None
Highgrade	jump up
Highgrade Disharmonic Orchestra	disco
Highgrade Rec	None
Hinde BE	None
Hinterhof	None
Hinterzimmer	None
Hinterzimmer Steve Cole	None
Hiss & Growl	None
Hive	indie poptimism
Hive Audio	None
Hive Audio  ag	None
Hive Audio Zürich	None
Hobbs	christian christmas
HobÃ© D	None
Hobé D	None
Hold Youth Paris	None
Homo Electronicus	None
Homopatik  Japan	None
Honey K	None
Honoree	techno
Horasse	None
Hosted by MC MrBison	None
Hot Creations	None
Hot Jam	None
Hot Since 82 Get Physical  Noir  Off Recordings  UK	None
House	None
Housedelivery	None
HpsyV aka Infinity LIVE	None
Hr Vogel	None
Hraach	house music
Huerco S	house music
Hug & Schiemann	None
Hugo Mendez	None
Human Element	progressive psytrance
Humangigz	None
Huzi Music live	None
Hyenah	house music
Hyrez	disco
I am Frost	techno
IDA	None
IF	rock
IKKI	electro trash
ILIOS	None
INCONTROL	None
INDOOR FLOOR	None
ISAbella Maison DEtre	None
IT	rap
Ian F	None
Ian Pooley	house music
Ianoo	None
Ibiza	house music
Iboga	None
Ich & Du  Kei Ahnig	None
Ida	None
Ida Daugaard	None
Idealist	ambient
Idealist Berg Audio	None
Idealistmusic	None
Idjut Boys	disco
Igor	classical
Ikonika	uk garage
Ilios	None
Ill77	None
Illesnoise	house music
Im Dunkeln	None
Im Holz	None
In der Sonne	None
Indian	electronic rock
Infinity Ink	house music
Infiné labelnight  Agoria	None
Infos	None
Inga Copeland	disco
Ingrid aka Adrian Bergmann	None
Ink	pop
Ink aka Nik	None
Ink aka Nik dj	None
Innervisions	None
Insane	rap
Insel	None
Installations	None
Integral and many more	None
Intro by Dineo	None
Iokoi	None
Iokoi & Aria	None
Ion Ludwig	None
Iphaze	dub
Isa Bazzgier	None
Ismail & Clive	None
Isolated Lines	techno
Istanbul  Berlin	None
Italo Business	None
Italy	None
Ittetsu	None
Ivan Alvarez	None
Ivan E	pop
Ivan R	None
Ivan Smagghe	rock
Ivo Christow	None
J Anderson	epicore
J Fab	None
J Kuhn	None
J055	None
JAM LA BAM	None
JANE FOX	None
JANN BRONNSKI	None
JAY SANDERS	techno
JEANFRANÇOIS LAPORTE	None
JOE VENDETTA & MARC NOUVELLE	None
JOHN LEMON	techno
JOKER	trap
JONES	trap
JOSEPHINE DE PARIS	techno
JOSHUA	pop
JOne	hip hop
JR	hip hop
JSayne	None
JSebK	None
JTijn	None
JUDITTA feat NOBODY NOSE live	None
JUTZI	None
Jabu	None
Jack & Juus	None
Jack & the Jerk	None
Jack Pattern	techno
Jack Scagnetti	None
Jack Slaughter	None
Jack Teck	new tribe
Jacqui	jazz christmas
Jacqui AKTIONSHALLE Joakim & the Ectoplasmics	None
Jade	new jack swing
Jaja	None
Jake the Rapper	house music
Jam Janiro	None
Jam Pesko	None
Jama Deejay	None
James Mc Hale	None
James Mc Hale  Tanzkarussell	None
James Mc Hale  Tanzkarussell  Bern	None
James Mc Hale  Tanzkarussell Bern	None
James Mc Hale & Luca de Grandis	rap
James McHale	None
Jamie Jones  Hot Creations  Crosstown Rebels	None
Jamie Lewis	house music
Jamie Shar & Liebkind	techno
Jan Oberlaender	None
Jan Penarrubia	techno
Jan Penarrubia  Offmind Records	None
Jani	None
Jann Bronski	None
Japan	idm
Jasi 158	None
Jauss	None
Javier Logares	techno
Javier Recarey	None
Jaxon	None
Jay Anderson	None
Jay Joe	None
Jay Phonic	techno
Jay Unique  Silk Events	None
Jayjoe	None
Jayjoy	None
Jazmin Ng	None
Jean Charles de Monte Carlo	None
Jean Charles de Monte Carlo  JCDMC	None
Jean Toussaint	None
Jeff	video game music
Jeff Bennett	None
Jeff Casoli	None
Jeff Casoli & Sandona	None
Jeff Mills	techno
Jeff Swing	techno
Jelipe JalapeÃ±o	None
Jelipe Jalapeño	None
Jen Morris aka sic	None
Jen Reimer & Max Stein Montreal	None
Jennifer Cardini	microhouse
Jens Bond	techno
Jens Lissat	techno
Jens Zimmermann	techno
Jensson	None
Jeremy De Koste	house music
Jeremy P Caulfield	techno
Jerks	punk
Jesaya	None
Jesse Nola	hip hop
Jesse Rose	house music
Jessica Diaz	None
Jessie	pop
Jestics	None
Jeudi Records	None
Jewl	None
Jichael Mackson	None
Jim Jupp & Julian House	None
Jimi Jules	rap
Jimi Jules & Kalabrese aka Jules & Spatz	rap
Jimi Jules Hive Audio  Bern	None
Jimmy Edgar	idm
Jmes Mc Hale	None
Joah & Pascal Inc	None
Joe Bless	None
Joe Claussell	hip hop
Johannes Heil	techno
Johannes Volk	techno
John Chantler	lowercase
John Daly	None
John Daly  Dollar Mambo	None
John Dimas	rap
John Donson  Elektrostubete	None
John Lemon	techno
John Lemon & CHRISTIAN  Darkroom	rap
John Lemon The Darkroom  ZÃ¼rich	None
John Lemon The Darkroom  Zürich	None
John Lokke	None
John Player	None
John Talabot	electronic rock
John Tejada	techno
John Wiese	noise
JohnLemon	techno
Johnny Bossco	None
Johnny D	techno
Jokari	disco
Jokari B2B Chapkmace	None
Joker	trap
Jolly Buoy	None
Jon Donson	techno
Jon Donson  Elektrostubete	None
Jon Gaiser	None
Jonas	pop
Jonas Blue	pop
Jonas Kopp	techno
Jonas Mantey	house music
Jonathan Brown	None
Jonathan Brown  Strange People	None
Jonathan Schwarz	None
Jonson	hip hop
Jools	post-disco
Joram	disco
Jordan Peak	disco
Jorge Doublescore Puertas	None
Joris Delacroix	house music
Jose Maria Ramon	techno
Jose Parra	cante flamenco
Josephine	cabaret
Josephine De Paris	techno
Joshua Jesse	None
José Parra	cante flamenco
Jstar	hip hop
Juan Atkins	techno
Juan Veloz & Friends	rap
Juen & Bach	None
Juiceppe	None
Julian Hansmeier	None
Julian Perez	techno
Juliano Lopez  Specimen  Crossworld record	None
Julien Aubert	None
Julietta	vapor soul
Jun Akimoto	hip hop
Jun Akimoto Fuse  Kyoto	None
Junction SM	None
Junior Boys	electronic rock
Junior D	pop
Juristik	None
Justin Fidèle	None
Jutzi	None
Jutzi & Don Tetris  subsTANZ	None
Jutzi B2B Don Tetris	None
Jutzi B2B Nicola Koch  subsTANZ	None
Jutzi b2b Maximilian berg	None
Juzz	disco
Jørg  Jon Donson	None
Jørg aka Jon Donson	None
K Chico	None
KACKMUSIKK	None
KAV VERHOUZER	house music
KBase	None
KD Music Pacha	None
KEJEBLOS	None
KER	None
KIF	None
KING AUTOMATIC	punk
KLOPFGEISTER	techno
KRISS FADER	None
KUBIN	None
KULARIS	progressive psytrance
Ka & Ge	None
Ka&Ge	None
Kabale und Liebe	techno
Kablam	fluxwork
Kadebostan	None
Kahn	None
Kai Alce	house music
Kaiser Souzai	house music
Kalabrese	microhouse
Kalabrese Orchestra live feat Khan	None
Kalamity Jo	None
Kalipo	electronic rock
Kami	None
Kamran Sadeghi	abstract
Kangding Ray	drone
Kano	uk garage
Kaos Panda	None
KaraMaehl	None
Karash LIVE	None
Karawan	None
Karera	None
Karim Samah	None
Karl Gustav	None
Karl Knatter	None
Karl Van Hinten	None
Karotte  Break New Soil	None
Karsten Pflum	intelligent dance music
Kartell	house music
Kate Simko	techno
Kate Simko Get Physical  LONDON	None
Kate Wax	techno
Kater Blau	None
Kater Holzig	None
Kater HolzigBerlin	None
KaterBlau	None
KaterMukke  Berlin	None
Katermukke	None
Katta	None
Kein	None
Kejeblos	None
Keks	ostrock
Kellerkind	house music
Kellerkind  Stil vor Talent	None
Ken Wan	house music
Ken Wan & Jeremy	house music
Kenel & Sonne	None
Kenel & Sonne Arche  ZÃ¼rich	None
Kenel & Sonne Arche  Zürich	None
Kengbang und Kelstroem	None
Kenhobiz	None
Kenneth Christiansen	None
Kenny	country
Kenny Ground	house music
Kens	deep gothic post-punk
Ker	None
Kerri Chandler	house music
Keränen	None
Kev the Head	None
Kevin Matthews	None
Khaderbai	abstract beats
Khainz	progressive psytrance
Khainz  Module	None
Khidja	house music
Khostic	None
Khruangbin	electronic rock
KiNK	techno
Kia Mann	None
Kiara Records Spain	None
Kibitz	None
Kid Konzoom	None
Kid Sublime	hip hop
Kid Wise	None
Kiev	shimmer pop
Kiki Bohemia live	None
Killernoizes	None
Kim Prevedello	hip hop
Kim Prevedello 22h at 2h	None
Kim Prevedello est un DJ dorigine cubaine qui allie musique électronique et rythmes traditionnels pour des	None
Kim Prevedelo	None
Kindimmer	techno
King Doudou	None
King Doudou aka Douster	None
Kink	techno
Kinky Beats	None
Kissogram	electronic rock
Klang Architekt	None
KlangKuenstler	house music
KlangfabriK	techno
Klangkarussell	house music
Klangkosmetiker	rock
Klangkünstler	None
Klara Lewis	fluxwork
Klaudia Gawlas	techno
Klaus	scorecore
Klaus Legal	None
Kleingross	disco
Klender	None
Klickhaus	None
Kling Klong	None
Klingande	house music
Klingande mit Live Saxophonist	None
Klute	drum and bass
Knobs	techno
Knor	None
Knotweed  CH	None
Knowbru Innocent Music	None
Knut und dAn from berne B2BSet	None
Knäckebröd	None
Kobosil	dub
Kode 9	hip hop
Kokenn	hip hop
Kollektiv KlangGut	house music
Kollektiv Turmstrasse	techno
Kolombo	house music
Kombé	None
Kompakt	None
Konk Pack	None
Konrad Dycke	None
Kooz	disco
Kopenhagen	None
Korek Percussion	None
Korsett	None
Kosen Prod	None
Kosen Prod  FR	None
Kotelett&Zadak	None
Kotra	disco
Koudlam	electrofox
Kowton	house music
Krankenzimmer 204	None
Kratermann	None
Kreisprozess	techno
Krenzlin	techno
Kreuzton	techno
Kris Wadsworth	techno
Kriss Toff	None
Kristian Davidek	None
Kristo	None
Krizzli	disco
Kruse & Nuernberg	disco
Krystal Klear	uk garage
Kuka	None
Kuki	None
Kultig & Cheers	None
Kumquat	None
Kun	None
Kurilian	None
Kurilian Kratz	None
Kurt Curtis Kienle	None
Kusaren	None
Kyle Venkman	None
Kyrill & Redford	groove room
KÃ¶lsch	house music
Kåre Kyl	None
Kölsch	house music
König Balthasar	None
Kühn	tunes
LA BAAZ	progressive psytrance
LA BIONDA	None
LA VITAMINA	None
LAD	disco
LADY BLACK SALLY	None
LAIKAN	None
LAILA M & OKIDOR	None
LAMPENFIEBER	None
LASSMALAURA Katerholzig	None
LAraignée au Plafon	None
LCP	None
LE PLAISIR DE VOUS FAIRE PLAISIR	None
LEFT	rap
LEISURE	None
LES POINTS  Nicola Kazimir  Louh  Barbir  Audino	None
LEVENTINO	None
LEZZ&LIZZ	None
LINE UP	None
LITCH	None
LIVE	world worship
LIVE  Bonaparte  Elektro Guzzi  Frivolous  Dimlite  Saalschutz  Air Cushion Finish  Be Swendsen  Digger Barnes  The Real Bronco	None
LIVE  HVOB	None
LIVE ARTISTS	None
LIVE Dapayk  Shackleton  Various Production  Robot Koch  Lur  Oliver Schories  Raz Ohara  Rizzoknor  Pilocka Krach  Kaltehand & Natasha Waters  Die Galoppierende Zuversicht  Digger Barnes	None
LIVE Einmusik	None
LIVE VISUAL ART BY PIXELPUNX	None
LIVEACTS	None
LJ Bacci	None
LJ Florent	None
LNF	hip hop
LSN	None
LU	cumbia
LUBÃMIR & CRANG	None
LUBØMIR & CRANG	None
LUCKY	rap
LUCKY LOOP	None
LYE	rock
LYNN JORDAN ECR REC LAURENT PHILLETTAZ	None
La B	None
La Bohème	rock
La Bombe	None
La Clandestine	None
La ForÃªt	None
La ForÃªt  TT  TONY DA	None
La Forêt	None
La Forêt  TT  TONY DA	None
La FÃ´ret	None
La Fôret	None
La Mibot et Foufoune délectricité	None
La Mine Express	None
La Ruche	None
La Ruchex1f	None
La Vie Cest Facile	None
La Vitamina	None
La pièce	None
Laboratoire	None
Lacrema	None
Lady Bar	None
Lady BarAcquaCabaretLove Tempo	None
Lady Boop	None
Ladybruce & Yaya	None
Lafayette live	None
Lagardere	hip hop
Laila M & Okidor	None
Lakuti	None
Lambock	None
Lamont Prince live	None
Lampenfieber	None
Lampert	None
Lando	techno
Laolu	techno
Lapsus	trance music
Lapsus Music	None
Lara Valentina	None
Lara aka BabaG & Cholon	None
Larcenist	None
Larry Gus	None
Larry King	None
Larry McMillen	None
Larrykoek	house music
Lars Moston	rock
Larytta	techno
Latenzzeit	None
Lauhaus	techno
Lauren Garnier	None
Laurent Bovey	hip hop
Laurent Charbon	hip hop
Lausanne	None
LausanneBerlin	None
LausanneZürich	None
Lautent Garnier	None
Lawrence English	ambient
Layfar	None
Lcp	None
Le Bleu du Ciel et les élèves de lEcole de Cirque	None
Le Centitme Singe	None
Le Chiffre	None
Le Citadin	None
Le Clou	None
Le Freak	None
Le Horla	None
Le Spectre	tekno
Le Voleur	None
Lee	country
Lee Burridge	house music
Lee Burridge  All Day I Dream	None
Lee Jokes	rap
Lee Jokes  Katermukke  OLARecords  DE	None
Lee Jones	folk
Lee Van Dowski	techno
Leftroom  Us	None
Lego	post-disco
Legowelt	techno
Lemonade	post-disco
Lemonick	rap
Len Faki	techno
Lennix	None
Lennix & Rocca	None
Lennix Music	None
LennixMusic	None
Leo	house music
Leo Gretener	dub
Leon	rock
LeonxLeon	disco
Les Alligateurs Boulots	None
Les Diplomates	None
Les Manchots	None
Les Mon Treux	None
Les Romanesques	None
Les Yeux Orange	disco
Les membres	None
Les voleurs de swing	None
Lesnicar	None
Lesničar	None
Lettus	None
Levela	jump up
Leventino	None
Lexer	house music
Lexx	rap
Lexy & KPaul	None
Liebe Detail	None
LiebeDetail	None
Life & Death	None
Light Motiv	None
Liittle Lu	None
Lila Hart	house music
LinG	None
Line up	None
Lineup Friday 12082011	None
Lineup Saturday 1382011	None
Lineup Saturday 1482010	None
Lineup Sunday 1482011	None
Lionel Early Sounds	None
Lionel Stephan D	disco
Lionel Stephan D aka little	None
Liquid Audio	None
Liquid Limbs live	None
Liquid Soul	progressive psytrance
Lissabon	None
Litch	None
Little Ernie	None
Little Helpers  London	None
Little Lu	None
Littlehouse rec	None
Littlehouse showcase  Genève	None
Liv Stone	rock
Live	christian christmas
Live Act	None
Live Bands Stage	None
Live Radioshow by Pierre Lewinsky	None
Live The Bullet	None
Live Visuals by DAZZLE	None
Live in Concert Los Yukas	None
Live on Stage	None
LiveVisuals on 3 Screens by BHD	None
Livio & Roby	techno
Lobi Rodio und Kelstroem	None
Loccomotion	None
Lolo & Romeo	None
London	classical
London Nebel	None
LondonBarcelona	None
LondonNYC	None
LondonNew York	None
Lonski & Classen feat Miranda	None
LooKee	None
Lopazz	techno
Loquace  Yamen & EDA	None
Lord Soft	None
Lorenzo Gangi	None
Lorik B2B Whim	None
Lorn	idm
Los Abstractos	None
Los Suruba	house music
Los Vacios de Charly	None
Los Wenamigos	None
Los dos	deep regional mexican
Lost Frequencies	house music
Lost Heritage	None
Louh	None
Louh Punkt  ZÃ¼rich	None
Louh Punkt  Zürich	None
Louie Austen Live	None
Louie Fresco	rock
Louis Brown	None
Louis De Fumer	None
Louis De Fumer  Electro Swing	None
Louis de Fumer	None
Lounge Techhouse	None
Lovataraxx	None
Love Matters  Berlin	None
Love Motel live	None
Low Jack	house music
Low Motion Disco	balearic
Lowrel & Hardy	None
Lowris	techno
Loïc Sottas	dub
LuLuxpo	disco
Luc G	None
Luc Gut	None
Luca Agnelli	house music
Luca Gerosa	None
Luca Parravicini	None
Luca Torre	techno
Luca Torre  Recycle records	None
Luca Vallante	None
Luca de Grandis	None
Luca de Grandis aka Der Schuft	None
Lucas Aliu	techno
Lucas MonÃ¨me	None
Lucas Monème	None
Lucerne	None
Lucidflow  Be	None
Lucy	indie
Lucy Railton	None
Lui Young	techno
Luigi Forte B2B Vellum	None
Luis Carvalho	None
Luis Cruz	None
Luis Hill	house music
Luiz & Winth	None
Lukas Kleesattel	techno
Lukatoyboy	None
Luke Miskelly	techno
Luke Redford	None
Luki	None
Luluxpo	disco
Luminator	None
Luna City Express  Moonharbour Berlin	None
Lutzenkirchen	techno
Luuki	None
Luzern	None
Lydia Sanz	None
Lynxbrothers	None
LÃ©o	None
LÃ´ & ACDJ	None
Léo	None
Lô & ACDJ	None
Löwenherz	None
MA	trap
MADE IN SWITZERLAND	None
MADESI	None
MAHMOOD	None
MAME	None
MANDY	pop
MANDY  Get Physical	None
MANDY  Philip Jung	None
MANFLY  MANDY	None
MANIEZZL	None
MANON	techno
MANU	rock
MANUEL VOCK	None
MANUHEME	None
MANUMAL	None
MARC MAURICE	None
MARCO Trinkler	None
MARCO Trinkler  Sunday Breakfast	None
MARCSMITH	techno
MARLA	None
MATHIAS STRAHLE	None
MATIJA	None
MATILDA	show tunes
MATTIÃ & AVA	None
MATTIØ & AVA	None
MAUA	None
MAUREL	house music
MAURIZIO	classical
MAXTER	None
MB Future	None
MC Drisco	None
MC GQ	None
MC Paps	None
MC Skywalker	None
MC Stone	None
MC2	None
MDMO	None
ME & her	rap
MES	quebecois
MF	hip hop
MF&Panadura	None
MFlava	None
MGF  ALL	None
MIA	electronic rock
MIA  Tanzkarussell	None
MIDIMAL	progressive psytrance
MIGUEL	hip hop
MIGUELANGEL	None
MILLIVOLT	None
MINITECHHOUSE FLOOR	None
MIRCO MENDOSTA	None
MISTA TRICK  SwingNBass	None
MInidetail artist	None
MMM	techno
MOB	hip hop
MOHORIZONS	None
MONSIEUR JUSTE	None
MR MIKE	rap
MRS JONK	None
MRZ live	None
MRux	rap
MT Dancefloor CLUBRAUM Utah Saints	None
MTA  UK	None
MURI	None
MUnited	None
MXR	None
MYSTICAL COMPLEX	trance music
Maaret	None
Maastricht	None
Maceo Plex	house music
Maceo Plex  Ellum Audio	None
Mad B  Du Lait	None
Madame Diva	None
Madfunk & Reas	None
Madmotormiquel	house music
Madnax	techno
Madteo	dub
Magda	techno
MahMood	None
Mahamaya	None
Maickel Esse	None
Mainstage	None
Makau & Kagl	rap
Make Plain	None
Makhno	hip hop
Mala	hip hop
Malente	breakbeat
Malik Sabotage	None
Malki	None
Mambo Chick	None
Man of Tomorrow	None
Manege 8  Berlin	None
Maniac Man	None
Manish	meditation
Mannequine	disco
Mannheim	christmas
Manojay and many others	None
Manolo	trap
Manon	techno
Manon  Desolat ZÃ¼rich	None
Manon  Desolat Zürich	None
Mantu	techno
ManuHeme	None
Manuel Fischer	None
Manuel Mind	None
Manuel Moreno	None
Many More	None
Many People	None
Mar Dean	None
Mara Trax	hip hop
Marc Antona	techno
Marc DArrigo	house music
Marc DArrigo & Simian Keiser	rap
Marc DArrigo b2b Guy Joshua	None
Marc DePulse	house music
Marc Fuhrmann	None
Marc Houle	techno
Marc Maurice	None
Marc Milner	disco
Marc Poppcke	techno
Marc Robert	None
Marc Vedo	house music
Marcel Bros	None
Marcel Fengler	techno
Marcel Vogel	None
Marcel Warren	None
Marcel Zeidler	None
Marcello Carozzi	techno
Marcism	None
Marco	grupera
Marco Adriano	brazilian gospel
Marco Bailey	techno
Marco Battagliero	None
Marco Berto	disco
Marco Capone	None
Marco De Rosa	house music
Marco Di Natale	None
Marco Hess	None
Marco Mendez	None
Marco Navarro	None
Marco Nea	None
Marco Repetto	None
Marco Repetto & Mastra Live	None
Marco Repetto live	None
Marco Serra	None
Marco Tegui	None
Marco Trinkler	None
Marco Vertoner	None
Marcus Meinhardt	house music
Marek Hemmann	techno
Margaret Dygas	dub
Maria Blessing	None
Mariano Mateljan	None
Mario Nyfeler	None
Mario White	techno
Mark Broom	techno
Mark Ernestus	fluxwork
Mark Fanciulli	disco
Mark Fell & Keith Fullerton Whitman	techno
Mark Henning	techno
Mark Off	None
Mark Seven	rap
Mark Steven	rock
MarkOFF	None
MarkOFF  Zurich	None
Markee	rap
Markese	None
Markko Mukke	None
Markova	opm
Markus Fix	techno
Markus Homm	techno
Markus Kenel	house music
Markus Kolz	None
Markus Lindner	techno
Markus Lindner  Cityfox	None
Markus Lindner  Stadtpark	None
Markus Lindner  Stadtpark  Cityfox Wien	None
Markus Steinhauer	None
Markus haZe	None
Marla	None
Marlaude	None
Marlowe	hip hop
Marner	None
Marosh Kopp	None
Marque Strawinsky	None
Marshall Jefferson	house music
Martin	house music
Martin Baur	techno
Martin Buttrich	techno
Martin Eyerer	techno
Martin Kleinert	None
Martin Landsky	techno
Martin M	None
Martin Meier	None
Martinez	pop
Marvel Lane	None
Marvin & Valentino	rap
Marvin J	None
Marwin	None
Mary C Jane	None
Mary Jane	funk
Masa	house music
Masaya	hip hop
Masaya Mina Rec	None
Masomenos	techno
Mass Prod	None
MassimilianoM	None
Massimo Brugnera IT	None
Massimo Stefanelli	disco
Massive Jay	None
Master Seb	None
Mastra	deep
Mastra live	None
Mat	pop
Matador	francoton
Mateo Morales	None
Materia	disco
Mathew Jonson	techno
Mathias & Andreas	None
Mathias Schaffhäuser	techno
Mathieu	None
Mathieu Barnaby	None
Mathon	None
Matija	None
Matt Grey	None
Matt Grey & Cos	None
Matt Star	techno
Matteo Arcucci	techno
Matteo Spedicati	techno
Matteo Spedicati & Alessio Mereu	rap
Matthew Burton	techno
Matthew Dekay	deep progressive trance
Matthew H	None
Matthew Herbert	house music
Matthew SQuare	None
Matthew Square	None
Matthias Tanzmann  Moonharbour	None
Matto	j-dance
Mattoo	techno
Matu	rock
Maurice Bateau	None
Mauro Picotto	bubble trance
Mauy	None
Mavi	None
Max	pop
Max Buchalik	house music
Max Cooper	house music
Max Del Principe	None
Max Durante	house music
Max Klebson	None
Max Meister	None
Max Parker	None
Max Power	None
Max Wanderer	None
MaxImHouse	None
Maximilian Berg	None
Mc Jerique	None
Me First and the Gimme Gimmes	punk
Meander  Nl	None
Meda	albanian pop
Meggy	disco
Mehhr	None
Mehhr & Beda	None
Mei ZhiYong	None
Meikel	techno
Mekanics	None
Mel Nagelbein	None
Mel Nagelbeint	None
Melania	None
Melchior	garage pop
Mellow D	bubble trance
Melokind live	None
Membrane	covertrance
Mendo	house music
Mensch & Muräne	None
MentalX	None
Mentor	None
Mercury	rock
Merkur  Japan	None
Meskal	None
Mess Me	electro trash
Metope	techno
Metropolitan parc	None
Metrotokyo	techno
Mia	electronic rock
Mia  Tanzkarussell Mulhouse	None
Micha Dutch	None
Michael Deep	house music
Michael Kaufmann	None
Michael Mayer	house music
Michael Pfiister	None
Michael Pfister	None
Michael Vonplon	None
Michal Ho	None
Michel Cleis	None
Michel van Dinteren DE  NL	None
Mickail	None
Micrometropolice	None
Midnight Operator	hip hop
Midnight Pulse	disco
Midéric	None
Miguel	pop
Miguel  Smalltown Collective	None
Miguel Campbell	disco
Mihai Popoviciu	house music
Mika Dutch	None
Mike Dyson	None
Mike Grieder	None
Mike Huckaby	house music
Mike Khoury	techno
Mike Machine	None
Mike Scoop & Bangokid	None
Mike Steez	None
Mike Teixeira	None
Mike Waulie	None
Mikkel Metal	techno
Mikrokosmos	None
Miky Merz	None
Milan	None
Millivolt	None
Milos D	None
MilosD	None
Mimanos	techno
Mind Against	techno
Mind Vortex	drum and bass
Mindfunk B2B DomK	None
Mindscape	drum and bass
Mini Bashekim	None
Minidetail  Lausanne	None
Minidetailx1f	None
Minilogue aka Sebastian Mullaert	None
Minimal	None
Mira	classical
Mira & Chris SchwarzwÃ¤lder	rap
Mira & Chris Schwarzwälder	techno
Mirco Caruso	hip hop
Mirco Esposito	None
Mirco Mendosta	None
Mirk Oh	None
Mirko Loko	techno
Mirko Loko  Cadenza	None
Mirko Molinari	house music
Mischkultur	None
Mismatch	None
Mismo	None
Miss Jools	techno
Miss Kittin	electronic rock
Miss Melera	techno
Miss Peel	None
MistaMista DJ	None
Mistamista	None
Mister Mola	None
Mit Spezial Acts leider dÃ¼rfen wir die namen noch nicht Publizieren da die Acts auf den Officiellen Streetparade Stages spielen werden und als surprise am abend noch bei uns feiern und auflegen werden	None
Mit Spezial Acts leider dürfen wir die namen noch nicht Publizieren da die Acts auf den Officiellen Streetparade Stages spielen werden und als surprise am abend noch bei uns feiern und auflegen werden	None
Mitikal	None
Mitsutek	techno
Mitura	None
Mixing up styles and moods	None
MoB	hip hop
Moan  Miami	None
Mobilee	None
Mobylette	None
Mobylette b2b Soivé	None
Mode of Motion	None
Model500 Live	None
Modern Love	None
Moe&Zard	None
Moezard	None
Molly	punk
MonblockB	None
Mondkalb	None
Moniak	None
Monkey Freakz	zapstep
Monkey Safari	deep
Mono  Weiss	None
Monokid & der Samtbody	None
Monoloc	techno
Monome	rap
Montagmorgen	None
Moomin	house music
Moon Harbour	None
Moosfiebr	techno
Morard	None
Morb	None
Mord	uk garage
Mord Fustang	uk garage
More	metal
Moresounds	hip hop
Morgan Button	None
Moritz Wettstein aka MRZ	None
Morphine records  live	None
Morris	country
Mosso	None
Mountain People	techno
Mouseen	None
Mouseen & Denny	None
Mouseen & Denny  Circle Of Love	None
Moussa	deep uplifting trance
Mousti	None
Move D	techno
Mr Egli	None
Mr Flazh	None
Mr G	None
Mr Jey Key	None
Mr Jonk	None
Mr Jonk & Schld	None
Mr Jonk B2B AARON JEHRO	None
Mr Klinger	None
Mr Nilson	None
Mr Peña	None
Mr Pigman	None
Mr Raoul K	techno
MrFake	None
MrLoathing	None
Mucho Stylez	techno
Mule & Man	None
Multitask	None
Munich	classical
Munken	None
Murat	turkish pop
Murciano	house music
Muri	None
Musique Large	None
Mutch	None
MxM	rap
My Daily Noise	None
My Digital Enemy	house music
My Panda Shall Fly	None
Myah	None
MÃ¤x Varano	None
MÃ¶ggli French Kitchen	None
Mátyás	None
Mäx Varano	None
Möggli French Kitchen	None
Mörk  CH	None
München	None
NACA	None
NATRON	brutal death metal
NEMO	neo-progressive
NERZ	None
NEWCOM	None
NEXOS	None
NHKKoyxen	None
NICOLAJ	None
NIK	rock
NIK & SOULT	None
NIKOLA KOTEVSKI	None
NL	house music
NS Kroo Sound System	None
NTFO	deep
NYC	beatdown
Nabin	None
Nabin & Sil B	None
Naca	None
Nacha	cantautor
Nachtstrom Schallplatten	None
Nader	techno
Nader  Partygarantie Zürich	None
Nadia aka Becky Slater	None
Naima	zouk
Nakadia	techno
Namito	house music
Nancy	rock
Nanodio	None
Naomi Bowler	None
Nash	folk
Nastia	None
Nat	christmas
Nata	None
Natalia	rock
Natch	techno
Natch & Ruben Coslada	rap
Nathan Fake	techno
Nathansbraten	None
Naturklang  Zh	None
Naturklang zurÃ¼ck mitten in der Stadt	None
Naturklang zurück mitten in der Stadt	None
Neamatiques	None
Nebukatz Nezar b2b Nicola Noir	None
Neek	None
Neevo	None
Nekow	disco
Nelson De Jesus	None
Nemelka	None
Nemo	neo-progressive
Nemo & Etienne Du Toit	None
Nemo & Etienne du Toit	None
Nenad J	None
Neo Mds	None
NeoMds	None
Never Die	None
New York	None
New York  Glasgow	None
NewCom CLUBRAUM Black Devil Disco Club	None
Ngoc Lan	vietnamese pop
NiCe7	house music
Nice try records showcase  Zurich	None
Nici Faerber	hip hop
Nici Faerber  Miteinander	None
Nici Faerber & Dani Nydegger	rap
Nici Faerber & Herr MÃ¼ller	hip hop
Nici Faerber & Herr Müller	hip hop
Nici Faerber Miteinander Musik  ZÃ¼rich	None
Nici Faerber Miteinander Musik  Zürich	None
Nick Curly	house music
Nick HÃ¶ppner	house music
Nick Höppner	house music
Nick K	None
Nick Nasti	None
Nick Warren	minimal
Nico Cano	None
Nico Canzoniere	None
Nico Faerber	None
Nico Mace	None
Nico Massa	None
Nico Massa & Elay	None
Nico Morano	disco
Nico Stojan	deep
Nico Stojan  Bar 25  Katermukke Berlin	None
Nicola Kazimir	rap
Nicola Kazimir & Audino	rap
Nicola Kazimir & LOUH  Punkt	rap
Nicola Kazimir Punkt  ZÃ¼rich	None
Nicola Kazimir Punkt  Zürich	None
Nicola Koch	house music
Nicola Koch  Amaro  Flavio Calzado  Corpataux  KlangFormer  Pedro Pereira	None
Nicola Noir	None
Nicolaj	None
Nicolas Duvoisin	disco
Nicolas Duvoisin & tsacK	house music
Nicolas Haelg	house music
Nicolas Ruiz	rock
Nicole Moudaber	techno
Nicolike	None
Niels Hesse	None
Nightshift	None
Nik	rock
Nik  Ink	None
Nik DJ	None
Nik Frankenberg	None
Nik dj	None
Niko Schwind	deep
Nikola Kotevksi aka Nick Nasty	None
Nikola Kotevski	None
Nikolas Wabe	None
Nils Fraser	None
Nils Fraser LIVE  Traumwerk	None
Nils Hoffmann	deep
Nima Gorji	techno
Nimm 2	house music
Ninette	None
Nite Jewel	fluxwork
Nkelo	None
Nkelo live	None
No J Rohrschacht	None
No Sikiriki & MC Extreem Bosnian	None
Noctambulo	None
Noir	chamber psych
Noir Music	None
Noise	None
Noisia	drum and bass
Noiz	dubsteppe
Nolè	None
Nolé	None
Nonsdrome	None
Nordstern  Basel	None
Nori	techno
Norm Talley	house music
Noromal & Durdek	rap
Noromal & Durdek & Kubin	rap
Norway	rock
Nouwah	None
Nova Heart live	None
Nu	kompa
Nukem	rock
Nummer	ambient
Nutek	None
OASE	None
OBF Sound System ft Shanti D	None
OCTAN	None
OFF Recordings  UK	None
OLA Rec	None
ONNO  UponYou	None
ORGON GROOVE	None
OUT OF ORDER	None
OUTDOOR FLOOR	None
OUTLAND	None
OWNO CH	None
Octave One	techno
OgeSoundsystem	None
OjiÃ©	None
Ojié	None
Okain	techno
Oktay	None
Okïn	None
Olafson	techno
Olga Korol	None
Oliver	house music
Oliver Aden	None
Oliver Aden & Luis Cruz	None
Oliver Huntemann	techno
Oliver K	hip hop
Oliver Klinghoffer	None
Oliver Koletzki	house music
Oliver Raumklang	house music
Olivier Kolly	disco
Ollin	None
Olstrïm	None
Om Unit	uk garage
Omen Accord	None
Ondrej	techno
Ondrej KUMQUAT	None
Ondrej Kumquat	None
One Circle	hardcore
Oneman bands	None
Onory  Serotonic	None
Onur Ãzer	techno
Onur Özer	techno
Optiv	drum and bass
Opuswerk	techno
Oram Modular	None
Oram Modular  Geneve	None
Ordinary Subject	house music
Osaka  live act	None
Oscar C	disco
Oscar Niczzo	None
Oscar Schubaq	techno
Oslo	orchestral
Osunlade	house music
Oszilot	None
Otist Riddim	None
Outdoor	None
Outstrip	techno
Oxalis	None
Oxsa	None
P Jones Karton  Amsterdam	None
P0gman	zapstep
PADOLINO	None
PANADURA	None
PASCAL DI BONGO	None
PASCI  Cheeky Choice	None
PASK	None
PAT PATRISHA	None
PAUL BART	disco
PBell	None
PBell  Christian Löffler	None
PEDRO & FELIPE	rap
PETER DIGITAL ORCHESTRA live	None
PETER STOFFEL	None
PETER STOFFEL Genève	None
PHIL ZVIEL & AFTER GRAUER	None
PHocto	None
PLO Man	None
PRO TONE	None
PROFILER	None
PSYCO	None
PTess	None
PUBLICIST	disco
PYLONE	electronica
PaTee & Maria Blessing	None
Pablo Bolivar	techno
Pablo Bordon	None
Pablo Color	None
Pablo Denegri	techno
Pablo Einzig	techno
Pablo Einzig Music  Miteinander	None
Pablo Mateo	techno
Pablo Nouvelle	house music
Paco	flamenco
Pad Beryll	house music
Padded Cell	balearic
Pailette	None
Palnoise	None
Pam & Mi	None
PanPot	None
Panause	None
Pandallougi	techno
Pandallougi & Jeremy Sunsets	techno
Pandour	None
Panorama Bar	None
Panoramabar ResidentBerlin	None
Pantha Du Prince	electronic rock
Paolo	pop
Papiro	None
Parabois	None
Parallel  Berlin	None
Paride Saraceni	None
Paris	uk garage
Partikel	dub
Pascal FEOS  Frankfurt	None
Pascal Greco	None
Pascal Hofer	None
Pascal Inc	None
Pascal Prosper	None
Pascal Thomson	None
Pascal Tokar	None
Pascal Viscardi	disco
Pasci	None
Pasci  Friedas BÃ¼xe extended	None
Pasci  Friedas Büxe extended	None
Pasci  Sandro KÃ¼hne  Bonny & Clyde  Love Cult	None
Pasci  Sandro Kühne  Bonny & Clyde  Love Cult	None
Paslesh	None
Pasquale C Peak	None
Pat	rap
Pat Heart	None
Pat Patrisha	None
Pat patrisha	None
Patee	None
Path	mathcore
Patric la Funk	None
Patricia Schmusekatze	None
Patrick	scorecore
Patrick Chardronnet	techno
Patrick Podage	groove room
Patrick Zigon	techno
Patrik Soderbom	techno
Patrique	None
Patrischa	house music
Patrischa Naturklang  Zurich	None
Patula	None
Paul Darey	techno
Paul Eg	techno
Paul Heimweh	None
Paul Mad	techno
Paul Van Dyk	trance music
Paul Woolford	house music
Paulette	None
Paulo	techno
Paulo César	brazilian gospel
Paulo César  Strange People	None
Paulo Diaz	None
Paulo Mota	None
Paulo Olarte	None
Pavel Plastikk	disco
Pavel vs Tiano Thomas	None
Paws live	None
Pazkal	house music
Peak	None
Pedro Pereira	None
Peggy Gou	house music
Pendler	None
Pennygiles UK	None
Pentaklon	None
Pepperpot	techno
Perfos	None
Peri&Para	None
Perle der Südsee SHEDHALLE Des Wahnsinns Fette Beute	None
Perlon	None
Permanent Triangle	None
Permanent Vacation  Italie	None
Permanent VacationDrumpoet Community	None
Perseo	None
Perto	None
Pet Conspiracy live	None
Petar Dundov	techno
Pete & Pete	hip hop
Peter D	techno
Peter Stoffel & Cobeia  Electronic boogie woogie action pack	None
Petre Inspirescu	None
Petrol Patrol	None
Pettinato feat Schwede	None
Peverelist	uk garage
Phala	None
Phantasm	None
Phantom Island	None
Phantomas & PAOLO	None
Phanton	None
Phil Farway	None
Phil Karg	None
Phil Riss & Ali C	None
Phil Riss b2b Ali C	None
Philip Bader	house music
Philipp Aregger	None
Philipp Strobel	disco
Philipp Weibel	None
Philippe Petit	techno
Phillygran	None
Phonica	None
Photomachine	bass music
Phrenetic	None
Phrex	None
Phucking Happyend	None
Pia Poke	None
Piemont	techno
Pierre & Jonathan	techno
Pierre Bastien	drone
Pig & Dan	techno
Pikaya	techno
Pillow Talk	techno
Pilocka Krach	rap
PingPongRundlauf	None
Pino	deep ccm
Pino Arduini	None
Pipol	None
Pit & Pat	rap
Pita	None
Pixelpunks	None
Pièrick	None
Piérick	None
Planet Vision	None
Plastic City Rec	None
Platinum	beats
Play & Prez	None
Play it Loud	None
Playlove	techno
Playpad Circus	None
PleasureLab	None
Pleasurekraft	techno
Plexo Solar Records	None
Plushgrizzly	None
Poker Flat	None
Pokerphil	None
Pol Wise	None
Pola	None
Polabdul	None
Polar Inertia	dub
Polaris	None
Polonium 8879	None
Polydance Djs	None
Pomelo	None
Portugal	rock
Posada	classic colombian pop
Pozzo	None
Praslea	disco
Praslesh	None
Praxis Records	None
Premiere Moby Disc Radio by Jørg	None
Premiesku	house music
Press C	None
PressC	None
Pretty Pink	disco
Primr aka Temiri	None
Prince	reggaeton
Princess P	None
Prism	None
Priss	None
Privilège Ibiza	None
Privée	None
Profiler	None
Profondo	None
Progenitor  LIVE	None
ProgressTunes	None
Progressive Trance	None
Projekt Gestalten	techno
Projektil	None
Proton	None
Protonica	trance music
Proudly People	techno
Proximo	None
Prurient	industrial music
PsYnesS	None
Psyberpunk	None
Psyche	electronic rock
Psyko	hardstyle
Ptess	None
Pujadub Operators	None
Punch Drunk Music	None
Pure Ground	None
Purple Disco Machine	house music
Pushkin	None
Pushkin Noize	None
Pye Corner Audio	techno
PÃ¤ge	house music
Päde	acousmatic
Päge	house music
Q&A with Bruno W	None
QUINTO ELEMENTO	regional
Qix	techno
Quarion	techno
Quartier Kruz CH	None
Quenum	techno
Quitim	None
Quitim & Massive Jay	None
Quivver	house music
R Ist Lieb	None
RABA	manele
RACKER	None
RAT	dancehall
RAWG	None
RBMA	None
RBMA  CH	None
REBOOT	techno
RHYTHM	rock
RINA LOU	None
RINO	rap
RINO  Cityfox	None
RINO  Cityfox Zürich	None
RIZZOKNOR live	None
ROCKTRONIC	None
ROLF IMHOF	None
RONT	None
ROOM 1	vocaloid
ROOM 2	None
ROSP	None
ROYAL FLUSH	hip hop
RSS Disco	disco
RUMORY	None
Rabih Beaini	mandible
Rabré	None
Racker	None
Radial	techno
Radio DRS Virus	None
Radio with Pictures	None
Rafael Anton Irisarri	ambient
Rafael Kleim	None
Rafaele Castiglione	house music
Rafeeq	None
Rafoo	None
Ragesh Nair	techno
Ragu  Whats House  SO	None
Rahaan	None
Raijin Gaijin	None
Rainer	techno
Rainer Weichhold	house music
Rainer Zufall b2b Streichholz	None
Ralf GUM	house music
Ralph Good	techno
Ramin	video game music
Ramon Lorenzo	None
Rampa	deep
Ramy Res	None
RamÃ³n	grupera
Ramón	grupera
Ran Salman	techno
Randall M	None
Randall M tINI & the gang  Orlando	None
Random Kid	None
Ranja&Eldo	None
Ranji  Blue Tunes Rec  Israel	None
Raoul	None
Raoul  Murg	None
Raphaello	None
Rapu & Nekow	None
Rapu & Nekow PRISMA Music  Zug	None
Rare Movement	house music
Rare Movement  JONNY N TRAVIS	None
Raum	folk
Raumfloor	None
Rauschkarft	None
Raw Records  CH	None
Raw Shan	None
Ray Okpara	techno
Raz Ohara	house music
ReChi	None
ReUP	None
ReYou	disco
Rearte	None
Rearte & Abdel Hady	None
Reas	house music
Reboot	techno
Recarey	None
Recondite	house music
Red Robin	None
Red pig flower	techno
Redshape	techno
Reggae Riot Sound	None
Relâche	None
Remote Area	None
Remute	techno
Remy Kersten	None
Renato Broccini	idm
Rennie Royma & Kare Kyl	None
Rennie Royma & Käre Kyl	None
Rennie Røyma	None
Rennie Røyma & Kåre Kyl	None
RenÃ¨ S	None
Renè S	None
Repos & Gabriel Stampfli	None
Resident dj	None
Resoe	techno
Resorted Recordings	None
Reto Ardour	techno
Reto Ardour  Hive Audio	None
Reto Ardour & Benja	techno
Reto Ardour b2b Dejan	None
Reverend BeatMan live	None
Reverse  LIVE	None
Revier	None
Revillo	None
Rex the Dog	electronic rock
Rheda Andrews Br  MatteoArcucci Ch  Fabio Guarriello It XLR Showcase	None
Rhythm Family Soundsystem	None
Ribordy Al Alcazar	None
Riccardo Farina	None
Riccardo de Cicco  Sal Capone	None
Rice & Beans	None
Rich Miles	None
Richie	soul
Richy Ahmed	house music
Rico OBF	None
Rico Rausch	None
Rico Roso	None
Rico Tubbs	breakbeat
Riki Ustrell	None
Riley Reinhold	None
Rina Lou	None
Rinaldo Makaj	disco
Rino	rap
Rino  Cityfox ZÃ¼rich	None
Rino  Cityfox Zürich	None
Rino  Marco Jefferson  Jon Donson  Baroz  Hanz Beater	None
Rino Cityfox  ZÃ¼rich	None
Rino Cityfox  Zürich	None
Rino Jay	None
Riotboy	None
Riparian aka Tommy Lexxus	None
Ripperton	soul
Ritter Butzke  Berlin	None
River Ist BÃ¶se	None
River Ist BÃ¶se  Amnesia	None
River Ist BÃ¶se  Requiem	None
River Ist Böse	None
River Ist Böse  Afterhour	None
River Ist Böse  Amnesia	None
River Ist Böse  Requiem	None
River Ist Lieb	None
Rizzoknor	None
Rizzoknor live	None
Ro&Mat	None
Ro&Mat  Tastefool	None
Roach	rap
Rob Tailor	None
Robby Naish	None
Robel	None
Robert Babicz	techno
Robert Curgenven	nu age
Robert Dietz	techno
Robert James	disco
Robert Piotrowicz	electroacoustic improvisation
Roberto De Carlo	disco
Robin Ivan	None
Robonaut	None
Robstar	None
Rocca	None
Rocco	disco
Rocco S	None
Rocket Van	None
Rocketnumbernine	None
Rockwool	None
Rodion	disco
Rodriguez Jr	techno
Roger M vs Sytec	None
Rogi	None
Rohan	techno
Rokka Animal Tschespito	None
Rolexx	None
Rolf Imhof	None
Rolf Saxer	rap
Romain Play	None
Roman Leonardi	None
Roman Stelzenbach	None
Romania	manele
Romano	country
Romano Rapeso	techno
Romero D	techno
Ron Morelli	house music
Rondel	None
Ronny Vergara	techno
Room 1 ambiance Deep Groove avec	None
Room 2 ambiance Tech Soul avec	None
Roots Panorama	disco
Rootystep Selecta	None
Roque le Char	None
Rosalinda	None
Rose&Ulysse	None
Rossko	techno
Rotkeller	disco
Rotterdam	None
Round Table Knights	house music
Roustam	techno
Royal Frass Club	None
Rozzo	techno
Ruben	tropical
Ruben Coslada	None
Ruben Shidozukuto	None
Rubinsteig	techno
Rudolf Eber	None
Rufus	electronic rock
Rumlaut	None
Rumlaut AFOXE	None
Rumory	None
Rumory AKTIONSHALLE Wighnomy Brothers	None
Rumpistol	ambient
Rumänien	None
Running Back	None
Rusconi	None
Russ Yallop	disco
Russell Haswell	idm
Russia	None
Ryan Clark	None
Ryan Crosson	techno
Ryan Crosson  Visionquest	None
Ryan Davis	techno
Ryan K	None
Ryan Mathiesen	rap
Ryoji Ikeda	idm
Ryuko	None
Ræve	house music
S	pop
S S S S	pop
SALVA DI NOBLES	None
SAM	country
SATINO	None
SDANKE aka Shaggy	None
SE Dzogchen Rinpoche	None
SENSE	None
SENSE  Basel	None
SENSUAL SQUEAK	None
SERKAN	german show tunes
SHADED	techno
SHAKA	techno
SHE Spells Doom	disco
SHXCXCHCXSH	techno
SILENT SPHERE	None
SIMINI	None
SIOPIS	techno
SIR JOE	None
SIS	rock
SKAI	disco
SKRYPTÖM  PARIS FR	None
SMART MONKEYS	None
SMOG  DE	None
SNES	None
SNTS	dub
SOKRATES	None
SOLEE Parquet Recordings	None
SOLOK	None
SOMNE	depressive black metal
SONIK	None
SPIF	None
SPITFIRE	techno
SPREEDELAY Katerholzig	None
SRANGE	None
SSDSS	None
STEPHANE DONOVAN PUPILLO	None
STYRO2000	None
STwo	vapor
SUMO	None
SUPERLIVE live feat Andaloop	None
SUSPECT ONE	None
SVARTVIT	None
SVENSKJ & TALIB	None
SYMBIZ live	None
SYMPHONIX	techno
Sa	None
Sabb	deep
Saben	None
Saben  Whats House  SO	None
Safari & Zielony	techno
Saint Peak	None
Saint WKND	house music
Salar	persian pop
Salon	rock
Saltaux	None
Salvatore Freda	techno
Salz&Pfeffer	None
SalzuÃnPepper	None
SalzuÛnPepper	None
Sam Binga	hip hop
Sam Divine	house music
Sam Feldt	house music
Sam KDC	drumfunk
Sam Paganini	techno
Sam Seven	None
Sampayo	None
Sampras	None
Samsara	retro metal
Samuel Angelo	None
Samuel Kerridge	mandible
Samuele	None
Samuri	rap
Samy Lee	None
San Marco	deep orchestral
San Marco  Cheeky Choice	None
San Proper & D Live	rap
Sandora	None
Sandro	None
Sandro Kuhne	None
Sandro KÃ¼hne	None
Sandro KÃ¼hne b2b Marco Trinkler	None
Sandro Kühne	None
Sandro Kühne b2b Marco Trinkler	None
Sandro Sincero	None
Sandro Vitalini	None
Sandro ZH	None
Sandsturm	None
Sandy Rivera	house music
Santis	techno
Santorini	techno
SantÃ¨	deep
SantÃ©	deep
Santè	deep
Santé	deep
Sarah	pop
Sarah Main	house music
Sarard	None
Sarna	techno
Sascha Braemer & NiconÃ©	house music
Sascha Braemer & Niconé	house music
Sascha Cawa	house music
Sascha Dive	techno
Sascha Sonido	house music
Sascha Stohler & Arnstroem	None
Saschienne	microhouse
Sasse	techno
Sassy J	fake
Sat 2200  0700	None
Satanic Surfers	punk
Satino	None
Satori	house music
Saturday to Sunday	None
Saved Records	None
Sayan	dub
Scarlett Etienne	rap
Schaffner	None
Schall & Rauch	None
Sche Sche	hip hop
Scheibenkleister	None
Scheinwerferli	None
Schimpy	techno
Schlammpeitziger live	None
Schld	None
Schmerol	None
Schmerol & Andreas Ramos	None
Schmerol Baked  ZÃ¼rich	None
Schmerol Baked  Zürich	None
Schmitz	None
Schnautzi	None
Schuhmacher	techno
Schwarzlicht	None
Scott Ferguson	house music
ScottyA	None
Scout Klas	None
Scrap & Jimi Jules	None
Scum	horrorcore
Seb Blake	disco
Seb Zito	techno
Sebas O Verde	techno
Sebastian Bosco	None
Sebastian Mullaert & Ulf Eriksson	techno
Sebo	house music
Sebo K	techno
Sebo K  Mobilee	None
Secret Guest	None
Selador	None
Selim & Armin	None
Selim&Armin	None
Sell Sander	None
Senator	None
Sender	progressive uplifting trance
Senking	microhouse
Sensient	psytrance
Sentiment	None
Senyawa	None
Senzen	None
Sequenzheer	None
Serafin	opera
Serafino	None
Sercan Demir aka Seco	None
Sergio DAngelo	None
Sergio Dream	None
Sergio Martella	None
Sergio Mesa	None
Sergio Trillini	None
Seteve	None
Seth Troxler	techno
Seth Troxler  Visionquest	None
Seuil	techno
Sevenstyler	hip hop
Several Definitions	house music
Severin  Karera Rec  SO	None
Sexbeach	None
Shaalan	None
Shabba	reggae
Shaddah Tuum	None
ShadesAtNight DJs TBC	None
Shadow Rec	None
Shaggy	pop
Shahira	None
Shaka	techno
Share	deep canadian indie
Sharon	soul
Sharon OLove	None
She DJ Nathalia	None
She DJ Panadura	None
She Jubilee Dj	None
She Nionika	None
Shingo Suwa	hip hop
Shiro Black  Gun PWDR	None
Shonky	techno
Shovell	None
SiMo	house music
Sickerman live	None
Sid Le Rock	hip hop
Side Effects	progressive psytrance
Sidney Charles	techno
Sidney Dry	None
Siegwart	None
Silat Beksi	None
Silent Rabbit	None
Silvan und Stephi	None
Silvision	techno
Simian Keiser	None
Simian Keiser & Marc DArrigo	rap
Similar Disco	None
Simoki	None
Simon Baker	techno
Simon Kwe	house music
Simon Lemont	None
Simon Slice aka Khainz	None
Simple	pop
Simplicity	christian relaxative
Simya & Grobi	None
Sinkane	None
SinnRd	None
Sinner DC	techno
Sinner DC & Jacen Solo	techno
Sinner DC & Spectrum aka Sonic Boom	techno
Sinneswandel	None
Sinneswandel  Berlin	None
Sinneswandel  ZH	None
Sins	None
Sins  WFmusik	None
Sins  wfmusik	None
Sinsonic Records	None
Sinusite	None
Sir Sway	None
Sirion  CH	None
Sirion Rec  Be	None
Sirion Records	None
Sirion Soundsystem	None
Sirion rec	None
Sis	disco
Sisyphos	None
Size	drum and bass
Skail Master M	techno
Skaos	ska
Skinner	None
Skor	hip hop
Skrizza	None
Skudge	house music
Sky & Ezikel	None
Sky Janssen Ezikiel	None
Skyr	None
Sleek aka Liquid Soul	None
Smalltown Collective	house music
Smallvile  Francfort	None
Smokey Joe and the Kid	electro music
Snowman	None
Snuffo	None
Snur	None
So	emo
SoSSoundz of SunElektrisch	None
Sobuth & Weiss	None
Social Disco Club	balearic
Sofa Tee	None
Softy	None
Sofus Forsberg	disco
Soivé	None
Solaris	rock
Solid	None
Soloduo	classical guitar
Soma	post-screamo
Somogo	didgeridoo
Somtek	idm
Soner  Lost In Noise  SO	None
Sonic Cube	progressive psytrance
Sonica	rock
Sonik	None
Sonja Moonear	None
Sonny Catanese b2b Lucas Ramirez	None
Sonny Fodera	house music
Sonodab	techno
Sons of Aoide	None
Sopha	None
Sordo	None
Soukie & Windish	deep
Soul Clap	disco
Soulmate Inc	None
Soulnotes Rec	None
Soult	None
Sound	None
Sound Nomaden ft MSP	None
Sound Pellegrino  FR	None
SoundSow	None
Sounds of Earth	None
Soupape	None
Sous Sol	rap
South Africa	None
Soweso Rec	None
Space	idm
SpaceK	rock
Spacebox720 live	None
Spain	None
Spanks	None
Spartaque	techno
Spatz Habibi	None
Special Guest	None
Special Guest  Gunnar Stiller	None
Special Guest  Sable Sheep	None
Special Guest ANNA NAKLAB	None
Special Guest TBA	None
Special Guests and Surprises	None
Special Visuals	None
Specialivery	techno
Spectral Mirror	None
Spellbound DJs	None
Spice 52	None
Spiegelbild	None
Spielplatz Helden Basel	None
Spint Twist	None
Spitfire	techno
Spoek Mathambo	None
Spooky Dolls Surgery et Royale Georgette	None
Sproute	None
Spruzzi	None
Squep	techno
Squirrel	jazz christmas
St Plomb	None
StPaul	None
Stadtpark	None
Stalker	None
Stan Starry	None
Starting Teeth	nerdcore
Startos	None
Static Movement	progressive psytrance
Stationfloor	None
Stavros	rock
Stefan Nolic	None
Stefan Nolic Naturklang  ZÃ¼rich	None
Stefan Nolic Naturklang  Zürich	None
Stefano Di Miceli	None
Stefano Loat	None
Stefano Rinaldi	None
Stefano Ritteri	None
Stefano rinaldi	None
Stellar OM Source	hauntology
Stellina	None
Stenchman	uk garage
Stephan Bodzin	techno
Stereo Express	house music
Stereo Riders & DJ Big B	None
Stereociti	house music
Steve Bug  Pokerflat Berlin	None
Steve Ewards	None
Steve OSullivan	techno
Steve Summers	house music
Sthepan Esse	None
Sticka	None
Stiglitz & Bernstein	None
Stil & Taktvoll	None
Stil vor Talent  Berlin	None
Stilbruch	None
Stimming	techno
Stimulus	None
Stino Stallone	None
Stipe	disco
StipÃ©	None
Stipé	None
Strahlemann & Töne	None
Stratos	house music
Stray	deep new americana
Strb	None
Strb  Tissu	None
StromKreis	None
Strotter Inst	None
Strumberg	None
Stu	indie
Stube Hosted By	None
Styro	None
Styro 2000	None
Styro2000	None
Styx Recordings  UK	None
Suara	j-dance
Sub Bros	None
Sub Zero	hardstyle
SubCulture	escape room
Subban	None
Subban b2b Adam Shelton	None
Subjected	dub
Substream	None
Such a Serge	None
Suddenly Neighbours	None
Sun Afterhour 1300  2100	None
Sunday to Tuesday morning	None
Sunman 130bpm	None
Sunset Handjob  Halle	None
Super Flu	house music
Super Flu decksnfx	None
Superlounge	house music
Superlover	house music
Supernova	techno
Superposition DJs	None
Supersymmetrie	None
Support CGibbs	None
Support Credo	None
Support OUS Label Night mit BITTUNER	None
Support by Mirk Oh	None
Supported by TEZ CADEY	None
Supprt DJs	None
Sur le pont 18h  22h	None
Suschi	None
Susie Star	None
Suspect One	None
Suspect One  Definitive Rec	None
Sutekh	microhouse
Sutsche	None
Svan	None
Sven Dohse	rap
Sven Wittekind	schranz
Svenskj	None
Svenskj & Talib	None
Svkre & Slodowsk	None
SweetnCandy	None
Switchbox	None
Sybille Jeans	None
Sydney Dry	None
Symbiotique	None
Synin	None
Syntosil	None
System  UK	None
Systematic	grunge pop
Systematic  PARIS	None
Sören Klanken	None
T Raumschmiere	hip hop
TAT vs Ozexia	None
TBA	techno
TBass	None
TCF	None
TEDDYson	soca
TEKNOSTAR	None
TEMPO Moderno	None
TERRY PARDINI	None
TG	country
THE CLEMENTIMES	None
THE FREEMASONS	screamo
THE MICRONAUT	None
THE RICH MANS KITCHEN ORCHESTRA	None
THE RIDDLER	None
THE TRASHFORMERS	None
THEY LIVE	None
THOMAS P HEKMANN	None
TIGR TIGR TIGR	None
TOM GROOVE	None
TONIC	rock
TRIPLE AGENT	breaks
TROPICAL CONTINENT SOUNDSYSTEM feat DJ Rumory	None
TROUBADOUR	None
TRUE LIES	progressive psytrance
TRiKOS b2b Lucas Vogt	None
TUNED	None
TUSSLE	None
Tabis	None
Tableturner Duo	None
Tadeo Doberska	house music
Tagedeep	None
Taiki Nulight	doujin
Tale Of Us	techno
Tale Of Us  Crosstown Rebels	None
Talin	None
Tallo	None
Tama Sumo	house music
Tamed Musiq	None
Tanua	techno
Tanzbär	None
Tanzbären	None
Tanzmuster	None
Tap Tap	comic
Tapes	ambient
Tapesh	house music
Tarab	lowercase
Tarco	None
Tarotkarten legen mit Señor Deckshark aka János	None
Tashi Luis	disco
Tashi Noir	None
Taucher	bubble trance
Taylor Cruz	None
Tec Jones	disco
TecJones	disco
Technasia	techno
Techno	None
Techrifice	None
Tee Moe	None
Teenage Mutants	house music
Teenager in Love	None
Tek Jam	None
Tekamolo dj	None
Teknopunx	None
Teknostar	None
Temiri	None
Tempa	uk garage
Tempa  UK	None
Terasun	None
Terazzza	None
Terence Terry	None
Terminal M	None
Terminal M ZH	None
Terramossi	None
Tevor Handa	None
Tha Trickaz	trap
Thales	None
The 2 Bears djteam	None
The Alchemist	hip hop
The Analog Roland Orchestra	disco
The Bassment	None
The Birthday Girls	None
The Bullet	None
The Circle Corner	None
The Club by Point Bar et TFT Events présentent	None
The Cruzaders	rock
The Cruzaderss	None
The Dean Soniks	None
The Emperor Machine	balearic
The Essentials	None
The Gaslamp Killer	idm
The Hacker	electronic rock
The Joy Boys	rock
The Killers Rabbits	electro trash
The Kooky Scientist	techno
The Last Place	None
The Legendary Reggae Riot Soundsystem	None
The Local Yocals	jungle
The Lovers	preverb
The National Fanfare of Kadebostany live	None
The Nutcrusherz	None
The Pixel	None
The Rah	None
The Rich Mans Kitchen Orchestra	None
The Skatalites	ska
The Sonic Catering Band	None
The Sorry Entertainers	techno
The Stereo Youth	None
The Streets	uk garage
The Subways	rock
The Teledubbies	None
The Upbeats	drum and bass
The Weaponstore	None
The Young Gods	experimental
The ground floor	techno
TheAlchemist	None
Thibault & Fab	None
Thierry Charollais	None
Thom	None
Thomas AS	None
Thomas Kudrna	None
Thomas Luke	None
Thomas Melchior	None
Thomas Peter	classic soundtrack
Thomas T	disco
Thomas Zopf	None
Thomtraxx	None
Throwing Snow	uk garage
Thug Entrancer	vaporwave
Tiago Cortez	None
Tiano Thomas&Pavel Prince	None
Ticon live	None
TiefenRausch	euroska
Tiefglanz	None
Tiefschwarz	techno
Tigerskin	techno
Tigris  Voodoo Industries	None
Till von Sein	techno
TillTape	None
TillTape b2b Gray Chalk aka Colliding Fields	None
Tillhelm Well	None
Tim & Puma Mimi	rap
Tim Exile	hardcore
Tim vs Osama	None
Time In Motion	progressive psytrance
Time Passager	None
Timmy K	None
Timnah Sommerfeldt	None
Timon Christen	None
Timoteo	sertanejo tradicional
TinTin	house music
Tina Frank	None
Tino Kaufholz	None
Tiorted	None
Tissu	None
Titonton Duvante	techno
Titto La Rocka	None
Titto la Rocka	None
ToBe	None
Tobi Dreipol	None
Tobi More	None
Tobi Neumann	house music
TobiWAN Kenobi	None
Todd Bodine	rock
Toi Toi	None
Tokyo	electronic rock
Tokyo JP	None
TolisQ	techno
Tom & Cherry	None
Tom Alemanno	house music
Tom Clark	house music
Tom Kaiser	None
Tom Novy	house music
Tom Wineman	None
Tom Wineman  Pleasurelab BNC	None
Tom Wineman b2b Maurice Bateau	None
Tommy four SevenPerto	None
Tomvson	None
Tomy Gips	None
Ton In Ton	None
Tonbohrer	None
Tonic	rock
Tony  Smash FX	None
Tony Gomez	None
Tony Nocera	None
Tony Smash FX	None
Toolroom  UKUSA	None
Torsten Kanzler	schranz
Touching Music  New York	None
Towby Freytag	None
ToxinOhm	None
ToxinOhm BE	None
Tr3lux	None
Trabant	icelandic pop
Tralala floor	None
Traumer	None
Traumtief	None
Tre Rose	None
Tre Rose Bros	None
Treatyourdjright	None
Treibstoff	None
Tremendo	house music
Tremendo  Glam  Whats House  SO	None
Tresor foreplay Berlin	None
Trigger	None
Trik	rap
Tristan Bohn	None
Tristan Bohn  Neon	None
Tropical Blue Master Clash	None
Trouble Maker	k-pop
Troy Pierce  Items & Things Berlin	None
Tryal	None
Tschechno	None
Tube & Berger	deep
Tuccillo	techno
Tunay Can	None
Turbulent DJs	None
Turistica	None
Two of a Kind	None
TÃ¼rÃ¶ffnung	None
Türöffnung	None
UA	disco
UBIK Sound System	None
UK	zapstep
UNDFND	None
URSL	None
US	pop
USA	None
UVB	dub
Uhuruku	None
Ulli & Maesoo	None
Ultra Planète	None
Umami	house music
Umberto	None
Unborn  FR	None
Underclownd	None
Underground Quality	None
Underground Resistance	techno
Uner  Kelllerkind  Jon Donson  MIA  Luca de Grandis  James Mchale	None
UniT	rap
Universalfilter	None
Urban Junior	garage punk blues
Urbanbassic	None
Ursprung	None
Ursprung b2b XEED	None
Usa	None
Ushuaia Ibiza	None
VAISHIYAS	progressive psytrance
VANA&TOBE	None
VANBERGER	None
VD	None
VENI VIDI VJ  httpwwwvenividivjcom	None
VIP FLOOR	None
VISUALS	None
VIVEK & Dego Ranking	uk garage
VJ & Surprise Guest	None
VJ La Destr	None
VJ Mathias	None
VSK	oshare kei
Vadim Svoboda	None
Valentin Boesch	None
Valentin Bösch	None
Valentino	rap
Valentino Kanzyani	techno
Valgeir Sigurðsson  Paul Corley  Nadia Sirota  Liam Byrne	None
Vamos Art	rap
Van Erpen	None
Van Erpen & Tiffany	None
Vanilla Ace	hip hop
Vanita	rap
Vanita  Rave Of Love	None
Vanita Hive  Zurich	None
Vanita&Shima	rap
Vanja	None
Vario Volinksi	None
Varoslav	techno
Vasco	None
Vasy	None
Vegas & Bazhi	None
Velocidad	disco
Ventil	None
Vera	deep australian indie
Vera Perlon  Berlin	None
Vertoner	None
Vessel	vapor soul
Vibramacz rec	None
Vibronics	dub
Videsad	None
Vijen Arman	None
Viken Arman	deep
Villa Bosso & Douglas André	hip hop
Vinc Vega	None
Vinyl Guerilla	None
Vinz Vega	None
ViperSwingm Spacek & Funky Chap	None
Virginia	disco
Visionquest	techno
Visual	None
Visual  Vj Mus	None
Visuals & Deko Pixel	None
Visuals & Deko by PIXEL	None
Visuals Videsad	None
Visuals by  MN	None
Visuals by  Veni vidi vj	None
Visuals by Gertrude Tuning & Pamela popo	None
Visuals by LOON	None
Visuals by Lisa Laser	None
Visuals by Litemotif Crew	None
Visuals by Palnoise	None
Visuals by Timowoodtv	None
Visuals by TmowoodTV	None
Visuals by VJ Bad Chance	None
Visuals by VJ Luna	None
Visuels Rocco S	None
Vitek	None
Viva Music	None
Vj Marina	None
Voice  Music Artists	None
Voigtmann	house music
Volkan Ocak	None
Volkan Ocak & Claudio	None
Volkan Ocak b2b Claudio	None
Volta Cab	house music
Voltec	None
Voltec  Flavius Tadeus	None
Voltmar	None
Von Allmen & Shawn Cloud	None
Voodookid	None
Voodookit	None
Vornehm&Unsittlich	None
Vox Low	None
Voyeur	house music
Vto	None
WADE	country
WANDERN mit BRONKO live	None
WF presents	None
WILD PICH	None
WILDLIFE	electroacoustic music
WILLI P	None
WIS	None
WLVS	None
WOLF	vapor twitch
WT Records	None
WTF	None
WaLT	None
Waldherr	None
Waldvogel	None
Walter	blues
Walter Albini	None
Wandervogel	None
Wandler	techno
Wandler  Cityfox	None
Wandler  Cityfox Zürich	None
Wandler & Styro2000	techno
Wankelmut	house music
Wareika	techno
Warp	antiviral pop
Wasabidelux	None
Wasabideluxe	None
Washerman	disco
Wasted Ruffians	house music
Watergate Records	None
Wavi	None
Wax de Molf	None
WeDoReMiX	None
Wedernoch	None
Weith	None
Weltenbummler & DeFeckt	None
Wen	mandopop
Wenotme  Maria blessing Oliver Aden & Luis Cruz	None
Wenzel Dashington	None
Whim	techno
White Wall LIVE	None
Whiteside	None
Wicked Wilma	None
Wien	None
Wild & Surf	None
Wilkinson	house music
Will Saul	house music
William Bennet	None
Winkel  VintageMöbel	None
Winner DJ Battle	None
Wittwe Meier & DÃ¶rte	None
Wittwe Meier & Dörte	None
Witwe Meier	None
Witxes	techno
Wla Garcia	techno
Wobble Lovers	electro trash
Wohnzimmer	None
Wolf  Lamb	hip hop
WolfLamb	hip hop
Worakls	deep
Worakls band	None
Work in Progress	None
Wuzz TÃ¤zz Boyz	None
Wuzz Täzz Boyz	None
Wyla	hip hop
WÆV	None
XCESS	None
XDB	dub
XV Kilist & Rocco	None
XYconstant	house music
Xenia Beliayeva	None
Xeno	electronic rock
Xhin	dub
Y&Y	reggaeton
Yan Bing	None
Yan Cook	techno
Yan Stricker	techno
Yanac	None
Yang Bing	techno
Yann Detroit	None
Yann Stricker & Juan Baeza	None
Yannick Müller	None
Yannick Robyns	None
Yannik Müller	None
Yapacc	techno
Yesin	disco
Yetti Meißner	None
Yoneda Lemma	None
You	emo
Youen	None
Young Echo	None
Ypsilon	None
Yvan Genkins	techno
Yves CavaliÃ©	None
Yves Cavalié	None
Yves Helbling	None
Yves Helbling  Beyond	None
Yön10	None
ZGroove	None
ZH	None
ZIDEKICK	None
ZILOUB	None
ZOZ	None
Zachov live	None
Zaikadelic	None
ZanoP	None
Zanop	None
Zayonne	None
Zenker Brothers	None
ZentroN	None
Zenzile	dub
Zero	downtempo
Zero b2b Razha	None
Zest	techno
Zest All Night a long	None
Ziloub	None
ZinK	None
Zip	house music
Zombie Disco Squad	house music
Zoo	None
Zouaoui	None
Zurich	None
Zustra	None
Zweikommasieben	None
Zweitraum	None
Zwicker decksnfxnvox feat Nina Klingele	None
Zwillingsmann	None
ZÃ¤hler & Nenner	None
ZÃ¼riPistolPete	None
ZÃ¼rich	None
Zähler & Nenner	None
ZüriPistolPete	None
Zürich	None
Zürich  DJ	None
Zürich  live act	None
a microphone & a roland Space Echo re201	None
adimatique	None
adlib	techno
afro disco	None
akuarium33	None
all Night long	None
and many more	None
and many more Danny soon realized that his future lay inmusic	None
and more TBA	None
areage	disco
b2b	None
basel	consort
be	rock
berlin	house music
bern	None
bird	indie
bs	None
buraq	None
but always focused firmly on the dancefloors needs anddesires	None
cancelled	techno
christian tamborrini	None
circle	rap
club	electronic rock
cora amplifiée	None
cut and paste diverse sounds Danny took to the decks at the age of 16 afterexperiencing sets by visiting European DJs Inspired by the likes of SatoshiTomiie	None
dOP	techno
davidgoessler	None
deco by didi	None
deep house  dj	None
delone	None
delsinNL	None
diSoul	techno
dirtymadsound	None
disco	vegas indie
dj Lynn Jordan	None
dj fragment	None
dj kelstroem	None
dj michel	None
dj skred	None
djgino	None
djs Guyus	None
dprojekt	None
dr habakuk	None
drhabakuk	None
dub  dj	None
dubstep reggae	None
duburchin	None
dylan owl	None
edits	house music
entropie	None
exotiques et pointus Passionné dès lenfance par cette musique festive et motivante	None
floor 1	None
floor 2	hi-nrg
girl	mashup
great impro & avantgarde band  live	None
gs	None
guest	electronic rock
guitare électrique	None
he beginsto record	None
hecht&zander	None
herr meyer	None
highgradeZurich	None
house	None
house  dj	None
httpssoundcloudcomblanktonsammelstelle	None
httpwwwparquetrecordingscom	None
httpwwwresidentadvisornetdjtoastterry	None
il a beaucoup travaillé pour arriver à ce style décalé qui lui correspond parfaitement Les musiques traditionnelles telles que la salsa	None
ill77	None
incite	groove
italospace disco	None
jungle	electronic rock
kescalandanke	None
klaudija groovin golic	None
knotweed records  decision making theory	None
la rucheLausanne	None
la samba et	None
lady bala	None
les sonorités tribales sont à la base de ses	None
lights by Ariel	None
littlehouse	None
live	worship
live BitTuner	None
live Hepp	None
live Isolated Lines	None
live Rotkeller	None
live S S S S	None
live set	None
look longDublin	None
lounge	None
lu	vallenato
luca mosso	None
many more	None
mathieu sabotage B2B such a serge	None
mc iyah ranx & echo master rjega zürich	None
meanderBerlin	None
meau	None
meta83	None
miaumusic  BE	None
mimetic	industrial music
minimise	None
more	metal
more guests TBA	None
more infos soon	None
more soon	None
motoguzziParis	None
mrrox & mrsimon	None
nat	christmas
nemoy	None
new facts	None
nunu	trap
omar	reggaeton
opdisc	None
organism showcase  Lausanne	None
oxsa	None
parkcity	None
parker meets risikogruppe	None
partoutcc	None
patee	None
patten	rap
percussions	None
pitch control	None
precision and most of all	None
psyco african beat	None
raa	sinhala
rafik	None
reedits	None
rest  Bern	None
ronkanditt	None
sandro de marco	None
scandal all stars aka ast	None
sirion	progressive psytrance
soul Hailing fromMadrid	None
space disco	None
stevnaintleavn	None
such a serge	None
suffix	None
t Danny Serrano	None
tINI	hip hop
tb 303	None
tbc	None
teknozwei	None
the gang all stars feat	None
thomas greminger	None
trackmaster69	techno
trashid	None
tsacK	rap
two turntables	None
uk funky  dj	None
uncoolch	None
ursprung	None
visuals Pixelpunx	None
visuals by MikaVentura	None
vj Camille de Dieu	None
voix	harpsichord
vs	pop
warm up by Yan Sebastian	None
waveIrland	None
weird disco	None
wekeed	house music
werk itmisshapecopenhagenDK	None
wfmusik	None
wwwresidentadvisornetdjgarance	None
xa0	None
xa0Lausanne	None
xa0african boogie  dj	None
xa0high life	None
xxx	None
yAn	techno
zink	None
zürich	None
Âme	None
Ãberraschungsgast Berlin	None
Überraschungsgast Berlin	None
