	None
& Guests	None
& Local Support Kugl	None
& Mehr bald	None
& some more	None
& special guests	None
&ME	alternative metal
0500  0630	None
0500  0700	None
0630  0800	None
0630  0830	None
0700  0900	None
0800  0930	None
0830  End	None
0900  1030	None
0930  1100	None
1 floor	None
10 April 2015  Moon	None
1030  End	None
11 APRILE LE MOON	None
11 APRILE MODERNITY	None
11 April 2015  Moon	None
12 APRILE LE MOON	None
12 APRILE MODERNITY	None
12 April 2015  Modernity	None
13 APRILE MODERNITY	None
16 Bit Lolitas	house music
1st part 21h  00h	None
2 floor	hi-nrg
2020 Soundsystem	None
2020Soundsystem	None
22a Music	None
22h2h	None
2headed	None
2nd part 00h  04h	None
3000 Records	None
3010	rap
3Some	None
3some	None
45 AMPM live	None
4ton	None
8 Bit Records	None
8Bit	None
8bit	None
9 April 2015  Moon	None
A coté de leur résidence dans différents clubs genevois	None
ABRAHAM LICORNE  electroswing  GE	None
AC204	None
ACID	indie
AGAPE	None
AGRO  UK	None
AIX	drone
AKA	None
AKA AKA	techno
AKA AKA feat Thalstroem	None
AKAY	None
ALAIN SZERDAHELIY	None
ALAN K	techno
ALGORYTHMIK live	None
ALON LEVI	None
AMari	None
AMochi	None
ANDRI LIVE  Cityfox	None
ANDRI LIVE  Cityfox Zürich	None
ANDRI LIVE  Highgrade	None
ANDROO	None
ANIMAL TRAINER  Pokerflat	None
ANTHONY Kavanagh	None
ANTS	None
ARG	None
ARG  Beatbrothers	None
ARNAUD VINTAGE  Vintage records  FR	None
ARTMAILLÉ	None
ASOK	techno
ATA	techno
ATrak	house music
AYOu2028	None
Aaawesome Colors	None
AbEs	None
Abbruchhaus	None
Abdel Hady	disco
Abel	deep indie r&b
About Clint	None
Above & Beyond	house music
Abrocybe	None
Academist	None
Accama	None
Access Denied	breakbeat
Acid Pauli	house music
Acousmie	None
Acqua	None
Actress	electronic rock
Ad Noseeam	None
Ada	techno
Adam Port	disco
Adana Twins	deep
Addison Groove	uk garage
Adhmad Til	None
Adhmad Til & friends	None
Ado	None
Adolpho & Franky	None
Adon	world worship
Adon & Zafer	rap
Adrian Bergmann	None
Adrian Bermudez	None
Adrian Flavour	None
Adriano Mirabile	rap
Adriatique	techno
Adriatique  Diynamic	None
Adriatique  Diynamic  Cityfox	None
Adriatique  Diynamic Zürich	None
Adva	None
Adverblaster	None
Ady Montana	None
Aebeloe	substep
Aendy	None
Afrilounge  Connaisseur	None
Afrojack	house music
Afterhour 15082010	None
Agape	None
Agape  Koums	None
Agent C b2b Chemical Soul	None
Agent Sascha	None
Agnès	pop
Agonis	None
Agoria b2b Mirko Loko	None
Ahmet Sendil	techno
Airone	None
Ajele	None
Aka Akha	None
Akirahawks	house music
Alain Roy b2b Dirty Larry	None
Alan Bolumar	None
Alan K	techno
Alan Kater	None
Albert Hofmann aka Sins & GaLaBar	None
Albi	None
Alci	cumbia
Alci  Robsoul	None
Aldijana&Jorven	None
Alec Troniq	house music
Alejandro Mosso	techno
Alek Sys	None
Aleksander Nesic	None
Alessio Mereu	rap
Alesso	house music
Alex	pop
Alex Andher	None
Alex Attias	breakbeat
Alex Barck	None
Alex Dallas	None
Alex Dallas und Lexx	None
Alex Kennon	house music
Alex Kostic	None
Alex Lore	None
Alex Mendes	disco
Alex Niggemann	techno
Alex Picone	techno
Alex Smoke	techno
Alex Sumi	None
Alexander Cherry	rap
Alexander Robotnick	None
Alexis Cabrera	techno
Alexkid	downtempo
Algorythm Rec  GER	None
Alice HÃ¤nseberger	None
Alice Hänseberger	None
Alle Farben	deep
Allied	drum and bass
Alma Negra	None
Along With  Zürich	None
Alternative	deep new wave
Alternative DJs	None
Alæ	house music
Amad vs Mented Wise	None
Amanda Lepore	electronic rock
Amaro	reggaeton
Ambareesh	None
Ambivalent	techno
Amiant	None
Amilcare	romantic
Amine Edge	house music
Amine Edge & DANCE	house music
Amirali	disco
Amnesia Scanner	mandible
Amsterdam	None
Amy Macdonald	pop
Anand B	None
AndId	techno
Ander	techno
Andi Deutsch	None
Andre Hommen	house music
Andre Lemont & Marius White	None
Andrea DAmore	None
Andrea Ferri	None
Andrea Oliva	house music
Andrea Oliva  Cadenza  Defected  BS	None
Andrea Roma	techno
Andrea Terramossi	disco
Andreas Foxxu200b & Daniel Demasoni	None
Andreas Henneberg	house music
Andreas Ramos	disco
Andreas Ramos Baked	None
Andres Garcia	None
Andres Hernandez	None
AndrewGee	None
Andri	house music
AndrÃ© Hommen	house music
André Hommen	house music
André Uhl	None
Andrés aka DJ DEZ	None
Andy Baxter	house music
Andy Gobeli VISUALS Style & Design GKZ	None
Andy Struzek	None
Anemone Tube	None
Angelica Fravi	None
Angy Dee	None
Animal Trainer	house music
Animal Trainer aka Rx & Adrian Flavor	None
Anja Schneider	techno
Anja Schneider  Mobilee Records	None
Ann Clue	None
Annakin	None
Anonym	techno
Another Dark Swinging Room 5	None
Anthea	techno
Anthik	house music
Antoine Chessex & Jérôme Noetinger	None
Antoni Maiovvi	None
Antonio Damato	techno
Apoll	None
Apollonia	None
Apolloniau2028	None
Appleblim	bass music
Apples & Pears	None
Après minuit Entrée 20	None
Arapu	rap
Archie Hamilton	techno
Area Remote	None
Arg	None
Argenis Brito	None
Argenis Brito  Ruta 5	None
Argy	techno
Ariane	None
Aril Brikha & Franky Digital	techno
Ark	vapor soul
Ark & Lenny	rap
Ark live	None
Arno Vintage	None
Arnstrom & Sascha Stohler	None
Aron Tanie	None
Arovane	ambient
Arran Lee	None
Art Department	techno
Art Department  Crosstown Rebels  Toronto	None
Artenvielfalt	house music
Arttu	None
Asic	None
Asile  Live   BP   Paris	None
Asphaltchild	None
Ast	None
Ast Alavista	None
Ata	techno
Ataxia	techno
Atønal	None
Au niveau international	None
Au salon 22h  3h	None
Audino	None
Audiofly	house music
Audiofly  Get Physical	None
Audionatica	techno
Audiotrix  FR	None
Auf Dauerwelle	None
Aulay Fou	rap
Autechre	techno
Avant minuit Entrée Gratuite	None
Avatism	deep
Avgusto	None
Avrosse B2B Louie Cut	None
Awesome Tapes From Africa	hip hop
Axel Boman	house music
Ayhasca Ernesto	None
AÃ¯sha Devi	fluxwork
Aïsha Devi	mandible
Aïsha Devi live	None
BACALAO  live	None
BAD YARD SOUND	None
BANG GOES	None
BAR STAGE	None
BASS BROTHERS  drum & bass  PRT	None
BASSMENT	None
BASSTHERAPY	None
BE	rock
BEFORE WE SAY GOODBYE ALBUM TOUR	None
BELLOMZ	None
BIG HAIR	None
BIG ZIS & MT DANCEFLOOR djteam	None
BIGT	None
BLACK ARTS LAB live	None
BLACK RABBIT	None
BLine	None
BOTICO	None
BOUNCE	indie dream pop
BOUNCE  live	None
BPST	None
BRAIN DAMAGE FEAT WILLI WILLIAMS	None
BRUT	retro electro
BTK	beatdown
BTong	None
Baby Brown	slow game
Bacalao & Sonne	house music
Backing band  THE HOMEGROWN BAND	None
Bad Taste  UA	None
Badre	None
Baggy Bukaddor	None
Bagheera	rap
Bakerman	None
Bakermat	house music
Bakyr Tenuta  Lausanne	None
Bang Goes	None
Bar 25	None
Bar25	None
Bar3000	None
Bar3000Plattenrelease	None
Barac	rap
Barbir	None
Barbir & Louh	None
Bardia Salour	None
Bardo & Salazar	None
Barem	techno
Barem  Minus	None
Baris K	None
Bart B More	house music
Basel	consort
Basic Fingers	None
Basil Bastard	None
Baskontrolle	None
Bassbüro	None
Basskontrolle	None
Bassment	None
Batiment	house music
Baumeister	None
BeaTTronic	None
Beam rec	None
Bear the Eagle	None
Beardy Man	disco
Beardyman	disco
Beatamines	house music
Beatbrothers  AG	None
Beatniks	None
Beckers	None
Beda	disco
Beda & Pat Patrisha	rap
Beda und nader	None
Bedrock	None
Belcastro	None
Belfort	None
Bellomz	None
Ben Aldred	None
Ben Kaczor	disco
Ben Larsen	techno
Beni Jacksen	None
Benja	None
Benja  Hive Audio  Zürich	None
Benja & Reto Ardour  Hive Audio	None
Benjamin Brunn	None
Benjamin Fehr	techno
Benjamin Gasser	None
Benna dj	None
Benno Blome	rap
Benoit & Sergio	disco
Benotmane	house music
Berber & Pasta	None
Berceuse Heroique  USA	None
Berlin	house music
BerlinDetroit	None
BerlinHamburg	None
Bern	None
Bernardo Zitto & Roberto Splendini	None
Bernoise	None
Betty&Ford	None
Bfly Steiner	techno
Biesentales	None
Big T	None
Big T  Subtl  GE	None
BigT	None
BildstÃ¶rung	None
Bildstörung	None
Bill Kouligas	None
Bill Patrick	None
Biosphere	ambient
Bird	indie
Birdy Nam Nam	turntablism
BitTuner	None
BitTuner live	None
Bitsculpter	techno
BjÃ¶rn StÃ¶rig	house music
Björn Nimmich	None
Björn Störig	house music
Black Forest	downtempo
Black Sally & The Grumbler	None
Black To Comm	warm drone
BlackForest Underground	None
Blackley	jump up
Blade SHEDHALLE Eli Verveine	None
Blaise Deville	None
Blake Worrell live	None
Blanck Mass	mandible
Blank Tapes	None
Blondish	house music
Bloom	comic
Blubblubb	None
Blue Mystic	None
Bob Bellerue	None
Bob Drop Dead	None
Bob&Bob	pop
Bodi Bill	german indie
Bodymoves by Splashcats	None
Bohnenblust	None
Bojan Milenkovic	rap
Bojanski	None
Bomb The Bass	house music
Bomba Titinka  electroswing live  IT	None
Bongo Kids	None
Bongo Pete	None
Bonnie	rock
Bonny & Clyde	None
Bonny & Clyde  BonnyClydezh	None
Bonobo	downtempo
Bontempi DJs	None
Bontempi Djs	None
Boris Brejcha	techno
Boris Why	house music
Born Bjorg	techno
Born BjÃ¸rg	None
Born Bjørg	None
Borussia	techno
Boston Bun	house music
Bowmore	None
Bowser	None
Boy George	new
Brain & Device	None
Brandt Brauer Frick	microhouse
Brandt Brauer Frick feat Ommas Keith	None
Branko live	None
Breakbeat Movement	None
Bremen	None
BrettHit	rap
BroKapella	None
Brodinski  F  Bromance Rec	None
Bronson	hip hop
Brothers in Arms	None
Brown S a collaboré avec plusieurs artistes du label Defected Records tel que Simon Dunmore	None
Brown S a eu la chance de jouer lors de la WMC	None
Brown S a joué pour les plus gros Events de la place comme les Red Zone	None
Brown S est à la base du succès des soirées Tasty qui se déroulent à Genève depuis 2011 et qui regroupent 4 à 5 fois par année 1000 à 1500 personnes avec Brown S accompagné dun artiste international	None
Bucharest	None
Buenos Aires	None
BuenosAires	None
Bugge Wesseltoft	jazz
Buraka Som Sistema	kuduro
Busy P	house music
Butch	rock
C2Cu2028	None
CA	rap
CABIN CREW	house music
CAPE TOWN EFFECTS	None
CAPTAIN HOOK LIVE	None
CASA SHOW LIVE	None
CASTROMOORE	None
CEZAR	techno
CH	None
CHIRI MOYA	None
CHUK	redneck
CLINCKER	None
CLM	None
CMYK	None
CMYKollektiv	None
COCOON STAGE Apollonia	None
COH	idm
COMA	disco
COMFORTNOISE PLOY	None
CONDOM	electronic rock
COSMIC DJ	disco
Cab Drivers	None
Cabanne	None
Cadenza  CHILI	None
Camea	house music
Cameo	soul
Canada	electronic rock
Canson	house music
Capcom	None
CapohLitch	None
Caprices Festival	None
Carl Cox	house music
Carl Craig	techno
Carlo Malito  IT	None
Carlos Jr	None
Cassy	microhouse
Caterina Barbieri	None
Catnappu200b LIVE	None
Cauliflower	None
Cedric Zeyenne	groove room
Cem Demir	None
Central Rodeo	rap
Ceo MÃ¼ller	None
Ceo Müller	None
CepheÃ¬	None
Cepheì	None
CerealKillers live	None
Chacal & Yakarta	cubaton
Chamalo	None
Channel X	house music
Chapelier Fou	None
Chapkmace	None
Charles Cohen	mandible
Chaton	None
Chaton dj	None
Cheesebeat	None
Cheibe Balagan	None
Chemical Soul	techno
Chemical Soul b2b ZGroove  JurRecords	None
Chic Brown	None
Chicks Luv Us & Medeew	rap
Chicks behind the decks showcase  Bern	None
Chill Bump	None
Chillhat	None
Chimeric	None
Chiri Moya	None
Choronzon	techno
Chris Ahn	techno
Chris Air	None
Chris Bailey	None
Chris Clayton	None
Chris Colburn	techno
Chris Liebingu2028	None
Chris Power and Friends	None
Chris Raphael	techno
Chris Rockwell	techno
Chris Rockwell  MinimalFraktion	None
Chris Tietjen	rap
Chris de Rebel	None
Christian Burkhardt	techno
Christian Löffler	house music
Christian Tamborrini	None
Christine Live	None
Christo	house music
Chronophone	None
Chuckie	house music
Chukks	None
Chymera	house music
Cio	None
Circle	rap
Circuit Diagram feat Derya Yildrim live	None
Ciril Camen	None
Cirill	None
Cirillo	techno
Cirkus	downtempo
City Flow  SLY INK	None
Cityfox	None
Cityfox Wient	None
Clapper	None
Claptone	house music
Clara	None
Clara Moto	techno
Claude Tarell	None
Claudio  Bassport	None
Claudio & Volkan Ocak	rap
Claudio Carrera	None
Claus Voigtmann	None
Clem	nu age
Clem  Specimen	None
Click  Click	pop
Clincker	None
Clit Eastwood	None
Cloud Boat	None
Clovis & Dan Campo aka The Dudes	rap
Club	electronic rock
Club Bonsoir	None
Club Cheval	disco
Club Q	None
CoMini	None
Cobeia	disco
Cobeia  Special no wave  post punk set	None
Cocktails Bar	None
Cockwhore & Macho	None
Cocoon	chanson
Cocoonnet	None
Cocun	None
Code Club	None
Coldcut	breakbeat
Cologne	None
ComaCorp Showcase Cassatta & Soapy LIVE	None
Comfort Fit	idm
Comini	None
Commix	drum and bass
Congorock	house music
Container	None
Cool Tigers	None
Copyright	house music
Corpataux	techno
Cos	canterbury scene
Cosili	None
Cosili VISUALS Style & Design GKZ	None
Cosme Tenuta  Lausanne	None
Cosmo & Faber	rap
Cosmokolor	rap
Coss	house music
Counterstrike	drum and bass
Courtney Storer	None
Coxswain	None
Creaked DJs	None
Crimetekk	None
Cris Deep	None
Cristal Fighters live	None
Cristian Tamborrini	house music
Critical  UK	None
Critical Mitch	None
Croatia Squad	house music
Crocodile Soup	rap
Crookers	house music
Crosstown Rebels	None
Crowdpleaser	techno
Cruz Jr	None
Cryin Soul	None
Cryptonites	house music
Ctwalk	None
Cuartero	techno
Culprit	None
Cummi Flu live	None
Current Value	drum and bass
Curtiss	None
Cut Hands	house music
Cuzzy Cuz	None
Cwalk	None
Cyclic	None
D	rock
D Brun del Re	None
D Club  Lausanne	None
DAFNE & CEM	None
DAINSKIN	None
DARKROOM GANG	None
DARKSIDE	techno
DAYSOMMAR OPEN AIR	None
DE	banda
DEBBYS & Mickail	None
DEBRUIT live	None
DEJAN	None
DEJAN  Cityfox	None
DEJAN  Cityfox  Zürich	None
DEJAN  Cityfox Zürich	None
DER KUTSCHER UND SEIN GAUL live	None
DEYAN	None
DIE Galoppierende Zuversicht	None
DIONYSOS	chanson
DIRTYMADSOUND	None
DISASTERADIO	rock
DJ 1901	None
DJ ATN	None
DJ Arg	techno
DJ Arg b2b Score	None
DJ BATTLE	None
DJ Big T	hip hop
DJ Budai	None
DJ CELLSKI	None
DJ Chemical Soul	None
DJ Cipmo	None
DJ Claudio	None
DJ Corrine Wacker	None
DJ DOSQ	None
DJ Dangerous Dave	None
DJ Deep	house music
DJ Dodger Stadium	None
DJ Dub	dub
DJ Duorythm	None
DJ Dylan	None
DJ F	None
DJ FAFF	None
DJ FERROX	None
DJ Flush	techno
DJ Food & DK	rap
DJ Fred Hystère	None
DJ GILB	None
DJ Geisha	None
DJ Gemini	None
DJ Girl	None
DJ Girl  3	None
DJ Grandmaster Flash The Turntable  Legend	None
DJ Hachi	None
DJ Hell	electronic rock
DJ Hidden	drum and bass
DJ Highman	hip hop
DJ Inferal Basterd	None
DJ JELLY ROLL	None
DJ Jack Slaughter	None
DJ Jihell	None
DJ Koze	house music
DJ Le Baron	rap
DJ Le Roi	hip hop
DJ Le Roi  Get Physical  Noir Music  BS	None
DJ LukJlite	None
DJ MITCH  old school swing  CH	None
DJ MITCH  swing old school  GE	None
DJ Madwave	rap
DJ Mandrax	None
DJ Mateo	None
DJ Mibor  electroswing  SP	None
DJ Mitch	None
DJ Mitch  swing  GE	None
DJ Moule	None
DJ Mourad	deep rai
DJ Nat	None
DJ Never	None
DJ Nicca	None
DJ Nissque	None
DJ OCTAN	None
DJ ORDOEUVRE	None
DJ Oxyd	None
DJ Phil Will	None
DJ Placid	techno
DJ Q	uk garage
DJ Quad Damage	None
DJ ROUNI  electro swing  CH	None
DJ ROUNI  electroswing  GE	None
DJ RTorkk	None
DJ Ralf	house music
DJ Rolla	None
DJ Rouni  electroswing  GE	None
DJ Ruben Estevez	None
DJ Ryck Plan B	None
DJ Sam Divine	None
DJ Scape	None
DJ Score	None
DJ Shadow & Cut Chemist	hip hop
DJ Simon Kwe & Zimbabwebird MC	None
DJ Spire	None
DJ Sprinkles	None
DJ Sticka	None
DJ Style & UniT	None
DJ Tennis	house music
DJ Thomas Luke	None
DJ Tonic & DJ Tremendo	None
DJ Trigun	None
DJ WU3	None
DJ Wld	None
DJ ZGroove	None
DJ Zör Gollin	None
DJ lukJLite	None
DJAIMIN	None
DJEN KA FLOW	None
DJERRY C	None
DJS GSwing  swing  CH	None
DJamency	rap
DJs	new jack swing
DJs AndrÃ© Marvin	None
DJs André Marvin	None
DJs DJ Koze  Matija  Ptess  Nici Faerber  The Dean Soniks  Ulli & Maesoo  JSayne & Loo Mapper  MiMi  Des Wahnsinns Fette Beute	None
DJs DJ Madskillz  Acid Pauli  Matija  Mika Dutsch Sonik  Monome  Cio & Nat  Pat Patrisha  Ulli & Maesoo  Bob Drop & Mad Rose  Paul Heimweh  Dubexmachina Soundsystem	None
DJs Guyus	None
DJs Housefrauen	None
DJs Jolly Buoy	None
DJs JussiPekka	None
DJs Life is Live	None
DJs PBell  Styro 2000  Ida  Rumory  Bang Goes  Playlove	None
DK	None
DMX Krew	house music
DNox	house music
DOMINIC	k-pop
DOO GOOD	None
DOSCI Look Like Plattentaufe	None
DPC	None
DR JONES	tone
DRAXON	None
DUB ROOTS	None
Da Ron	None
Dachshund	techno
Dachsund	None
Dada Und Cosili Live	None
Dadaglobal	disco
Dais & Duschek	None
Daitan	None
Daitan & Shivan	None
Damian Deroma	techno
Damian Lazarusu2028	None
Dan Beaumont	disco
Dan Berglund	classic swedish pop
Dan Ghenacia	techno
Dan Noël	None
Dana Ruh	techno
Dance Classics & Disco	None
Dandy	rock
Dandy Jack	hip hop
Dandy Jack & Junction SM	techno
Dandy Jack ET LE SERPENT QUI DANSE  ruta5	None
Dani Casarano	techno
Dani Nydegger	None
Daniel Bell	techno
Daniel Dreier	techno
Daniel Mehlhart	techno
Daniele Cosmo	None
Danny Krivit	hip hop
Danny Mansfield	None
Danse Noire djs	None
Dantze	None
Daparec	techno
Darek	None
Daria	techno
Dario DAttis	rap
Dario DAttis Official	None
Dario La Mazza	None
Dario La Mazza & STEFANO RINALDI	None
Dario Lotti	rap
Dario Rivas	rock
Dario Rohrbach	None
Dario Todorovic	None
Dark Floor	None
DarkZ B2B Rekah	None
Darkroom Gang  Jann Bronski  John Lemon & Christian  Aulay Fou	None
Darkstep	None
Darrien	hardcore
Das Balz	None
Das Volca Massaker Orchester	None
Das polnische Abgang & Chinchi	None
Dash Berlin	house music
Dash Deep Records	None
Dave Canina	None
Dave Clarke	techno
Dave Eleanor	hip hop
Dave Eleanor presents LNR	None
Dave Martins	rap
Dave Phillips	psychobilly
Dave Vega	techno
David Armada	rap
David Armada  Specimen	None
David Cumplido	None
David Durango	techno
David Gtronic	techno
David Jach	house music
David Kiesel	None
David Mayer	disco
David Morales	house music
Davide Cucchi	None
Daylight Floor	None
De Suso	None
De la bonne Deep suivit dun live de minimal cest vendredi prochain au The Spirit Bar  Ca va taper du pied	None
DeWalta	techno
Dead J live	None
Deadbeat	techno
Dedans 23h  05h	None
Dee Joe	None
Dee Nelli	None
Deeno	None
Deep A	None
Deep Dishu2028	None
Deep Seven	None
Deep White	None
Deepwhite	None
Deetron	techno
DefPlay	None
Dehors  20h30  23h	None
Dejan	None
Dejan  Cityfox	None
Dejan  Cityfox Zürich	None
Dekmantel	None
Delakeyz	house music
Delano	pop
Delta Funktionen	techno
Dema & Paride Saraceni	techno
Demegy	None
Demetrio Giannice	house music
DemonD	None
Demotape Clinic  Zürich	None
Den Ishu  Desolat  Supernature	None
Dene Anthony	None
Deneha	house music
Denis Dzigal LIVE	None
Deniz Bul	None
Denz	swedish
Der Dirigent	None
Der Dritte Raum	techno
Der Gammler	None
Der Held	None
Der HollÃ¤nder	None
Der Holländer	None
Der Kleine Italiener	None
Der Schlechte Einfluss	None
Der Schmeisser	None
Der VogelwÃ¤rter	None
Der Vogelwärter	None
Derrick May	techno
Design  Performance	None
Desolat	None
Detroit	None
Detroit Grand Pubahs	techno
Detroit Swindle	house music
Deyan	None
Diatek	techno
Die Galoppierende Zuversicht	None
Die Wilde Jagd	None
Digital Switchover	None
Digitaline	techno
Digitalism	electronic rock
Digitizer	nu electro
Dilbert	classic peruvian pop
Dilek	None
Dilusso	None
Dimitri	house music
Dimlite	idm
Dinky	techno
Dino White	None
Dirt Crew	house music
Dirty Disco Youth	house music
Dirty Doering	house music
Dirty Flav	None
Dirty Sound Magnet	None
Dirty Sound System Feat Pilooski	None
Disagony	None
Discarga VS	None
Disco  Italo  reedits  Chicago House  DJ	None
Discø Chånnel	None
Disko Dario	None
Disprove	None
Divalvi	house music
Dixonu2028	None
Diynamic Label Night	None
Dizco Joe	None
Dj COBEIA	None
Dj Daparec	None
Dj Estèphe	None
Dj Gibson Praise	None
Dj Infernal Bastard	None
Dj Intec	None
Dj Johnny & Dj Fonseca	None
Dj La Febbre	None
Dj Mauri	None
Dj Mute	None
Dj Never Die	techno
Dj Notec	None
Dj POPULIST	None
Dj Polyrithmo	None
Dj PorCus	None
Dj Reas	None
Dj Rolla	None
Dj Rumba Stéréo	None
Dj Sat El Flaco	None
Dj Style	coverchill
Dj TAG  Tresor	None
Dj Vidy	rap
Dj fil	None
Dj girl & Flexibelle	None
Dj little & David Durango	None
Dj tsacK	None
DjMitch	None
Djamency	rap
Djazzy	rap
Djebali	techno
Djerry C	None
Djs	new jack swing
Djs La Foret	None
Djs Nik	None
Djuma Soundsystem	techno
Dmori	None
Doctor Dru	disco
Doctor Flake	downtempo
Dog Almond	None
Dolibox	house music
Dollar Mambo	rap
Dom	rap
Dom & Roland	drum and bass
Dom&Roland	drum and bass
Domingo Romero b2b Michel Sacher	None
Dominic	k-pop
Dominik	scorecore
Dominik Eulberg	techno
Don Diablo	house music
Don Malastas	None
Don Malastas B2B DJ Highman	None
Don Ramon	argentine reggae
Don Ramon  Friedas Büxe	None
Don Ramon & MA	techno
Don Ranking	None
Don Williams	country
Donnacha Costello	techno
Donnerwetter	None
Doobious	None
Dope Ammo &Shaddy MC	None
Doppelt Gemoppelt	techno
Dorian Paic	techno
Doris Stemmel	None
Dottore	None
DoubtingThomas	rap
Douglas AndrÃ©	None
Douglas André	None
Douglas Greed feat Nagler & Kuss	None
Douster  Sound Pellegrino	None
Down by Concept	None
Down to the Bunker	None
Doze & Madink	None
Dr Jones	tone
Dre Skull	hip hop
DreadJ	techno
Drifter	drum and bass
Drime  Hexagon Dubs  UK	None
Driscoxa0 GE	None
Driss	None
Drone Unknow	None
Dropout Agency	None
Dropout AgencySoundsystem	None
Dropout Rec	None
Drum & Bass  Kalvingrad	None
Drum That Bass  CH	None
Drum and bass	None
Drumpoet	None
Drumpoet Night	None
Drumpoet ZH	None
Drums Of Death	None
Dser	None
Dser  Dark Manoeuvres  GE	None
Dualism	progressive psytrance
DubExMachina  Zürich	None
Dubbel Dutch	house music
Dubfire	techno
Dubfire LIVE HYBRIDu2028	None
Dubfunk	rap
Dubnova	house music
Dumme Jungs	electro trash
Dunkelmuth	None
Durian Brothers	mandible
Dyed Soundorom	techno
Dylan Owl	None
Dynamic Range	None
Déepart	None
EAGLEEYE CHERRY	None
EBONY BONES live	None
ECHOLOT Dub System	None
ED Function	None
EDDIEKEY	None
EL COLLERA  cumbia digital	None
EL DEAR	None
ELEMENT	rap
ELLEN SCHNEIDER live	None
EMI	None
EMRE ECE	None
ENTLET	None
ENTRÉE FLOOR	None
ENZO LO CONTE	None
EUGENE THE CAT  electroswing live  AUS	None
EVA D	None
Eats Everything	disco
Ebony Bones	None
Eco  Voisinage  Genève	None
Ed Luis	None
Eddie Fowlkes	techno
Eddie Thoneick	house music
EddieKey	None
Edgar Jack	techno
Edgar Peng	disco
Edison Cabrino	None
Edison Cabrino b2b Helder	None
Eevy	None
Eftn	None
Eftn live	None
Eiffel	hi-nrg
Einmusik	techno
Eintakt	None
Einzelkind	techno
Ekkohaus	techno
El Alusinante	None
El Kid and Ishan Sound	None
El Mundo	disco
El Rino	None
El Tigre	None
ElMar	None
Electribe	None
Electro Culture Records  Littlehouse Records	None
Electro Floor	None
Electrophil Records	None
Electrosanne by Night	None
Elektro Guzzi	techno
Elektrohandel	deep chill
Element	rap
Eli Escobar	house music
Eli Vervain	None
Eli Verveine	techno
Elia BÃ¶siger	None
Elia Bösiger	None
Elias 308	None
Ellen Allienu2028	None
Elly	None
Elvira	hip hop
Elvis  Linaz  Kaspar Weiss  Syntosil  Space Works  Bildstoerung  VerInnerLicht	None
Elvis Cassetta	house music
Emanuel La Roche	None
Emanuel Satie	house music
Emanuele Errante	nu age
Emeteria	None
Emi	None
Emilie Nana	hip hop
Emilie Simon	world christmas
Emill de Moreu	house music
Emre Bektas	None
Emre Bektas  Radio Moskau	None
Emre Bektas & Denny & Mouseen	None
Emre Bektas & Jaxon	None
Emre Bektas & Mouseen & Denny	None
En dehors de Genève cest au Liquid Club de Berne	None
Ena Lind	techno
Enchufada  CH	None
Endgame	None
Ensemble Economique	abstractro
Ensemble Phoenix	None
Entrance by the back on the street	None
Entre habitudes et nouveautés la programmation de cette nouvelle semaine annonce la couleur	None
Enzo Lo Conte	None
Enzo Siffredi	house music
Enzo Siragusa	techno
Epi	None
Era & Falter Visuals	None
Eramina	None
Eric Borgo	techno
Ernesto Ferreyra	techno
Erol Alkan	hip hop
Escape to Mars	None
Eskimo	screamo
Eskimo Live	None
Esp Woody McBride Experience	None
Eurokai	None
Eva D	None
Eva Shaw	big room
Everstone	house music
Evi Beast	None
Evil Business	None
Evita	None
Exercise One Exone	None
Exlab	None
Exploration	None
External Source	None
Extrastunden	None
Extrawelt	house music
Ezikiel	techno
Ezikiel  Unite	None
F	classical
F Raphaël K	None
FAB	rock
FABELHAFT	None
FABRIKTHEATER Sick Girls	None
FABRIKTHEATER Various Productions	None
FABRi	None
FALL	pop
FALL  SNTWN	None
FCKN Crew	electro trash
FERROX	None
FIAT BUX & Le Citadin	None
FIN	None
FJAAK	None
FLORE  POLAAR  FR	None
FLORENTM	None
FLOXYTEK  Diable au corps	None
FLUK ENSEMBLE	None
FLUK ENSEMBLE EN FUMOIR	None
FOOL	None
FOYER	None
FR	None
FRANCO FOLLE	None
FRANKY	None
FRANTZ LORIOT	None
FRED	gospel
FRED LICCI	None
FRITZ FIRULIN	None
FRONTLINE	anthem worship
Fabian Binkert	None
Fabian Kozelsky	None
Fabian Kozelsky b2b Somi	None
Fabian Reichelt & Raycoux Jr	None
Fabien	None
Fabio Giannelli	techno
Fabio Guarriello	None
Fabio Monesi	rap
Fabio Tamborrini	disco
Fabio Zaccone	None
Fabr	None
Fabri	None
Fabrizio aka Dee Nelli	None
Fall  Sonotown  Paris	None
Fango Packung	None
Fantastic Friends  CH	None
Faust	classical
Favila & Valentine	None
Favila&Valentine	None
Feathered Sun	house music
Fedde Legrand	house music
Fehrplay	big room
Feldermelder	None
Felipe & Gusto	None
Felipe Acevedo	None
Felipe La Main Mise  Lausanne	None
Felipe Puertes	None
Feodor	deep opera
Fernando Costantini	techno
Ferro	None
Festival IN   t	None
Festival IN t   t	None
Fiat Bux	None
Fiber	None
Fiji  electro pop live	None
Filastine live	None
Filippo Vicario	None
Finnebassen	house music
Fish	ska
Fiume Junior	None
Flavio	channel pop
Flavio Calzado	None
Flexxi	None
Flinke Finger	None
Flo	pop
Flo Kaufmann	None
Floating Points	house music
Floor 1	None
Floor 1  Hazienda	None
Floor 2  Taurus	None
Floor 2 Föhn Wind of Music	None
Florent  M	None
Florian Hecker	idm
Florian Kunicke	None
Florian Kupfer	house music
Florian Meindl	techno
Flowdrian & LaMeduza	None
Flying Circus	None
Flying Lotus	idm
Follow Me	None
Foreign Beggars	uk garage
Format B	house music
Fornax Void	None
Fr	None
Fracture	deep liquid
France	gypsy jazz
Francesco Del Garda	techno
Francesco Diaz	edm
Francisco Meirino	None
Franco Bianco Fucking Alive	None
Franco Biancou200b LIVEDJ Set	None
Franco Mento	rap
Franjazzco	footwork
Frank Lorber	None
Frank Spirit  Bern	None
Frank Storm	None
Frankfurt	None
Frankfurt am Main	None
Franko Lopez	house music
Franky Rizardo	house music
Franz Bianchi	None
Franz White	None
François Antico	None
Freak Slaughter	uk garage
Freaks behind the Deck	None
Fred HystÃ¨re	None
Fred Hystère	None
Fred Linger	disco
Fredi Salomon	None
Frenchbreaks	None
Frenchwerk	None
Freudenreich	None
Fri 2200  0600	None
Friends	emo
Friends With Displays	None
Fritz Kalkbrenner	house music
Frivolous	house music
Frontline	anthem worship
Fuga Ronto	None
Fulldupblex live	None
Fulvio Calà	None
Fumiya Tanaka	techno
Fumuj	dub
Funk Bastard	hip hop
Funk Flavour	None
FunkstÃ¶rung	drum and bass
Funkstörung	idm
Funky Chap	None
Funky Chap & Morris Malone	None
Funky Chap & Space K	None
Futura	None
GANZ	trap
GARCON	None
GESTALTUNG & PERFORMANCES	None
GIOMAR	classic peruvian pop
GRANT LAZLO  electroswing  FR	None
GREEN SYSTEM	None
GROOVAH  cumbia funk  GE	None
GROUND CONTROL	idm
GUILLAUME P  Ge	None
GUNMAN  drum & bass  BE	None
GYMNASTYC	None
GaLaBar	hip hop
GaLaBar  WF  Toulouse	None
GaLaBar  WFmusik	None
GablÃ©	None
Gablé	None
Gadjo Loco	None
Gaiser	techno
Gallo	None
Galoppierende Zuversicht	None
Ganjaman LIVE	None
Garage	rock
Garance	techno
Garance & diSoul	techno
Gareth Emery	house music
Garibovic	rap
Garry Klein	None
Gary Dex	None
GarÃ§on & Agonis	None
Garçon	None
Garçon & Agonis	None
Garçon & Morard	None
Gaspard de La Montagne	techno
Gaston	mbalax
Gaty Lopez	disco
Gavin Russom aka Black Meteoric Star	None
Gazelle Twin	grave wave
Gel Abril	techno
Gelivan	downtempo
Gemini	rap
Gemini from Pyra all Stars	None
General Rush	None
Genetic Dysfunction	techno
Germany	shimmer
Geronimo	opm
Gertrude Tuning	None
Gesaffelstein	house music
Geschwister Schumann	house music
Get Physical	None
Ghetto Blaster et Faute de Frappe	None
Ghetto Po	None
Ghinzu	rock
Ghost Box Film Retrospective	None
Ghost Engine	None
Ghoster	None
Ghosting Season	rap
Gianluca Casnici	None
Gianlukino	None
Gianni Callipari	disco
Gianni Milani	None
Gibraltar Vacuum Live  OUS	None
Gigi LP	None
Gigolo Romantic	None
Gigolo Romantico	None
Gil Von De & Mica	None
Gil Von De & Sebastien Dupuis	None
Gil Von De accompagné de Francesco Vallance	None
Gil von De & Daniel Branco	None
Gill & Gill	None
Gill&Gill	country
Gilles Peterson	downtempo
Ginger Boss & Asian Eyez	None
Giorgia Angiuli	techno
Giorgia Anguili	None
Girl	mashup
Giulia Paradiso	hardcore
Giusy S	None
Giusy S b2b Maickel Esse	None
Gleichschritt	None
Gloria Bulsara	None
Godié EOW LU	None
Gogo	jazz
Gold Finger Brothers	None
Golden Disko ship live	None
Gomorra	techno
Goner	triangle indie
Good Groove records	None
Goodman	None
Gorillaz Sound System	None
Gotan Project	downtempo
Goyav	None
Grand Corps Malade	francoton
Gray Chalk	None
Graze	None
Green Cat	None
Greg Puppa	None
Greg Robert LIVE	None
Greg Shepherd	None
Gregor Dubster	None
Gregor Tresher	techno
Gregorylla & Poljak	None
Gregster Browne	None
Greman	None
Greta Gratos	None
Group A	None
Grueter & Buergin	None
Guest	electronic rock
Guests	None
Gui Boratto	house music
Guido MÃ¶bius	None
Guido Möbius	None
Guido Schneider	techno
Guillaume & The Coutu Dumonts	techno
Guipei	None
Gunman & Judah	rap
Guti	disco
Guy Gerber	techno
Guy Joshua	None
Guyus	uk garage
GÃ¶rlitz	None
Görlitz	None
HAUS vol1	None
HEIDI	country
HELIOS & HESS	None
HFS Dub ECHOLOT Dub System	None
HIDDEN PEAKS  Argent Sale	None
HIGHMAN  dnb jungle jump up	None
HIPOPULATION	None
HNQO	disco
HOSH	deep
HOSTED BY MOUSS MC	None
HOUSE	None
HUND KOEKET	None
HVOB	house music
Hackey	None
Hage	big room
Hanfry Martinez	rap
Hard Coming Love	None
Hard Ton	None
Hardtek  Raggatek  Tribecore  Zoo	None
Harris Kale	None
Harris Kale  Deep Fuzz  CH	None
Harry Axt	house music
Harysive	None
Hathor	None
Hector	merengue
Hector Couto	techno
Hector dMb	None
Heiko	coverchill
Helder	house music
Henrik Schwarz	techno
Henrique	sertanejo universitario
Henry Wu	fluxwork
Hepp	None
Hepp live	None
Herkul	None
Herr MÃ¼ller	None
Herr MÃ¼ller & Secondlife	None
Herr Müller	None
Herr Müller & Secondlife	None
Herr Vogel	None
Herrrouine	None
Herva	rap
Herzschwester	techno
Hey O Hansen	None
HiGHFi	None
Hieroglyphic Being	techno
Highgrade	jump up
Hintergrundrauschen	None
Hinterhof	None
Hirsute	None
Hiss & Growl	None
Hive Audio	None
Hive Audio Zürich	None
Holger Hecler	techno
Homeless	folk punk
Homo Electronicus	None
Homopatik  Japan	None
Honoree	techno
Horasse	None
Horstmeier	hip hop
Hosted by	None
Hot Jam	None
Hot Jam DJTeam	None
House	None
House music	None
Houseworx	None
Howling	house music
Huerco S	house music
Humour	None
Huzi Music live	None
HӳҏnфЯєӽ	None
I	hip hop
IDA	None
IF	post
IKKI	electro trash
ILIOS	None
IMPERIAL TIGER ORCHESTRA	ethiopian pop
INCONTROL	None
INDEFINITE VJ	None
INDOOR FLOOR	None
ISLE OF DREAMS STAGE Avicii	None
ISLE OF DREAMS STAGE Calvin Harris	None
ISLE OF DREAMS STAGE David Guetta	None
IXINDAMIX  SP 23	None
Ian F	None
Ian Pooley	house music
Ibiza	house music
Iboga	None
Ida	None
Idealist	ambient
Idealist Berg Audio	None
Idealistmusic	None
Idjut Boys	disco
Idriss D	rap
Igor Blaska	None
Ilario Alicante	techno
Ilios	None
Illesnoise	house music
Im Dunkeln	None
Im Holz	None
Imm & LeeO	None
In Flagranti	balearic
In der Sonne	None
InTakt	downtempo
Indeed	None
Infernal Bastard b2b Quad Damage  JurRecords	None
Infinity Ink	house music
Infiné labelnight  Agoria	None
Inga Copeland	rap
Ingrosso	house music
Installations	None
Instramental	None
Iokoi	None
Iokoi & Aria	None
Iphaze	dub
Isa Bazzgier	None
Isolated Lines	techno
Isolée	house music
Israel	gospel
ItaloJohnson	None
Italy	None
Its Moonrack  Oscil8	None
Ivan Alvarez	None
Ivan Alvarez b2b Kenny Ground	None
Ivan E	pop
Ivan R	None
Ivan Smagghe	rock
J Anderson	epicore
J Kuhn	None
J055	None
JACK & JUUS	None
JAH WORK SOUND	None
JAM LA BAM	None
JAMIE LEWIS & RESIDENT	None
JANE FOX	None
JANN BRONNSKI	None
JANSKI BEEEATS  live	None
JCX	None
JEANFRANÇOIS LAPORTE	None
JEUDI 12 AVRIL	None
JOHN LEMON	techno
JOHNNY OSBOURNE  reggae  JAM	None
JOKE	experimental
JONES	trap
JOne	hip hop
JP Candela	None
JR	hip hop
JSebK	None
JUDITTA feat NOBODY NOSE live	None
JUR Records Allstars DJs	None
Jabu	None
Jack & Juus	None
Jack & Stella	None
Jack Cinch	None
Jack Teck	new tribe
Jacopo Carreras	None
Jacqui	jazz christmas
Jacqui AKTIONSHALLE Joakim & the Ectoplasmics	None
Jaja	None
Jamahr	house music
James Mc Hale	None
James Mc Hale & Luca de Grandis	rap
James McHale	None
Jamie Jones	techno
Jamie Jones  Hot Creations  Crosstown Rebels	None
Jamie Shar	techno
Jamie Shar & Liebkind	techno
Jan Ketel	house music
Jan Penarrubia	techno
Jann Bronski	None
Jaona	None
Japan	idm
Jardin Collectif	None
Jasi 158	None
Jauss	None
Javier Logares	techno
Jaxon	None
Jay Anderson	None
Jay Veedee	None
Jaydan	jump up
Je Dâvu	None
Jean Charles de Monte Carlo  JCDMC	None
Jean Toussaint	None
Jeff Bennett	None
Jeff Casoli & Sandona	None
Jeff Mills	techno
Jeff Swing	techno
Jeff Swings	None
Jen Morris aka sic	None
Jennifer Cardini	microhouse
Jens Bond	techno
Jens Zimmermann	disco
Jeremy De Koste	house music
Jeremy P Caulfield	techno
Jerks	hardcore
Jerome Cerilla	hip hop
Jesco Schuck	None
Jesse Nola	hip hop
Jesse Rose	house music
Jessie	pop
Jestics	None
Jeudi 110 Electro Thursday	None
Jeudi 1510 Electro Thursday	None
Jeudi 22 Electro Thursday  SMorSillo	None
Jeudi 810 Electro Thursday	None
Jichael Mackson	None
Jim Jupp & Julian House	None
Jimi Jules	disco
Jimi Jules & Kalabrese aka Jules & Spatz	rap
Jimmy Edgar	idm
Joah	None
Joah & Pascal Inc	None
Joe Dooro	None
Joel Gautschi	None
Joey Miesch	None
Johanna Knutsson	techno
Johannes Volk	techno
John B	drum and bass
John Chantler	lowercase
John Daly	None
John Daly  Dollar Mambo	None
John Dimas	rap
John Khan	None
John Lemon & CHRISTIAN  Darkroom	rap
John Player	None
John Player B2B Jauss	None
John Talabot	electronic rock
John Tejada	techno
John Wiese	industrial music
JohnLemon	techno
Johnny D	techno
Johnny Holiday	rock
Jokari	rap
Jokari B2B Chapkmace	None
Jon Donson	techno
Jon Gaiser	None
Jonas Kopp	techno
Jonas Mantey	house music
Jonas Rathsman	house music
Jonathan Brown	None
Jools	post-disco
Joram	disco
Jordan Peak	disco
Jorge Doublescore Puertas	None
Joris Delacroix	house music
Jose Parra	cante flamenco
José Parra	cante flamenco
Journée Standard	None
Juan Atkins	house music
Juan Veloz & Friends	rap
Juandroid	None
Juen & Bach	None
Juli Holz	house music
Julia Holter	pop
Julian Perez	disco
Juliano Lopez	disco
Juliano Lopez  Specimen  Crossworld record	None
Julien Aubert	None
Julien Kano	None
Junction SM	None
Jungle Street Groove  BS	None
Junior Boys	electronic rock
Junior Jack & Kid Creme	house music
Junior Tshaka	None
JurRecords	None
Juristik	None
Just Alae	None
Justin Nozuka	pop
Jutzi	None
Juzz	disco
K Chico	None
KABAKA PYRAMID & THE BEBBLE ROCKERS	None
KAEGŌN	None
KEJEBLOS	None
KEM KEYL	None
KIF	None
KING AUTOMATIC	rock
KITTEN AND THE HIP electroswing live  UK	None
KIZOMBA	None
KONTAKT	disco
KUBIN	None
KUVA  Oscil8DEEPINRECORDS	None
Kabale und Liebe	techno
Kablam	fluxwork
Kadebostan	None
Kaegōn	None
Kahn	None
Kaiser Souzai	house music
Kalabrese	house music
Kalabrese Orchestra live feat Khan	None
Kalamity Jo	None
Kalipo	house music
Kami	None
Kamran Sadeghi	abstract
Kano	uk garage
Kaolin	None
Kaos Panda	None
Karawan	None
Karera	None
Karl Möstl	rap
Karotte	techno
Kartell	house music
Kassette Boys	disco
Kastil	house music
Kate Wax	rap
Kathrin De Boer	None
Katta	None
Kaz James	australian dance
Keks	ostrock
Kellerkind	house music
Ken Wan	house music
Ken Wan & Jeremy	house music
Kenhobiz	None
Kenneth Christiansen	None
Kenny	country
Kenny Ground	house music
Kenny Ground b2b Ivan Alvarez	None
Kenny Larkin	techno
Kent Brockmen LIVE	None
Kent Kaina	None
Keränen	None
Kettel	idm
Keziah Jones	None
Khainz	progressive psytrance
Khidja	house music
Khruangbin	electronic rock
KiNK	techno
Kid Koala	downtempo
Kid Konzoom	None
Kid Wise	None
Kiki Bohemia live	None
Killernoizes	None
Killing Sheep	None
Kily	None
Kim Prevedello	hip hop
Kim Prevedello  Little House Castle Music	None
Kim Prevedelo	None
Kina Music	None
Kink	techno
Kissogram	electronic rock
Kiste	None
Kiwistar	electro music
Klaaar	disco
KlangKuenstler	house music
Klangkosmetiker	rap
Klara Lewis	idm
Klarsicht	None
Klaus Legal	None
Klickhaus	None
Klingande	house music
Knor	None
Knäckebröd	None
Kobosil	dub
Kollektiv KlangGut  Katermukke	None
Kollektiv Turmstrasse	techno
Kolombo	house music
Kombé	None
Kompakt	None
Konpiuta	None
Kooz	rap
Kosen Prod	None
Kosen Prod  FR	None
Kotelett&Zadak	None
Kotra	rap
Koudlam	electrofox
Krassen Krastev	None
Kris Wadsworth	techno
Krisitian	barnmusik
Kriss Toff	None
Kriz Fade	None
Krizzli	rap
Kryder	house music
Kuka	None
Kuki	None
Kun	None
Kuno	None
Kuppel	None
Kurilian Kratz	None
Kyle Venkman	None
KÃ¥re Kyl	None
Kåre Kyl	None
König Balthasar	None
Kühn	broadway
LA4A aka Ambivalent	None
LAD	rap
LADY BLACK SALLY	None
LAILA M & OKIDOR	None
LAMPENFIEBER	None
LAN MUZIC	None
LATINO	grupera
LAraignée au Plafon	None
LE PLAISIR DE VOUS FAIRE PLAISIR	None
LES POINTS  Nicola Kazimir  Louh  Barbir  Audino	None
LEVENTINO	None
LINE UP	None
LITTLE LION & DEEP SOUL	None
LITTLE LION SOUND	None
LIVE	world worship
LIVE  Bonaparte  Elektro Guzzi  Frivolous  Dimlite  Saalschutz  Air Cushion Finish  Be Swendsen  Digger Barnes  The Real Bronco	None
LIVE Dapayk  Shackleton  Various Production  Robot Koch  Lur  Oliver Schories  Raz Ohara  Rizzoknor  Pilocka Krach  Kaltehand & Natasha Waters  Die Galoppierende Zuversicht  Digger Barnes	None
LIVE Einmusik	None
LIVE Marc Houle	None
LIVE VISUAL ART BY PIXELPUNX	None
LJ Bacci	None
LJ Florent	None
LNF	hip hop
LSN	None
LTJ Bukem feat MC Conrad	None
LUCIO Malatoid	house music
LUCKY LOOP	None
LYNN JORDAN ECR REC LAURENT PHILLETTAZ	None
La B	None
La Bohème	rock
La Bohème B2B Chapkmace	None
La Bombe	None
La Clandestine	None
La ForÃªt	None
La Forêt	None
La Mibot et Foufoune délectricité	None
La Ruche	None
La Ruche  Lausanne	None
La Ruche Présente	None
La Suite	None
La Vie Cest Facile	None
La Vue VJ Collective	None
Laboratoire	None
Lacrema	None
Lady Bar	None
Lady Boop	None
Lady Noon	None
Lafayette live	None
Lago	None
Laila M	None
Laila M & Okidor	None
Lain	None
Lamont Prince live	None
Lampenfieber	None
Laolu	techno
Lapsus	trance music
Lapsus Music	None
Lara Valentina	None
Laris Alexander & Gil Von De	None
Larkian	None
Larry Gus	None
Larry McMillen	None
Lars Wickinger	None
Larytta	techno
Lauhaus	techno
Laurent Charbon	rap
Laurent Garnier	techno
LausanneBerlin	None
LausanneZürich	None
Lawrence	country
Lawrence English	drone
Lazerslut  Berlin	None
Lazy Mouth	rap
Lcp	None
Le Bleu du Ciel et les élèves de lEcole de Cirque	None
Le Bérger	None
Le Centitme Singe	None
Le Citadin	None
Le Clou	None
Le Freak	None
Le Horla	None
Le Petit Prince	None
Le Peuple de LHerbe	dub
Le Spectre	tekno
Le Voleur	None
Le collectif Oscil8 fait son premier tour de piste à Lausanne	None
Le team Brown S a été créée en 2007 Il regroupe deux amoureux de House Music à savoir Black Martini et Alex Kuem	None
Lecture w Sassy J	None
Lee	country
Lee Burridge	house music
Lee Burridge  All Day I Dream	None
Lee Gamble	idm
Lee Jones	folk
Lee Van Dowski	techno
Leeman	None
Leeroy Thornhill	breakbeat
Legowelt	techno
Lemka	None
Lemonade	balearic
Lemonick	disco
Lemonick  Argent Sale  Couleur 3	None
Len Faki	techno
Lerosa	techno
Les Chicklettes	None
Les Manchots	None
Les Points live	None
Les membres	None
Les voleurs de swing	None
Lesničar	None
Levin	rock
Lewis Duggleby	None
Lewski	None
Lewski & Benito	None
Lexx	disco
Lexy	None
Liebe Detail	None
LiebeDetail	None
Life & Death	None
Light Motiv	None
Lila Hart	techno
Lime	disco
Limited brothers	None
LineUp Friday	None
LineUp Saturday	None
Lineup Friday 12082011	None
Lineup Saturday 1382011	None
Lineup Saturday 1482010	None
Lineup Sunday 1482011	None
Lionel Stephan D	rap
Lionel Stephan D aka little	None
Liquid	fourth world
Liquid Audio	None
Liquid Limbs live	None
Lissabon	None
Little Barrie	modern blues
Little Lu	None
Littlehouse showcase  Genève	None
Liv Stone	rap
Live DÃ¼rerstuben	None
Live Dürerstuben	None
Live I Heart Sharks	None
Live Radioshow by Pierre Lewinsky	None
Livio & Roby	techno
Loccomotion	None
Loccomotion  Argent Sale  CH	None
Loco Dice	techno
Loco Lita  Basel	None
Logistics	drum and bass
London	classical
London UK	None
LondonBarcelona	None
LondonNew York	None
Lonski & Classen feat Miranda	None
LooKee	None
Look Like	house music
Lopazz	techno
Lorax	movie tunes
Lord Soft	None
Lorik	hip hop
Loris Scaglia	None
Lost Frequencies	house music
Lost Heritage	None
Louh	None
Louie Austen Live	None
Louie Vega	house music
Louis De Fumer  Electro Swing	None
Louisahhh  US  Bromance Rec	None
Louise	None
Lovataraxx	None
Love Motel live	None
Low Jack	house music
Low Motion Disco	balearic
Lowrel & Hardy	None
Lowris	techno
Loïc Sottas	rap
Lu K	None
Lu Siegwart	None
Luca Agnelli	rap
Luca Castillo	house music
Luca Fioretti	None
Luca Torre	techno
Luca Torre  Recycle records	None
Luca Torre vs Ben Larsen	None
Luca de Grandis	None
Luca de Grandis aka Der Schuft	None
Lucas Aliu	techno
Lucas Monème	None
Luciano	operatic pop
Lucianou2028	None
Lucigene	None
Lucy Railton	None
Luka Torre	None
Lukatoyboy	None
Luke	country
Luke Miskelly	techno
Luki	None
Luki Music	None
Luna City Express	techno
Luzern	None
Ly Sander	house music
Lynx  Hospital  Detail  UK	None
MADE IN SWITZERLAND	None
MAHMOOD	None
MAIN STAGE	None
MANDY	pop
MANS1	None
MARCO Trinkler	None
MARCO Trinkler  Sunday Breakfast	None
MARLA	None
MASH	halloween
MATHIAS STRAHLE	None
MATIJA	None
MATILDA	hollywood
MATT MANIK	None
MATTHIAS SCHAFFHÄUSER	None
MAURIZIO	classical
MAnimals	None
MC Drisco	None
MC FAVA	None
MC Fava	None
MC Fava  Commercial Suicide	None
MC PAPS  Mc  GE	None
MC Paps	None
MC Raf	None
MC Riya	None
MC SOLAAR	chanson
MC STONE  Neurocide  CH	None
MC Skywalker	None
MC Skywalker  GE	None
MC Soze	None
MC Stone	None
MC Stone  Neurocide  Fribourg	None
MERCREDI 11 AVRIL	None
METRIK TEKNOMAD  Astrofonik	None
MEX	deep cumbia sonidera
MGF  ALL	None
MGMS  CH	None
MIA	electronic rock
MIGUEL	pop
MINIMAL	None
MIRCO MENDOSTA	None
MISTA TRICK  SwingNBass	None
MITIKAL  dnb jump up	None
MITIKAL  drum & bass  GE	None
MMM	techno
MN	None
MNÃVR	None
MNØVR	None
MONSIEUR JUSTE	None
MR MIKE	rap
MR RIDDLER	None
MRI	None
MRZ live	None
MRux	disco
MT Dancefloor CLUBRAUM Utah Saints	None
MUnited	None
MXProject	None
Maaret	None
Maastricht	None
Maceo Plex	house music
Maceo Plex  Ellum Audio	None
Maciek Norowol	None
Macy Gray	soul
Mads Penthouse named JetLag	None
Madwave	None
Magda	techno
Mah Mood	None
MahMood	None
Maickel Esse	None
Main Room	None
Mainfloor	None
Makam	None
Makau & Kagl	rap
Make Plain	None
Mala	flamenco
Malicious Joy	None
Malik Sabotage	None
Malki	None
Malki  Deep Fuzz	None
Mambo Chick	None
Man of Tomorrow	None
Manish	healing
Manon	techno
Manuel Fischer	None
Manuel Moreno	None
Manuel Resch	None
Manuheme	None
Many People	None
MarT	swedish punk
Mara Trax	hip hop
Maral Salmassi	techno
Marc Antona	techno
Marc DArrigo	techno
Marc Fuhrmann	None
Marc Houle	techno
Marc Milner	rap
Marc Poppcke	techno
Marc Romboy	techno
Marc Vedo	house music
Marcel Bros	None
Marcel Vogel	None
Marcello Carozzi	techno
Marco	tropical
Marco Basile	None
Marco Berto	rap
Marco Capone	None
Marco Carola	techno
Marco Carvalho	None
Marco De Rosa	house music
Marco Falkone	None
Marco Faraone	techno
Marco Repetto	None
Marco Repetto live	None
Marco Trinkler	None
Mardoch	None
Marek Hemmann	techno
Margaret Dygas	dub
Maria Blessing	None
Mariano Mateljan	None
Mario Aureo	None
Mario Nyfeler	None
Mario Robles	None
Mario White	techno
Mark Faermont	rap
Mark Fell & Keith Fullerton Whitman	techno
Mark Henning	techno
Mark Off	None
Mark Rhein	house music
MarkOFF	None
Markese	None
Markus Kenel	house music
Markus Lindner	techno
Markus Lindner  Cityfox	None
Markus Lindner  Stadtpark	None
Markus Lindner  Stadtpark  Cityfox Wien	None
Markus Steinhauer	None
Markus haZe	None
Marla	None
Marlon	None
Marlon Hoffstadt & HRRSN	rap
Marlowe	hip hop
Marner	None
Marque Strawinsky	None
Marquez Illu200b	None
Marshall Jefferson	house music
Marshall White	techno
Martin	house music
Martin Buttrich	techno
Martin Huergo	techno
Martin Kleinert	None
Martin Meier	None
Martin Solveig	house music
Martinez	pop
Marvin J	None
Marwin	None
Mary Jane	funk
Mas Ricardo	None
Masaya	hip hop
Mass Prod	None
MassimilianoM	None
Massimo Brugnera	None
Massimo Stefanelli	rap
Massive Jay	None
Massive Jay  DJPlacid  Everstone  Quitim  Fabian Kozelsky  Joel Gautsch  Nenad J	None
Master Seb	None
Mastra	deep
Mastra live	None
Matador	francoton
Matek	None
Mateo Morales	None
Mathew Jonson	techno
Mathon	None
Matias Aguayo	microhouse
Matija	None
Matt Grey	None
Matt Grey & Cos	None
Matt Kay	house music
Matt Star	techno
Mattafix	None
Matteo Spedicati	rap
Matteo Spedicati & Alessio Mereu	rap
Matthew Dekay	deep progressive trance
Matthew SQuare	None
Matthew Square	None
Matthias Tanzmann	techno
Matthias Tanzmann  Moonharbour	None
Mattoo	techno
Matu	rock
Mauro Picotto	house music
Mauy	None
Mavi	None
Max	pop
Max Cooper	house music
Max Grell	None
Max Klebson	None
Max Romeo	reggae
MaxImHouse	None
Maximilam Stolze	None
Maximilian Berg	None
Maximilian Berg  Official	None
Maxmillion Dunbar	idm
Maxxi Soundsystem	disco
Maztek	drum and bass
Mc Fava	None
Mc Jerique	None
Me & My Monkey	rap
Me First and the Gimme Gimmes	punk
Meda	albanian pop
Median Structure DJs	None
Meffekt	None
Meggy	rap
Mehhr & Beda	None
Mei ZhiYong	None
Meienberg	None
Mekanics	None
Mel Mercury	None
Melodiesinfonie	ambeat
Melokind live	None
Membrane	covertrance
Mendez & Lombardo	None
Mendo	house music
Mensch & MurÃ¤ne	None
Mensch & Muräne	None
MentalX	None
Mentor	None
Mercury	rock
Merkur  Japan	None
Mess Me	electro trash
Metalheadz	None
Metope	techno
Metrik	drum and bass
Metropolitan parc	None
Metrotokyo	techno
MiNa	ye
Mia	electronic rock
Mia Kaltes	None
Micha Dutch	None
Michael Deep	house music
Michael Mayer	house music
Michael Pfister	None
Michaelmusic	None
Michal Ho	None
Michel Cleis	None
Michel Degen b2b Atila	None
Michel Morard	None
Michel Sacher	None
Mickail	None
Mickey Morris	None
Micrometropolice	None
Mideric	techno
Midilux	None
Midéric	None
Miguel	pop
Miguel  Smalltown Collective	None
Mihalis Safras	techno
Miiir	None
Mik Maroo	None
Mika Dutch	None
Mike Dyson	None
Mike Grieder	None
Mike Huckaby	house music
Mike Scoop & Bangokid	None
Mike Servito	techno
Mike Teixeira	None
Mike Waulie	None
Mikkel Metal	techno
Mildred Guy B2B Condor	None
Millivolt	None
MilosD	None
Milow	rock
Mind Against	techno
Mind Void LIVE	None
Mindfunk B2B DomK	None
Mindtrick  NL	None
Mini Bashekim	None
Minidetail  Lausanne	None
Minilogue aka Sebastian Mullaert	None
MinimalHouse Floor	None
Minton  MinimalFraktion	None
Minus	screamo
Mirco Caruso	hip hop
Mirco Mendosta	None
Mirk Oh	None
Mirko Loko	techno
Mirko Loko aka Lazy fat People	None
Mirko Molinari	house music
Miro Pajic	rap
Mirweis Sangin	None
Misi Berczelly	None
Mismatch	None
Mismo	None
Miss Golden G & Crotek	None
Miss Melera	house music
Miss Peel	None
Missil	None
Missy Jay	house music
MistaMista DJ	None
Mister Kriz	None
Mitika	None
Mitikal	None
Mitikal  Sinister	None
Mitsutek	techno
Mitsutek DJ	None
Miwon	ambient
Moa Club	None
Mobilee	None
Mobylette	None
Model500 Live	None
Modern Love	None
Modernity	None
Moe & Zard	None
Moe&Zard	None
Moezard	None
Mohammad	arab pop
Molly	punk
MonblockB	None
Moniak	None
Mono  Weiss	None
Monokid & der Samtbody	None
Monolix	techno
Monome	rap
Monome & Mitsutek	techno
Moon B	house music
Moon Harbour	None
Moonraisers	rock
Moosfiebr	techno
Moral	None
Morard	None
Moritz Wettstein	None
Moritz Wettstein aka MRZ	None
Morris	country
Morris Malone	None
Motion Lab VJ Team	None
Mountain People	techno
Mountain People DJs	None
Mouseen & Denny	None
Mouseen & Denny  Circle Of Love	None
Mousti	None
Move D	techno
Moving Shadow  UK	None
Mr Flazh	None
Mr Jonk	None
Mr Jonk B2B AARON JEHRO	None
Mr Mendel	None
Mr Peña	None
Mr Pigman  Tomorrow is Today  BIENNE	None
Mr Raoul K	techno
MrOuch	None
Muck	redneck
Muck b2b Trigun	None
Mule & Man	None
Muller System	None
Multivitamins	None
Munken	None
Murat	turkish pop
Murciano	house music
Music is Music	None
Musics Light	None
Mutlu	rap
Muzi	None
My Daily Noise	None
My My	techno
My Panda Shall Fly	None
Myah	None
Mylky Way	None
MÃ¡tyÃ¡s	None
Mátyás	None
NACA	None
NEMO	progressive
NESTOR KEA	None
NEWCOM	None
NICO MASSA	None
NICOLAJ	None
NIGHTSOMMAR	None
NIK & SOULT	None
NIK FRANKENBER VS JOHN DEPARDY	None
NIRSO  electro tropical sonido tropico dj set  BR	None
NIXX	None
NOIR	pop
NOVALIMA  afroperuvian	None
NVRWRK	None
Nabin & RamyRes	None
Naca	None
Nacha	spanish new wave
Nader	techno
Nadia aka Becky Slater	None
Nakadia	techno
Naked Tunes	None
Nancy	rock
Narod Niki	None
Naskal	None
Nastia	None
Nat	christmas
Nata	None
Nathan Fake	house music
Natis Merio	None
Ned ONeal  MinimalFraktion	None
Neek	None
Neevo	None
Neljane	None
Nelson De Jesus	None
Nelson Garcia	dominican pop
Nemelka	None
Nenad J	None
Nenad J  Mickail  Senyc  Massive Jay	None
Nenad J & ToBe	None
Neneh Cherry & Rocketnumbernine	None
Neon Indian	electronic rock
Nervo	house music
Nessuno	None
Never Die	None
NewCom CLUBRAUM Black Devil Disco Club	None
Newfact Music	None
Ngoc Lan	vietnamese pop
Nice try records showcase  Zurich	None
Nici Faerber	hip hop
Nick Curly	house music
Nick K	None
Nick Larson	None
Nick Warren	minimal
NickBee  Invisible recordings	None
Nicky Blackmarket	jungle
Nicky Blackmarket  dnb jump up  UK	None
Nico Canzoniere	None
Nico Massa	None
Nico Massa & Elay	None
Nico Stojan	house music
Nicola Kazimir	disco
Nicola Kazimir & Audino	rap
Nicola Kazimir & LOUH  Punkt	rap
Nicola Koch	techno
Nicola Noir	None
Nicolas Duvoisin	rap
Nicolas Duvoisin & tsacK	rap
Niconé	house music
Night Talk	house music
Nik	rock
Nik  Ink	None
Nik DJ	None
Nik Frankenberg	None
Nik OUS	None
Nik dj	None
Niko Schwind	deep
Nikola Kotevksi aka Nick Nasty	None
Nikolas Wabe	None
Nils Hoffmann	deep
Nils Twachtmann	disco
Nima Gorji	techno
Nimm 2	house music
Nina Kraviz	techno
Ninette	None
Nite Jewel	escape room
Nkelo	None
Nkelo live	None
No J Rohrschacht	None
Noa	None
Noar	None
Nobodys Perfect Dj	None
Noir	pop
Noisia	drum and bass
NolÃ¨	None
NolÃ©	None
Nolè	None
Nolé	None
Nordstern	None
Nore En Pure	None
Norm Talley	house music
Noromal&Somi	rap
Nos partenaires	None
Nouvelle Vague	downtempo
Nova Heart live	None
Nu Audio Collective	None
NuAudio Collective	None
Nungan	None
OASE	None
OCTAN	None
OMAR PERRY  reggae  JAM	None
OP9  live feat Air Bacha	None
ORION & MOLE	None
OUTDOOR FLOOR	None
OWNO	None
OXA	None
Oase	None
Oben Am Berg	None
Obscene	None
Obscene  USA	None
Octave One	techno
Offstream DJKollektiv	None
Okain	techno
Okidor	None
Oktay	None
Oktay  XtraTamed  Lausanne	None
Okïn	None
Olafson	techno
Olga Korol	None
Oliver Aden & Luis Cruz	None
Oliver K	hip hop
Oliver Raumklang	house music
Oliver Schories	house music
Olivier Kolly	disco
OlstrÃ¶m	None
Olstrïm	None
Olström	None
Olöf Arnalds	icelandic pop
Ondrej	techno
Ondrej Kumquat	None
One Circle	hardcore
One Track	None
OneFootStep	techno
Oneman bands	None
Onory  Serotonic	None
Onur Özer	techno
Onur Özur	None
Oo  Plak Records	None
Opuswerk	techno
Oram Modular	None
Oram Modular  12 Club  Genève	None
Oram Modular  12 Club Genève	None
Oram Modular  Geneve	None
Orange Dub	None
OrangeMusic  On The Top	None
OrangeMusic on the Top Winner	None
Orion & Mole	None
Orion&Mole	None
Osaka  live act	None
Oscar Schubaq	house music
Oslo	orchestral
Osunlade	house music
Otist Riddim	None
Overwerk	uk garage
Ovum Recordings  IRL	None
Oxsa	None
PADOLINO	None
PAPS  MC  GE	None
PARADISE STAGE Jamie Jones	None
PASCAL DI BONGO	None
PASK	None
PAT KP	None
PAT PATRISHA	None
PAUL BART	rap
PBell	None
PBell  Christian LÃ¶ffler	None
PBell  Christian Löffler	None
PBell & Mitsutek	None
PETER DIGITAL ORCHESTRA live	None
PETER STOFFEL	None
PETER STOFFEL Genève	None
PHIL ZVIEL & AFTER GRAUER	None
PIXELPUNX	None
PROOF OF CONCEPT	None
PTess	None
PYLONE	electronica
PYTHIUS  Blackout	None
PaTee & Maria Blessing	None
PaTee & Pbeat	None
Pablo Color	None
Pablo Einzig	techno
Pablo Nouvelle	house music
Paco	flamenco
Pad Beryll	house music
Padded Cell	balearic
Pam & Mi	None
Panacea	None
Panause	None
Pandallougi	techno
Pao	techno
Papiro	None
Para One	house music
Parabois	None
Parallel  Berlin	None
Paris	uk garage
Parquet Recordings	None
Pascal FEOS	techno
Pascal Greco	None
Pascal Hofer	None
Pascal Inc	None
Pascal Viscardi	house music
Pasci	None
Pat	rap
Pat Heart	None
Pat Patrisha	None
Pat patrisha	None
Patee	None
Path	screamo
Patlac	disco
Patric la Funk	None
Patrick	movie tunes
Patrick Chardronnet	house music
Patrick Podage	groove room
Patrick Podage & Laura Wiesmann	rap
Patrik Soderbom	techno
Patrique	None
Patrischa	house music
Patryk Molinari	house music
Paul Darey	rap
Paul Eg	techno
Paul Heimweh	None
Paul Oakenfold	trance music
Paul Poulson	None
Paulette	None
Paulo César	brazilian gospel
Paulo Olarte	None
Pavel Prince b2b Tiano Thomas	None
Pawlikowski	classic polish pop
Paws	rock
Paws live	None
PazTeQ	None
Pazkal	house music
Pazul	house music
Peace Club	None
Peak	None
Pedro Andrade	None
Pedro Pereira	None
Pele	disco
Penetration Records	None
Pentaklon	None
Pepperpot	techno
PepÃ©	norteno
Pepé	banda
Percussion congas Edwin Sanz	None
Perle der SÃ¼dsee SHEDHALLE Des Wahnsinns Fette Beute	None
Perle der Südsee SHEDHALLE Des Wahnsinns Fette Beute	None
Perlon	None
Perry Pierce	None
Pet Conspiracy live	None
Petar Dundov	techno
Pete Tong	house music
Peter D	techno
Peter Stoffel & Cobeia  Electronic boogie woogie action pack	None
Peter Wanden	None
Petre Inspirescu	None
Petrol Patrol	None
Pettinato feat Schwede	None
Peverelist	bass music
Phace  Neosignal	None
Phala	None
Phear	None
Phil	rock
Phil Cole	disco
Phil Riss & Ali C	None
Phil Riss b2b Ali C	None
Phil Wild	None
Phil Wild b2b Agent C	None
Phil Wild b2b ZGroove	None
Philip Bader	house music
Philip Weibel	None
Philipp Weibel	None
Philippe Petit	techno
Phree Music	None
Phrex	None
Phucking Happyend	None
Pi Why	None
Pia Poke	None
Piemont	techno
Pierre Bastien	minimal
Pig & Dan	house music
Pikaya	techno
PillowTalk Concert &	None
Pilocka Krach	disco
Pingu	None
Pino	deep ccm
Pipol	None
Pit & Pat	house music
Pit Mitchel	None
Pita	None
Pitch Black	psychill
Pixelpunks	None
Pixelpunx	None
PiÃ©rick	None
Pièrick	None
Piérick	None
Placid	house music
Plastic City Rec	None
Platform	None
Play & Prez	None
Play Lego Bitch	None
Play it Loud	None
Playground	grunge
Playlove	techno
Playpad Circus	None
PleasureLab	None
Pnom Pen  Oscil8	None
Pol Wise	None
Pola	None
Polar Inertia	dub
Poljak	None
Pomelo  Zurich	None
Porn Sword Tobacco	ambient
PortableBodycode	None
Possessedby	None
Pozzo	None
Praslea	rap
Praslesh	None
Praxis Records	None
Premiesku	house music
Press C	None
PressC	None
Presscode	None
Presscode  JurRecords	None
Presscode b2b Muck	None
Primr aka Temiri	None
Princess P	None
Profondo	None
Profound	None
ProgressTunes	None
Projektil	None
Propz & Rowney	None
Prospect	None
Proximo	None
Psyche	electronic rock
Psyko	hardstyle
Ptess	None
Punks Jump Up	electronic rock
Pushkin Noize	None
Pye Corner Audio	house music
PÃ¤r Grindvik	dub
Päde	musique concrete
Pär Grindvik	dub
Q&A with Bruno W	None
QBig  Elevation Music	None
Quad Damage b2b Infenal Bastard	None
Quad Demage	None
Quarion	techno
Quartier Kruz	None
Quentin Harris et Sandy Rivera	None
Quenum	techno
Question & Exclamation Mark	None
Quitim	None
Quitim & Massive Jay	None
R3hab	house music
RABA	manele
RAT	dancehall
RAWG	None
RBDdrive	None
REBOOT	techno
RHYTHM	rock
RINO	rap
RINO  Cityfox	None
RINO  Cityfox Zürich	None
RIZZOKNOR live	None
ROBYN CHAOS	None
ROLF IMHOF	None
ROOM 1	vocaloid
ROOM 2	None
ROSP	None
RSS Disco	house music
RUMORY	None
Rabih Beaini	mandible
Radio DRS Virus	None
Radio Slave	techno
Radio with Pictures	None
Radiorifle	None
Rafael Anton Irisarri	drone
Rafael Kleim	None
Ragesh Nair	techno
Ragu  Whats House  SO	None
Rahaan	None
Rainer	techno
Raise	None
Ralf	None
Ramin	scorecore
Ramon Lorenzo	None
Ramon vs Mercury Fall	None
Rampa	deep
Ranja&Eldo	None
Ranno	None
Rapu & Nekow	None
Rare Movement	hip hop
Raresh	None
Raum	anti-folk
Raw & Mental House Music	rap
Raw Shan	None
Raz Ohara	house music
Razha	None
ReUP	None
ReYou	disco
Rearte	None
Reas	hip hop
Reboot	techno
Recarey	None
Recondite	house music
Record Release Party	None
Red pig flower	techno
Redshape	techno
Reese Bau	None
Reggae Riot Sound	None
Regional Liga	None
Rehbellen	None
Reiter & Hofer	rap
Rekah	None
Rekah  CBK	None
Reklok	None
Relâche	None
Remute	techno
Remy Kersten	None
Rene LaVice	drum and bass
Rene Lahar	None
Rennie Royma & Kare Kyl	None
Rennie Royma & KÃ¤re Kyl	None
Rennie Royma & Käre Kyl	None
Rennie RÃ¸yma	None
Rennie RÃ¸yma & KÃ¥re Kyl	None
Rennie Røyma	None
Rennie Røyma & Kåre Kyl	None
Renè S	None
Repos & Gabriel Stampfli	None
Resident dj	None
Resoe	techno
Reto Ardour	techno
Reto Ardour  Hive Audio	None
Reverend BeatMan live	None
Rework	techno
Rex the Dog	electronic rock
Rho	rap
Rhythm Family Soundsystem	None
Ribordy Al Alcazar	None
Ricardo Villalobos	techno
Ricardo Villalobosu2028	None
Riccardo Farina	None
Rice & Beans	None
Richard Dorfmeister	downtempo
Richie Hawtin	techno
Richtaste	None
Richy Ahmed	house music
Rico Rausch	None
Riddler	None
Riki Ustrell	None
Riley Reinhold	None
Rina Lou	None
Rinaldo Makaj	rap
Rino	rap
Riotboy	None
Ripperton	soul
River Ist BÃ¶se  Afterhour	None
River Ist Böse  Afterhour	None
River Ist Lieb	None
Rizzoknor	None
Ro&Mat	None
Roach	rap
Rob Tailor	None
Robby Naish	None
Robel	None
Robert Babicz	techno
Robert Curgenven	nu age
Robert Dietz	techno
Robert James	disco
Robert Nesta	None
Robert Piotrowicz	electroacoustic improvisation
Roberto De Carlo	rap
Robin Hirte	rap
Robin Ivan	None
Robin Schulz	house music
Rocca	None
Rocket Van	None
Rocketnumbernine	None
Rockwool	None
Rodion	disco
Rodri	None
Rodrigo y Gabriela	flamenco
Rodriguez Jr	techno
Roger Sanchez	house music
Rogi	None
Rohan	techno
Rolf Imhof	None
Rolf Saxer	disco
Rollercone	electro jazz
Rollin John  Divercity  Zurich	None
Rom Beads	None
Roman Flügel	house music
Roman Klinger	None
Roman Leonardi	None
Roman Stelzenbach	None
Romano	country
Romano Rapeso	techno
Ron Shiller	None
Rondel	None
Room 1 ambiance Deep Groove avec	None
Room 2 ambiance Tech Soul avec	None
Rose&Ulysse	None
Rossko	techno
Rotkeller	rap
Rottun	None
Round Table Knights	hip hop
Roustam	techno
Royal Frass Club	None
Royal Muzik RMS	None
Rozzo	techno
Rubinsteig	techno
Rudolf Eber	None
Ruede Hagelstein	techno
Rumlaut	None
Rumory	None
Rumory AKTIONSHALLE Wighnomy Brothers	None
Rumpeldisco	None
Rumpistol	electronica
Running Back	None
Russ Yallop	disco
Russell Haswell	idm
Ryan Clark	None
Ryan Crosson	techno
Ryan Crosson  Visionquest	None
Ryan Davis	techno
Ryan Hawkin	techno
Ryoji Ikeda	idm
Ryuko	None
Rødhåd	techno
S	pop
S S S S	pop
SAAL	rap
SALVA DI NOBLES	None
SAMEDI 14 AVRIL	None
SANKEYS STAGE Davide Squillace	None
SAv	None
SCHNAUTZI  Argent Sale  CH	None
SCRATCHOPHONE ORCHESTRA  electroswing live  FR	None
SENSE	None
SENSE  Basel	None
SERKAN	german show tunes
SHAKA	banda
SHE Spells Doom	rap
SKANKIN SOCIETY  GE	None
SKRYPTÖM  PARIS FR	None
SMorSillo	None
SONIK	None
SONO PIRATE UNIT CREW  SPU	None
SPY	drum and bass
ST LÔ	techno
STAVA	None
STEPHAN EICHER	chanson
STEPHANE DONOVAN PUPILLO	None
STRESSu2028	None
STYRO2000	None
STwo	deep indie r&b
SUBTIF 2	None
SUMO	None
SUPANOVA	None
SUPERLIVE live feat Andaloop	None
SUPERSMAX	None
SVARTVIT	None
SVENSKJ & TALIB	None
SYMBIZ live	None
Saben	None
Saben  Whats House  SO	None
Saint Pauli	electronic rock
Saint Peak	None
SaintHarare	None
Sakrou200b	None
Salar	persian pop
Salvatore Freda	house music
Sam Corso	None
Sam Divine	house music
Sam K	rap
Samantha	hi-nrg
Samedi 1010 Les 30 ans du Patron  Deep to Tek	None
Samedi 1710 Desperados Night	None
Samedi 24 Mind  Agape	None
Samedi 310 Vinyl Only	None
Sampayo	None
Sampras	None
Samuel Kerridge	mandible
Samuele	None
Samy	german
San Marco	deep orchestral
San Proper	techno
Sandro	None
Sandro Kuhne	None
Sandro Kühne	None
Sandro Sincero	None
Sandro Vitalini	None
Sandro ZH	None
Sanity	screamo
Santis	techno
Santoro&Blair	None
Santé	deep
Sarah	pop
Sarah Main	house music
Sarna	techno
Sascha Braemer & Niconé	house music
Sascha Dive	techno
Sascha Sonido	house music
Sascha Stohler	None
Sascha Stohler & Arnstroem	None
Sascha Stohler & MNOVR	None
Sasse	techno
Sassy J	fake
Sat 2200  0700	None
Satanic Surfers	punk
Satori	house music
Sav	None
Sche Sche	hip hop
Scheinwerferli	None
Schild K	None
Schimpy	techno
Schlammpeitziger live	None
Schld	None
Schlepp Geist Live	None
Schmerol	None
Schmolke7	None
Schnautzi	None
Schnautzi  Argent Sale  GE	None
Schwebekastenjunge	None
Scrap & Jimi Jules	None
Scum	horrorcore
Seamus Haji	house music
Seb Mara	None
Seb Zito	techno
Sebas O Verde	techno
Sebastian Bosco	None
Sebo K  Mobilee	None
Seidensticker & Salour	None
Selim & Armin	None
Sender	progressive uplifting trance
Senefelder	None
Senor Zazou	None
Sentiment	None
Senyawa	None
Senyc	None
Senzen	None
Septentrio & Askemwhy	None
Serafin	opera
Serafino	None
Sergio Dream	None
Sergio Martella	None
Sergio Mesa	None
Serkan Denizer	None
Servet Argin	None
Sese	None
Setaoc Mass	dub
Seteve	None
Seth Troxler  Visionquest	None
Sety	techno
Seuil	techno
Several Definitions	house music
Severin  Karera Rec  SO	None
Sexbeach	None
Shaalan	None
Shabba	reggae
Shaddah Tuum	None
Shahira	None
Shaka	banda
Shake It Maschine  Tomorrow is Today  BIENNE	None
Shawnecy	techno
She Jubilee Dj	None
Shibo Gonzales	None
Shingo Suwa	hip hop
Shlomi Aber	techno
Shogun Audio	None
Shonky	techno
Shovell	None
SiMo	house music
Sick Spud	None
Sickerman live	None
Sid Le Rock	hip hop
Sidney Dry	None
Sil B	None
Silencio  Genève	None
Silent Rabbit	None
Silva & Loco	None
Silvan und Stephi	None
Silvano	None
Silver & Loco	None
Simian Keiser	None
Simoli Brothers	None
Simon Baker	techno
Simon Lemont	None
Simon Slice aka Khainz	None
Simpig	rap
Sinkane	None
Sinner DC	techno
Sinner DC & Jacen Solo	techno
Sinner DC & Spectrum aka Sonic Boom	techno
Sinneswandel	None
Sins	None
Sins  WF  Genève	None
Sins  WFmusik	None
Sins  wfmusik	None
Sinusite	None
Sirion Rec	None
Sis	rap
Sisyphos	None
Size	drum and bass
Skaos	ska
Skrizza	None
Skudge	dub
Sky Janssen & Ezikiel	None
Sky Janssen Ezikiel	None
Skyr	None
Skywalker  GE	None
Slat 5	None
Sleek aka Liquid Soul	None
Slow To Speak La Main Mise  Paris	None
Slowhands	rap
Smallvile  Francfort	None
Smash FX	None
Smokey Joe and the Kid	nu jazz
Smoking Room	None
Smoky Smoky	None
Snuffo	None
Snur	None
Sobuth & Weiss	None
Social Disco Club	balearic
Softy	None
Sofus Forsberg	rap
Soloduo	classical guitar
Solomunu2028	None
Soma	post-screamo
Sometimes in arts	None
Somogo	didgeridoo
Somtek	disco
Soner  Lost In Noise  SO	None
Sonica	rock
Sonik	None
Sonja Moonear	None
Sonja Moonearu2028	None
Sonny Catanese b2b Lucas Ramirez	None
Sonodab	techno
Sopha	None
Sordo	None
Sory Kaba	None
Soukie & Windish	house music
Soul Clap	house music
Soulmate Inc	None
Soult	None
Sound Centric	techno
Sounds of Earth	None
Soupape	None
Sous Sol	rap
Soweso Rec	None
Space Dimension Controller	house music
Space K	None
SpaceK	chamber psych
Spanks	None
Spatz Habibi	None
Special Guest	None
Special Guest  Gunnar Stiller	None
Special Guest  Sable Sheep	None
Special Night by Cadenza	None
Special guest	None
Specialivery	techno
SpectraSoul	drum and bass
Spectral Mirror	None
Spellbound DJs	None
Spice 52	None
Spiral Hand	None
Spleen United	danish pop
Spoek Mathambo	None
Squash	None
Squirrel	swing
St Plomb	None
StPaul	None
Stacey Pullen	techno
Stadtpark	None
Stalker	None
Stanton Warriors	breakbeat
Stasis Recordings	None
Stavros	rock
Steefunk	None
Stefan Goldmann	techno
Stefan Nolic	None
Stefano Di Miceli	None
Stefano Loat	None
Stefano Rinaldi	None
Stefano Ritteri	None
Stefano rinaldi	None
Stellar OM Source	hauntology
Stenchman	uk garage
Stephan Bodzin	techno
Stephan Grieder	None
Stereo Riders & DJ Big B	None
Stereociti	house music
Steve Bug  Pokerflat Berlin	None
Steve OSullivan	techno
Steve Sanders	None
Steven Sanchez  La ruche	None
Sthepan Esse	None
Stikmoo	None
Stilbruch	None
Stilspiel & BodenLos	None
Stimming	techno
Stipe	rap
Stof Terrier	None
Stoga	None
Storlon	None
Storm	environmental
Strassenmajor	None
Strb	None
Strb  Tissu	None
Strb b2b Nemelka	None
Stride Night  be	None
Stripe	hardcore
Strobetech	None
Strotter Inst	None
Stu	indie
Stubborn Pace	None
Studer TM & MC 45	None
Studio Barnhus  SE	None
Styro	None
Styro 2000	None
Styro2000	None
Suara	otacore
Subban	None
Subjected	dub
Subsistenz	None
Subversion officiel	None
Suddenly Neighbours	None
Sueshi	None
Suffix Visuals	None
Sun Afterhour 1300  2100	None
Sunisit	None
Sunny Graves ES  Live	None
Super Flu decksnfx	None
Superpitcher	techno
Superposition DJs	None
Sur le pont 18h  22h	None
Svart	black
Sven Dohse	disco
Sven Väth	techno
Sven Väthu2028	None
Svensk Fisk	None
Svenskj	None
Svenskj & Talib	None
Sw	None
Sweden	None
SweetLife	None
SweetnCandy	None
Sylek	None
Syndrom	None
Synonym Blau	None
Synthquest	None
Syntosil	None
Sysmic	None
Sysmik	None
Systematic	grunge pop
SØS Gunver Ryberg	None
T Raumschmiere	hip hop
TAT vs Ozexia	None
TBA	techno
TBC	None
TCF	None
TECHNICAL ITCH	drum and bass
TECHNO	None
TEDDYson	soca
TEKNOSTAR	None
TERRY PARDINI	None
THE ANIMALS	rock
THE CAT	None
THE CLEMENTIMES	None
THE LEGISTS	None
THE MICRONAUT	None
THE SKATALITES	ska
THE TRASHFORMERS	None
THEO	jazz
TINI	hip hop
TIT  CH	None
TNT	None
TOMMY LIEBHARDT	None
TONIC	rock
TROPICAL CONTINENT SOUNDSYSTEM feat DJ Rumory	None
TRX b2b DJ Frontline b2b Mr Breakds  Project Riot	None
TRaumschmiere DJ	None
Tableturner Duo	None
Tagedeep	None
Taktlos	german street punk
Tale Of Us	techno
Tale Of Us  Crosstown Rebels	None
Talib	hip hop
Tallo	None
Tanua	techno
Tanzkarussell	None
Tapesh	house music
Tarab	lowercase
Tarco	None
Tardis Labelnight	None
Tarpon	None
Tastatur	None
Techno	None
Techno  Makhno	None
TechnoTech House Floor	None
Tedi B2B Bigraf	None
Tee Moe	None
Teenage Mutants	house music
Teenager in Love	None
Teklicit Marsatek  FR	None
Terazzza	None
Terell Gucci Winchester	None
Terence Terry	None
Terminal M ZH	None
Terramossi	None
Terri B	None
Terrorist	None
Thalstroem	house music
The 2 Bears djteam	None
The Analog Roland Orchestra	disco
The Architects	None
The Bad Rabbit	None
The Bontempi DJs	None
The Bullet	None
The Circle Corner	None
The Club by Point Bar et TFT Events prÃ©sentent	None
The Club by Point Bar et TFT Events présentent	None
The Cruzaders	rap
The DIFFIKULT Crew	None
The Disciplines	rock
The Emperor Machine	balearic
The Frankenberg Show	None
The Gaslamp Killer	idm
The Gladiators	rock
The Hacker	electronic rock
The Hiiters	None
The Kooky Scientist	techno
The Legendary Reggae Riot Soundsystem	None
The Lovers	rock
The Martinez Brothers	techno
The Mole	techno
The National Fanfare of Kadebostany live	None
The Necks	dark jazz
The Panacea	drum and bass
The Pirates	None
The Pixel	None
The Rah	None
The Rich Mans Kitchen Orchestra	None
The Skatalites	ska
The Son of Dog	None
The Sonic Catering Band	None
The Sorry Entertainers	techno
The Space Lady	outsider
The Spirit Bar	None
The Spirit of October Week  1	None
The Stereo Youth	None
The Streets	uk garage
The Subways	rock
The Tight tINI Groove And Handsome Rumpelfunk	None
The Titties  Das Hutwerk	None
The Toxic Avenger	house music
The Trilogy Tapes	None
The Weaponstore	None
The Young Gods	rock
The ground floor	techno
Therapy Session	None
Theydream	None
Thom	None
Thom Nagy	None
Thomas AS	None
Thomas Kudrna	None
Thomas Luke	None
Thomas T	rap
Thomas Zopf	None
Throwing Snow	house music
Thug Entrancer	vaporwave
Tiano Thomas b2b Pavel Prince	None
Tief	None
Tiefglanz	None
Tiefschwarz	techno
Tigris & Neustadtneurothiker	None
TillTape	None
Tim & Puma Mimi	rap
Tim Exile	hardcore
Tim Green	techno
Tim vs Osama	None
Timnah Sommerfeldt	None
Timon Christen	None
Timoteo	sertanejo tradicional
Tina Frank	None
Tiorted	None
Titto La Rocka	None
To Be	None
ToBe	None
Tobi Dreipol	None
Tobi Hoeppner	None
Tobi Neumann	house music
TobiWAN Kenobi	None
Tobias Becker	None
Tobias Oliver	None
Todd Terry	house music
Toi Toi	None
Tom Alemanno	rap
Tom Kaiser	None
Tom Wineman	None
Tombass	None
Tommy Four Seven	schranz
Tommy four SevenPerto	None
Tomorrow is Today  GE	None
Tompaul	None
Tomy Gips	None
Tonga	None
Tonic	rock
Tony Nocera	None
Tony Sylvester	None
TonyP	None
Toolroom	None
Toots & The Maytals	reggae
Torn	None
Total Science	drum and bass
Toutes les infos sur wwwmambobarclubch	None
Township Rebellion	rap
Toxicangel	None
Tr3lux	None
Traumer	None
Traumtief	None
Tre Rose	None
Tre Rose Bros	None
Treibstoff	None
Tremendo	house music
Tremendo  Glam  Whats House  SO	None
Tresor foreplay Berlin	None
Tricky	downtempo
Trigger	None
Trigun	None
Trinidad	rap
Trip In	None
Tropic Of Cancer	nu gaze
Tropics	indie
Trotzkopf	house music
Troy Pierceu200b	None
Tube & Berger	house music
Tuccillo	house music
Tunay Can	None
Tunne	None
Turno  Low down deep  UK	None
Two Loops Low Tek	None
Two loops low tek	None
Two of a Kind	None
UA	rap
UBIK Sound System	None
UFREQS	None
UK	zapstep
USA	None
Ubik	idm
Uffie & Feadz	rap
Uhuruku	None
Ulrich Schnauss	post-disco
Ultra PlanÃ¨te	None
Ultra Planète	None
Umberto	None
Un JeNeSaisQuoi  F	None
UnderStanding	None
Underclownd	None
Universalfilter	None
UponYou	None
Urban Junior	garage punk blues
Uriel	None
Ursprung	None
Ursprung b2b XEED	None
V Kawumski	None
VACUUM  jump up  Lux	None
VALENTINO & HENRYSURE	None
VANA&TOBE	None
VANBERGER	None
VANDAL  Kaotik Records  FR	None
VD	None
VENDREDI 13 AVRIL	None
VENI VIDI VJ  httpwwwvenividivjcom	None
VERY SPECIAL GUEST	None
VILLABOSSO	hip hop
VITO	techno
VJ AbsUrda	None
VJ La Destr	None
VJ La Vue VJ Collective	None
VJ Mathias	None
Vacuum  Biological beats  LUX	None
Vadims Soundcatcher Tour feat DJ Vadim	None
Valentino Kanzyani	techno
Vanilla Ace	hip hop
Vanita	disco
Vanita&Shima	rap
Vanja	None
Vario Volinski	house music
Varoslav	techno
Vasy	None
Vegas & Bazhi	None
Vendredi 1610 Sound Mechanc	None
Vendredi 210 EHL Sound presents House  Techno Night Vol3	None
Vendredi 23  Deep in LausAngeles  Burning Man Decompression  Space K	None
Vendredi 910 Black Beats	None
Ventil	None
Vera	deep australian indie
Vessel	deep indie r&b
Vicky Devine	None
Vielfarbig	None
Viens taper du pied sur des rythmes électro et régaler tes oreilles de sonorités nouvelles Entre techno et house	None
Vijen Arman	None
Viken Arman	deep
Villa Bosso & Douglas AndrÃ©	hip hop
Villa Bosso & Douglas André	hip hop
Vinc Vega	None
Vinyl Team	None
Vinz Da Groove	None
Viper Recordings	None
ViperSwingm Spacek & Funky Chap	None
Virus	uk garage
Visionquest	techno
Visuals & Deko Pixel	None
Visuals & Deko by PIXEL	None
Visuals by Gregel Oirom	None
Visuals by Timowoodtv	None
Visuals by VJ LUPIN & GERTRUDE TUNING  FR & CH	None
Visuels Gertrude Tuning  Argent Sale  CH	None
Visuels Gertrude Tuning  Argent Sale  GE	None
Visâge Pale	None
Vitronic	None
Viuels & support  Tenuta	None
Viva Music	None
Vkee Madison	None
Vlad	None
Vlnolam Kawumski	None
Volkan Ocak & Claudio  Christoph & Oliver van den Miescher  Dario Todorovic	None
Volta	neo-psychedelic
Voltage	uk garage
Voltec	None
Voltmar	None
Von Allmen & Shawn Cloud	None
VonD	None
Vonderfluh	None
Vox Low	None
W4LLE	None
WANDERN mit BRONKO live	None
WENOTME	None
WENOTME  Boris Why & Nico	None
WF	None
WF presents	None
WILDLIFE	electroacoustic music
WINTERGARTEN	None
WLVS	None
WOLF	edm
WTF	None
WYCLEF JEAN	christmas
Walter June	None
Wandler	techno
Wandler  Cityfox	None
Wandler & Styro2000	techno
Wankala	rap
Wankelmut	house music
Wareika	techno
Warp	antiviral pop
Washerman	disco
Wasulu Selecta	None
Watergate	bubble trance
Watergate Records	None
Wavi	None
We came in peace	None
WeDoReMiX	None
Weith	None
Welcome  FR	None
Whim	techno
Wicked Wilma	None
Wien	None
Wiesage	None
Wighnomy Brothers	techno
Wilkinson	house music
William Bennet	None
William White & the Emergency	None
William Wood	None
Willie Burns	house music
Wobham LIVE	None
Worakls band	None
World Wide Connects  GE	None
Wunderbaum	None
WÆV	None
XCut	None
XV Kilist & Rocco	None
Y&Y	tropical
YANN LAMBIEL	None
Yan Bing	None
Yanac	None
Yang Bing	techno
Yann Stricker & Juan Baeza	None
Yannick Robyns	None
Yarah Bravo	None
Yare	None
Yaya	techno
Yetti MeiÃner	None
Yetti Meißner	None
Yin & Klang	None
Yoav	None
Yodelice	chanson
Yoneda Lemma	None
Yoni Banks & Yan Ka	None
Yosko	None
Youcef   BP   Paris	None
Yougene	None
Young Echo	None
Yvan Genkins	techno
YÃ nkov aka yAn	None
Yànkov aka yAn	None
ZGroove	None
ZH	None
ZILOUB	None
Zachov live	None
ZanoP	None
ZanoP b2b She Nionika	None
Zanop	None
Zedd	pop
Zenker Brothers	None
Zenzile	dub
Zero	downtempo
Zest	techno
Zgroove	None
Ziggi	dancehall
Ziloub	None
Zimmerpop	None
ZinK	None
Zip	house music
Zombidou	None
Zombie Disco Squad	techno
Zoo Underground floor	None
Zouaoui	None
Zukunft	None
Zukunft Rec	None
Zurich	None
Zuzarte La Main Mise  Lausanne	None
Zwicker decksnfxnvox feat Nina Klingele	None
Zürich	None
Zürich  DJ	None
Zürich  live act	None
a microphone & a roland Space Echo re201	None
areage	disco
arnstroem & uglyfunker	None
au Zoo du Mad à Lausanne	None
b2b	None
batteur de la formation GROOVTANK	None
beatbrothers	None
beatis	None
brazilian girls	downtempo
buraq	None
but certainly in life and especially in the art of sound the eye and the ear are equal partners Talking about the young and talented KlangKuenstler	None
cancelled	techno
cette semaine	None
christian tamborrini	None
club	electronic rock
conflict area	None
cora amplifiée	None
cristina souvenir	None
dOP	techno
darkstep	None
das Batz	None
davidgoessler	None
deco by didi	None
deep house  dj	None
delsinNL	None
der Dirigent	None
diSoul	techno
dirtymadsound	None
disco	emo
dj Lynn Jordan	None
dj fragment	None
dj kelstroem	None
dj michel	None
dj skred	None
dolores	cantautor
drhabakuk	None
drum and bass	None
dub  dj	None
dubstep reggae	None
dylan owl	None
edison cabrino	None
electro	tracestep
electro live  PERU	None
electroclash	None
electrostep floor saal	None
elm	video game music
entropi Visuals	None
era	None
era & tweet	None
eskimo & Lila Hart	None
event canceled	None
floor 1	None
floor 2	hi-nrg
follow me	None
gs	None
guitare électrique	None
highgradeZurich	None
hosted by Tony Nwachukwu	None
house	None
house  dj	None
httpwwwresidentadvisornetdjtoastterry	None
ill77	None
incite	groove metal
ivan alvarez	None
jay veedee	None
jungle	electronic rock
jurrecords	None
kescalandanke	None
klaudija groovin golic	None
knotweed records  decision making theory	None
lOurs	None
la rucheLausanne	None
le Bypass et pour la Lake Parade	None
le digital rencontre Le vinyl pour un mélange explosif	None
liquid	fourth world
littlehouse	None
live	christian christmas
live BitTuner	None
live S S S S	None
liveacts tba	None
look longDublin	None
lounge	None
mas Ricardo	None
mas ricardo	None
mc iyah ranx & echo master rjega zürich	None
mc soze	None
meanderBerlin	None
meta83	None
miau musik	None
mimetic	industrial music
minimal	None
minimise	None
more	post-grunge
more guests TBA	None
motoguzziParis	None
moving shadow  UK	None
nat	christmas
nemoy	None
neurofunk floor Foyer	None
new facts	None
novamute	None
opdisc	None
organism showcase  Lausanne	None
oxsa	None
parkcity	None
parker meets risikogruppe	None
partoutcc	None
patten	rap
peel	chamber psych
percussions	None
perlon  CHILI	None
peter wanden	None
pitch control	None
quark	None
reedits	None
sCs	None
scandal all stars aka ast	None
screamo floor Foyer	None
senyc	None
shaka	banda
suffix	None
suffixtv	None
t	pop
tINI	hip hop
tb 303	None
tba	techno
tech house floor Saal	None
teknozwei	None
the gang all stars feat	None
therapy session	None
tickle out our endorphins and  in the best case  be a joyful escapism from the hectic everyday life Welcome to the world of KlangKuenstler	None
trashid	None
tropical bass	None
tsacK ET FIL  Volt bar  CH	None
tsuba	None
tsunami	punk
tt	bmore
turntable babes	None
tweet	r&b
two turntables	None
u2028	None
uk funky  dj	None
uncoolch	None
ursprung	None
visuals Pixelpunx	None
visuals by MikaVentura	None
visuel  ABSÜRDA vjing	None
vj Camille de Dieu	None
voix	harpsichord
wAFF	house music
wankäla	None
warm up by Yan Sebastian	None
waveIrland	None
werk itmisshapecopenhagenDK	None
wfmusik	None
what counts is solely to enjoy here and now Music should preserve our feelings	None
wwwresidentadvisornetdjgarance	None
wwwthecratesch	None
yAn	techno
you have to add another organ of perception the heart Music without emotion is useless Emotional music reminds us that we shouldnt think about yesterday or tomorrow	None
zink	None
zouk bass dj set  PERU	None
Âme	None
Âme live	None
Ãme live	None
à la Majestic Night Montreux ainsi quau Studio du Montreux Jazz Festival quils se sont distingués	None
ЈєϨтЇϲϨ	None
МирАӏӏ Яєsidents	None
