	None
130BPM	disco
88uw	techno
AKAY & NEEVO	rap
AMARO	reggaeton
ANDON	None
AR	desi
ARIAS	rap
Adolpho & Franky	None
Adriatique	techno
Albi	None
Alec Troniq	house music
Alex Dallas	None
Alex Dallas b2b Kalabrese	None
Alex G & Fame	rap
Alex Mota	None
Alice Hänsenberger	None
Alphajet	None
Amaro	reggaeton
Ambivalent	techno
Amsterdam	None
An21	house music
Andhim	house music
Andre	techno
Andrea Oliva	techno
Andrew The Grand	None
Andri	deep
André Galluzzi	None
Andrés Marcos	None
Animal Trainer	house music
Animation byAnish & The PDG	None
Anthony	hollywood
Apollonia	None
Architectural	dub
Atol	None
Attilio	None
Azoth	None
Azzuro	None
BJÖRN LOMAR	None
Baile Musik	None
Bar25  Berlin	None
Bart Skils	techno
Bas Ibellini	None
Bassbüro	None
Bauchamp	None
Beatamines	house music
Beats On Demand	None
Beda	rap
Ben Purple	None
Berghain  Berlin	None
Berghain Ostgut	None
Berlin	house music
Bern	None
Bird	indie
BitTuner	None
Björn Lomar	None
Black Coffee	house music
Borderliners Rec	None
Boris Dolinski	None
Boumi B	None
Bowser	None
Breandan Davey	techno
Brian Sanhaji	hip hop
Brown S	house music
Bruno Minimal	None
CASQUE	None
CFLOW	None
CFlow	None
CLAUDE STAFFIERI	None
Cadenza  Lausanne	None
Carl Jack aka Abdomen	None
Cem	turkish
Centaury	None
Chipe	None
Chris Air	None
Chris Koegler	None
Chris Rockwell	techno
Chris de Rebel	None
Christian Burkhardt	techno
Cityfox  Zurich	None
Clarisse	None
Clarisse  Lausanne	None
Cocoon	chanson
Consor	techno
Costa Del Soul DJ Team	None
Custom Tea	None
DE	grupera
DISCOfloor	None
DJ Emerson	techno
DJ Fett Burger	None
DJ Girl	None
DJ Tennis	house music
DJs	new jack swing
DJs Atol	None
DRESSCODE all in white	None
Dalibox  MinimalFraktion  Salidamusic	None
Dandy Jack	techno
Daniel Dreier	techno
Daniel Marrone	None
Danny Daze	disco
Dario DAttis	rap
Dario Sorano	techno
Dario Zenker	techno
Das Balz b2b Adrian Bergmann	None
Das Balz b2b Amelié	None
David Delgado	hip hop
David Keno	house music
David Suivez	None
Dean Breda	None
Deeperfect	None
Defend	rock
Definition	hardcore
Dejan	None
Dement3d  Geneva	None
Demetrio Giannice	house music
Der Junge mit der Trompete	None
Dicke Lauscher	None
Dimitri	house music
Dirty Flav	None
Disciples	house music
Disco Dave	rap
Diynamic  Lausanne	None
Dj Faith	None
Dj RP	None
Dj Toyo	None
Djerry C	None
Doma	hi-nrg
Don Tetris	None
Doppelpack	None
Double & Parkz	None
Dream	pop
Droplex	techno
Drumcell	techno
Drumcode  Firenze	None
Drve	None
Dubculture  Event	None
Dunwich	rap
Eats Everything	disco
Eevy	None
Ekserd	rap
Electron  Geneva	None
Electronica Floor	None
Enrico Valenti	None
Enzo Siffredi	house music
Ez Raidler	None
FAITH	pop
FORSITION	None
FRANK RICH	None
FREDi Salomon	None
Fabien	None
Faith	pop
Fantastic Friends Recordings  Lausanne	None
Fat Sushi	techno
Feldermelder	None
Felix Jaehn	house music
Fenomen	hip hop
FlexFab	None
Floating Points	house music
Florian Defunes	None
Florian MSK	None
Florin	romanian pop
Forsition	None
Four Tet	electronic rock
Frank Rich	None
Frank Sonic	techno
Frankfurt	None
Franky Fiction	None
Franz Filter	None
Fred	christian christmas
Fredy S	rock
GD	k-pop
GREEKfloor	None
Garance	techno
Gary Beck	techno
German Lachs	house music
Get Physical	None
Ghetto Po	None
Ghost	metal
Gil Glaze	None
Gobbit	None
Grnd lop prod	None
Gunes Ergun	None
Guy Gerber	techno
Guzzle	None
HOBI	rap
Hans Bouffmyhre	techno
Harry Klein	None
Heimat	hip hop
Hive	indie poptimism
Hive Audio	None
Hot Trax	None
House Floor	None
Huazee	None
Isolated Lines	techno
Italoboyz  Marco Donato	None
JANK	emo
JOE GALEN	None
JOHN MAD & NORA	None
Jackmate	microhouse
Jacqui	jazz christmas
Jamie Jones	techno
Jayda G	rap
Jeremy Underground	None
Jimi Jules	rap
Joachim Spieth	rap
Joe Maker	techno
John Talabot	electronic rock
Johny Blaze	None
Joker	trap
Julien Aubert	None
Jus Deelax	techno
Jutzi	None
KENT	trap
KK3D	None
KRAFTECK	techno
Kalabrese	house music
Kellerkind	house music
Kevin Shala	techno
Kiasmos	ambient
King Arthur	house music
Kiril Bikov	None
KlangfabriK	techno
Knut	post-metal
Knut2010	None
Kollektiv Ost	house music
Konvex 1	None
Konvex 2	None
Kopfkino 3D	None
Krenzlin	techno
Krizzli	rap
LAMPENFIEBER	None
LARS LINDENBERG	None
LUKAS FREUDENBERGER	None
LUKII	None
La Fleur	techno
Laolu	techno
Laurent Garnier	techno
Le Bérger	None
Lee Van Dowski	techno
Lejuste	None
Lesničar	None
Lexer	house music
Lineup	None
Lineup Indoor  Mainfloor	None
Lineup Open Air	None
Ling & Mexx	None
Local Support	None
London	classical
Lost Heritage live	None
Lost at	None
Louie Cut	techno
Lui Young	techno
Luis Roza	None
Lukii	None
Lützenkirchen	techno
MAKA	None
MANDY	pop
MAUVE	None
MDR	None
ME & her	rap
MM	banda
MORGANJ	None
Maceo Plex	house music
Madwave	None
Magicstone	None
Makau AND FILAFERRO	None
Mano Le Tough	techno
Marcel Dettmann	techno
Marcel Heese	techno
Marcel Vivo aka mrrox	None
Marco Di Natale	None
Marco Faraone	techno
Marco Resmann	techno
Marcos Del Sol	None
Marcos del Sol	None
Mareena	None
Marika Rossa	techno
Marina	pop
Marion K	None
Markus Kenel	house music
MatJoe	deep
Maurer & Toepfer	None
Maya Jane Coles	house music
Me Dro	None
Meerganglied	None
Melchior	punk blues
Michael Seelenruhig	None
Mike Väth	None
Miniload	None
Mira b2b Chris Schwarzwälder	None
Mirko Loko	techno
Mischkultur	None
Miss Jools	techno
Miss Peel	None
Mobilee  Zurich	None
Moinsen	None
Monaberry	None
Morard	None
Morgan Button	None
Mother Recordings  DE	None
Motor City Drum Ensemble	techno
Mucho Stylez	techno
Mueller	show tunes
Munich	classical
Muri	None
NED ONEAL	None
NESHA	None
Nader	techno
Ned O Neal	None
Nektar	rock
Nemok6	None
Neutronix	None
Nici Faerber	hip hop
Nicola Koch b2b Peter Szanto	None
Nicola Noir	None
Nicolas Duvoisin	rap
Nicolas Haelg	house music
Nik dj	None
Nikola Kotevski	None
Nikolaj Tange Lange	None
Nina Kraviz	techno
Nina Nana	None
Ninette	None
Nkelo Live	None
Oli Allen	None
Oliver K	hip hop
Opuswerk	techno
Orsett	None
Otto Knows	house music
PHILLIP INÄBNIT	None
Pablo Einzig	techno
Pacman	trap
Patrick Podage	groove room
Pawlikowski	classic polish pop
Peer Kusiv	house music
Permanent Triangle	None
Peter Schumann	rap
Pfeffy	None
Philip G Cifuentes	None
Piratenkind	None
Pixelpunks	None
Plassix	None
Poker Flat	None
Profondo	None
Proud	None
Qebeq	None
Quan	rap
RICO LOCO	None
RINO	rap
RJR	None
Radro	None
Radro & DANIEL MARRONE	None
Raphael Dincsoy	techno
Raw Vox	None
Razha	None
Reber	house music
Reklok live	None
Rennie Røyma & Kåre Kyl	None
Reto Ardour	techno
Rich vom Dorf	None
Rick Even	None
Rico Rausch	None
Rico Rausch b2b Der Dirigent	None
Rico Rausch b2b der Dirigent	None
Ripperton b2b Deetron	None
Robel	None
Robin & The Sidekick	rap
Robin Schulz	house music
Rodri	None
Rolf Saxer	rap
Roman Flügel	techno
Romano Rapeso	techno
Ruede Hagelstein	techno
Rusconi	None
Rødhåd	techno
SK Supreme  Zurich	None
SONABZ	None
Sabb	techno
Sandro Falletta  Colludo rec  Salidamusic	None
Sav Manganaro	None
Saved	anthem worship
Saved  Switzerland	None
Sebastian Groth	techno
Sentiment	None
Serge	cabaret
Seth Troxler	techno
Several Definitions	house music
Shahira	None
Shimono	None
Silvision	techno
Simpig	uk garage
Simply Simon	None
Sinisa Tamamovic	techno
Skaos	ska
Soleyu	None
Sonabz	None
Sonny Catanese b2b Lucas Ramirez	None
Soulfooled  Geneva	None
Special Guest	None
Spectron	None
Squep	techno
Steffen Flum	None
Sternenwanderer	None
Steven Wallace	None
Stil vor Talent	None
Strictly Rhythm  Zurich	None
Stuart Hawkins	None
SuCré SaLé	None
Subban	None
Substance	techno
Suffix visuals	None
Sven Schaller	techno
TAG	breakbeat
THEX	None
TOM BLAKE	None
TROMBETA	None
TUBA	brass ensemble
Tanua	techno
Techno Venus  Lausanne	None
Techrifice	None
Teenage Mutants	house music
The Black Madonna	house music
The Cruzaders	rap
The M&B Experiment	None
Thom Mayr	None
Thomas Jack	house music
Thomas Mayr	None
Thomas Schumacher	techno
Tom Blake	None
Tom H	None
Tony Garcia	freestyle
Toppaz  Berlin	None
Torsten Kanzler	schranz
Toy  O	rock
Tracknics	None
Trinidad	rap
Tristan Bohn	None
Tschespito	None
UK	zapstep
VJing by Maak	None
Vacintosh	None
Valeron	hip hop
Vanita b2b LowTales	None
VisionE	None
Vril	dub
Wankelmut	house music
Watergate  Switzerland	None
West D	techno
Wicked Wiggler and later Fabien	None
Wiggaz	None
Wunschkinder	None
Xander Valley	None
Yvan Genkins	techno
Yves Helbling	None
ZerO	downtempo
Zero	downtempo
Zest	techno
Ziiva aka Lukii	None
Zürich	None
and others	None
fabien	None
live	christian christmas
mOOving	None
mastra	deep
mimetic	industrial music
more tba	None
stefano m	None
