00h00 à 00h45  Bak XIII	[]
00h00 à 00h45  The Atomic Bitchwax	[]
1204 Genève	[]
14h00 à 14h45  Danila	[]
14h00 à 14h45  Floyd Beaumont & The Arkadelphians	[]
15h00 à 15h45  Max der Zinger	[]
15h00 à 15h45  Six Months Of Sun	[]
16h00 à 16h45  Hollyhock	[]
16h00 à 16h45  M Fallan	[]
17h00 à 17h45  The Savonnettes	[]
17h00 à 17h45  Voice Of Ruin	[]
18h00 à 18h45  Colossus Fall	[]
18h00 à 18h45  The Chikitas	[]
19h00 à 19h45  Ca Va Chier	[]
19h00 à 19h45  Wardhill	[]
20h00 à 20h45  Gaz	[]
20h00 à 20h45  Mumakil	[]
20h00 à 20h45  Vuyvr	[]
21h00 à 21h45  Incrüst	[]
21h00 à 21h45  KessKhtak	[]
22h00 à 22h45  Elizabeth	[]
22h00 à 22h45  Promethee	[]
22h2h	[]
23h00 à 23h45  Faute de Frappe	[]
23h00 à 23h45  SolarFlar VS Rocrar	[]
5 h Set	[]
900000Y	[]
ABSÜRDA	[]
AEED LIVE	[]
ANDROMEDA CIRCUS	[]
ARNIKA	[]
ARTISAN	[]
Aaah Club	[]
Adriatique	['disco', 'deep', 'deep', 'house music', 'microhouse', 'techno', 'techno', 'house music', 'disco', 'techno', 'hip hop', 'hip hop', 'rap', 'techno', 'disco', 'deep', 'deep', 'house music', 'microhouse', 'techno', 'techno', 'house music', 'disco', 'deep', 'deep', 'house music', 'microhouse', 'techno', 'techno', 'house music']
Aftergrauer	[]
AgnÃ¨s	['chamber pop', 'ambient', 'pop', 'indie folk', 'chamber pop', 'ambient', 'pop', 'indie folk', 'chamber pop', 'ambient', 'pop', 'indie folk']
Agnès	['chamber pop', 'ambient', 'pop', 'indie folk', 'chamber pop', 'ambient', 'pop', 'indie folk', 'chamber pop', 'ambient', 'pop', 'indie folk']
Ajja	['dark psytrance', 'trance music', 'dark psytrance', 'trance music', 'dark psytrance', 'trance music']
Ajja vs Cosmosis	[]
Albruic	[]
Alci	['bolero', 'classic colombian pop', 'cumbia', 'merengue', 'salsa', 'vallenato', 'disco', 'techno', 'rap', 'techno', 'bolero', 'classic colombian pop', 'cumbia', 'merengue', 'salsa', 'vallenato', 'bolero', 'classic colombian pop', 'cumbia', 'merengue', 'salsa', 'vallenato']
Alex Dallas	[]
Alle Farben	['house music', 'deep', 'deep', 'house music', 'house music', 'deep', 'deep', 'house music', 'house music', 'deep', 'deep', 'house music']
Aloan	[]
Altius	[]
Alva Noto	['idm', 'ambient', 'ambient', 'dark jazz', 'drone', 'techno', 'fourth world', 'idm', 'intelligent dance music', 'mandible', 'microhouse', 'minimal', 'drone', 'idm', 'ambient', 'ambient', 'dark jazz', 'drone', 'techno', 'fourth world', 'idm', 'intelligent dance music', 'mandible', 'microhouse', 'minimal', 'drone', 'idm', 'ambient', 'ambient', 'dark jazz', 'drone', 'techno', 'fourth world', 'idm', 'intelligent dance music', 'mandible', 'microhouse', 'minimal', 'drone']
Am Khamsaa	[]
Amazon	[]
Amsterdam	[]
Ananas Symphonie	[]
Ananas Symphony	[]
Animal Trainer	['house music', 'deep', 'house music', 'deep', 'house music', 'deep']
Antipods	[]
Apron Records  USA	[]
Ariane	[]
Arival	[]
Ark	['vapor soul', 'vapor', 'disco', 'techno', 'house music', 'rap', 'techno', 'vapor soul', 'vapor', 'vapor soul', 'vapor']
ArtmaillÃ©	[]
ArtmaillÃ© b2b Alan Bolumar	[]
Artmaillé	[]
Artmaillé b2b Alan Bolumar	[]
Asmara	[]
Audionatica	['techno', 'disco', 'hip hop', 'hip hop', 'rap', 'techno', 'techno']
Av Skardi	['techno', 'ambient', 'house music', 'rap', 'techno', 'house music']
Aya Waska	['dub', 'dub', 'dub']
AÃ¯sha Devi	['escape room', 'fluxwork', 'mandible', 'escape room', 'fluxwork', 'mandible', 'escape room', 'fluxwork', 'mandible']
Aïsha Devi	['escape room', 'fluxwork', 'mandible', 'escape room', 'fluxwork', 'mandible', 'escape room', 'fluxwork', 'mandible']
BEN MANSON	[]
BERBER & PASTA	[]
BERNARDO & LOZANO	[]
BISCARDONG	[]
BRUT  DE	[]
Babo	[]
Bang Goes	[]
Barcelona	['acoustic pop', 'dreamo', 'acoustic pop', 'dreamo', 'acoustic pop', 'dreamo']
Bardo & Salazar	[]
BassbÃ¼ro	[]
Bassbüro	[]
Basses Terres	[]
Bbphoque	[]
Beda	['disco', 'rap']
Beda  2nd Floor Mastra	[]
Beez & Simo	[]
Benja	[]
Berber & Pasta	[]
Berlin	['big room', 'big', 'deep', 'edm', 'house music', 'house music', 'house music', 'trance music', 'trance', 'house music', 'trance music', 'big room', 'big', 'deep', 'edm', 'house music', 'house music', 'house music', 'trance music', 'trance', 'house music', 'trance music', 'big room', 'big', 'deep', 'edm', 'house music', 'house music', 'house music', 'trance music', 'trance', 'house music', 'trance music']
BitTuner	[]
Bitsculpter	['techno', 'techno']
Black Zone Myth Chant	['mandible', 'mandible', 'mandible']
BlackStrobe	['electronic rock', 'electrofox', 'rock', 'disco', 'techno', 'house music', 'hip hop', 'rap', 'house music', 'electronic rock', 'techno', 'electronic rock', 'electrofox', 'electronic rock', 'electrofox']
Bonaventure	['disco', 'rap']
Boris Werner b2b Lauhaus	[]
Britta Arnold	['house music', 'deep', 'disco', 'techno', 'rap', 'techno', 'house music', 'deep', 'house music', 'deep']
Buoyancy	[]
Burt Cobain	[]
Buzz  T	[]
CH	[]
CHATEAU CHEPERE ALL STAR	[]
CMYK	[]
CPLAYDEJAVUCH	[]
Cadenza	[]
Cadenza Music	[]
Caillou	[]
Call Super	['house music', 'fluxwork', 'house music', 'house music', 'fluxwork', 'house music', 'house music', 'fluxwork', 'house music']
Canson	['house music', 'techno', 'techno', 'house music', 'house music']
Carl Craig	['house music', 'techno', 'microhouse', 'techno', 'house music', 'house music', 'techno', 'rock', 'techno', 'hip hop', 'hip hop', 'rap', 'techno', 'house music', 'techno', 'microhouse', 'techno', 'house music', 'house music', 'techno', 'house music', 'techno', 'microhouse', 'techno', 'house music', 'house music', 'techno']
Casimir von Oettingen	['disco', 'house music', 'house music', 'rap', 'idm']
Casserolband	[]
Chapkmace	[]
Charles Meyer	['disco', 'house music']
Charles Meyer  LIMMATBEATZCH	[]
Charles Meyer and Josè Parra	[]
Cherosa	[]
Chopstick & Johnjon	['disco', 'deep', 'deep', 'hip hop', 'rap', 'hip hop', 'hip hop', 'hip hop', 'hip hop', 'disco', 'deep', 'deep', 'disco', 'deep', 'deep']
Chris Ahn	['techno', 'house music', 'techno']
Christian Schiemann	['disco', 'rap']
Cirkus	['downtempo', 'downtempo', 'downtempo']
Clem	['ambient', 'nu age', 'rock', 'disco', 'hip hop', 'hip hop', 'hip hop', 'rap', 'jungle', 'ambient', 'nu age', 'ambient', 'nu age']
CoMini  Betty&Ford	[]
Conxion	[]
Coolcat	[]
Coolcat et Simon Mozer 2000	[]
Cooly G	['bass music', 'uk garage', 'bass music', 'uk garage', 'bass music', 'uk garage']
Cosmosis	['dark psytrance', 'trance music', 'dark psytrance', 'trance music', 'dark psytrance', 'trance music']
Craiova	['manele', 'manele', 'manele']
Cristan	[]
DAVID LAMON	[]
DJ Bolumar	[]
DJ Dub	['dub']
DJ HEra	[]
DJ Les Filles Affranchies	[]
DJ Lineup	[]
DJ MARABOUT	[]
DJ OEL & KAMA	[]
DJ Rescue	['hip hop']
DJ Reverend P	['disco', 'downtempo', 'hip hop', 'house music', 'hip hop', 'hip hop', 'rap', 'house music']
DJ Sets	[]
DJ Tennis	['house music', 'rock', 'techno', 'rap', 'techno', 'house music', 'house music']
DJ Zest	[]
DJs OEl & Kama	[]
DLP	['disco', 'techno', 'electronica', 'house music', 'house music', 'disco', 'techno']
Dachkantine	[]
Damiano Pappada	[]
Damon Irving	[]
Dan Andrei	[]
Dan Noël	[]
Dandy Jack	['disco', 'techno', 'hip hop', 'hip hop', 'rap', 'techno']
Daniel Avery B2B Roman Flügel	[]
Danse Noire	[]
Danse Noire DJs	[]
Dario La Mazza	[]
Darius D	[]
Dave Dalux	[]
Dave Lozano	[]
David Carretta	['electronic rock', 'rock', 'disco', 'techno', 'house music', 'rap', 'electro music', 'industrial music', 'techno', 'industrial music', 'electronic rock', 'electronic rock']
David Lozano	[]
David Suivez	[]
Debora Ipekel aka Night Nurse	[]
Dee Nelli	[]
DeeJay Q	[]
DeeNelli	[]
Dejan	[]
Deneha	['disco', 'techno', 'house music', 'rap', 'house music', 'techno']
Detroit	[]
Digitalo Enterprises  NO	[]
Dim	['ccm', 'rock', 'christian', 'christian', 'worship', 'ccm', 'rock', 'christian', 'christian', 'worship', 'ccm', 'rock', 'christian', 'christian', 'worship']
Disco 45 Londres	[]
Disco Dave	['disco', 'house music', 'rap']
Dj Fil from 10pm to 2am	[]
Dj Gaspard	[]
Double You	['hi-nrg', 'hi-nrg', 'europop', 'house music', 'hi-nrg', 'hi-nrg', 'europop', 'house music', 'hi-nrg', 'hi-nrg', 'europop', 'house music']
Dracula Lewis	[]
Dreems	['house music', 'house music', 'house music']
Ducks on Repeat	['disco', 'techno', 'house music', 'techno']
Dymons	['ambient', 'psychill', 'ambient', 'psychill', 'ambient', 'psychill']
Ectocasmic	[]
EgoPhunk	['disco', 'house music', 'rap', 'house music']
Einzig & Faerber	['rap']
El Alusinante	[]
Elk  Rhino	[]
Elkee	[]
Elle Rêve	[]
Elvis Cassetta	['disco', 'house music', 'rap', 'house music']
Endgame	[]
Eric A  Simple & Sans PrÃ©tention  CH  House	[]
Eric A  Simple & Sans Prétention  CH  House	[]
Et Vous	[]
Ezikiel	['disco', 'techno', 'techno', 'rap', 'dub', 'techno', 'jungle']
FABRI	[]
FELIX FOSSIL	[]
FICHTRE  Feldermelder	[]
FIMO feat MANOLO	[]
FR	[]
FRYK	[]
Fat Acid	[]
Feldermelder	[]
Fez Momo	[]
Fichtre	[]
Finefood records  Fribourg	[]
Fis	['bass music', 'fluxwork', 'mandible', 'house music', 'bass music', 'fluxwork', 'mandible', 'house music', 'bass music', 'fluxwork', 'mandible', 'house music']
Fleeting Wax  Berlin	[]
Flink	[]
Flooting Grooves	['ambient', 'didgeridoo', 'psychill', 'world fusion', 'ambient', 'didgeridoo', 'psychill', 'world fusion', 'ambient', 'didgeridoo', 'psychill', 'world fusion']
Flying Lotus	['hip hop', 'post-disco', 'electronic', 'escape room', 'idm', 'idm', 'hip hop', 'indie r&b', 'electronic rock', 'electronic rock', 'downtempo', 'hip hop', 'idm', 'hip hop', 'post-disco', 'electronic', 'escape room', 'idm', 'idm', 'hip hop', 'indie r&b', 'electronic rock', 'electronic rock', 'downtempo', 'hip hop', 'idm', 'hip hop', 'post-disco', 'electronic', 'escape room', 'idm', 'idm', 'hip hop', 'indie r&b', 'electronic rock', 'electronic rock', 'downtempo', 'hip hop', 'idm']
Foupoudav	[]
Francesco De Bellis	[]
Frankfurt	[]
François K	['house music', 'house music', 'house music']
Freshmint	[]
Fritz Kalkbrenner	['house music', 'deep', 'deep', 'german', 'techno', 'house music', 'house music', 'disco', 'techno', 'hip hop', 'house music', 'hip hop', 'hip hop', 'rap', 'techno', 'house music', 'deep', 'deep', 'german', 'techno', 'house music', 'house music', 'house music', 'deep', 'deep', 'german', 'techno', 'house music', 'house music']
GE	['gospel', 'praise', 'gospel', 'praise', 'gospel', 'praise']
GIL live	[]
GINO  Special 3 h Christmas Intro Set	[]
Garçon	[]
Garçon Sauvage	[]
Gertude Tuning	[]
Gianni Callipari	['disco', 'rap']
Grande Scène	[]
Greg Beato	['house music', 'disco', 'rap', 'house music', 'house music']
Greg Shepherd	[]
Guy Joshua	[]
HERMANSSON & MARTINEZ	[]
Habibi Funk	[]
Havanna Sound	[]
Helder Costa b2b Lee Low	[]
Herkul	[]
Herr Müller	[]
Honoree	['techno', 'house music', 'rap', 'techno']
Horasse	[]
Hraach	['house music', 'house music', 'house music']
Hrdvsion	['disco', 'ambient', 'rap']
Hug & Schiemann	[]
INFX	[]
Iggy	['pop', 'hip hop', 'pop', 'pop', 'pop', 'pop', 'hip hop', 'pop', 'pop', 'pop', 'pop', 'hip hop', 'pop', 'pop', 'pop']
Ikke	['discofox', 'house music', 'discofox', 'house music', 'discofox', 'house music']
Imox	[]
In Flagranti	['balearic', 'disco', 'balearic', 'disco', 'balearic', 'disco']
Intro by ATA	[]
Isolated Lines	['rock', 'disco', 'techno', 'rap', 'techno']
J Velez aka Professor Genius	[]
JOHAN MÃVE	[]
JOHAN MÖVE	[]
JONES b2b LEFTHAND	[]
Jacqui & Réne Dachner	['rap', 'hip hop']
Javi Peña	[]
Jeff Swing	['disco', 'techno', 'hip hop', 'rap', 'techno']
Jeff Swing b2b Cosmokolor all night long	[]
Jens Bond	['techno', 'techno', 'techno']
Jessie	['pop', 'neo mellow', 'pop', 'pop', 'pop', 'r&b', 'pop', 'pop', 'neo mellow', 'pop', 'pop', 'pop', 'r&b', 'pop', 'pop', 'neo mellow', 'pop', 'pop', 'pop', 'r&b', 'pop']
Jestics	[]
Jimi Jules	['disco', 'rap']
Joe Galen	[]
John Morales	['rock', 'disco', 'hip hop', 'rap']
Jokari	['disco', 'rap']
Jonny Rock	['rock']
Josè Parra	['cante flamenco', 'flamenco', 'cante flamenco', 'flamenco', 'cante flamenco', 'flamenco']
José Parra	['cante flamenco', 'flamenco', 'cante flamenco', 'flamenco', 'cante flamenco', 'flamenco']
Judaah	[]
Juen & Bach	[]
Juliano Lopez	['disco', 'rap']
Julien	['chamber pop', 'indie folk', 'indie', 'chamber pop', 'indie folk', 'indie', 'chamber pop', 'indie folk', 'indie']
Julien Aubert	[]
Julien Gremaud	[]
Katermukke  Berlin	[]
Kim Prevedello	['disco', 'hip hop', 'house music', 'hip hop', 'rap']
Klanggärtner	[]
Kombé	[]
Kowton	['bass music', 'house music', 'fluxwork', 'uk garage', 'house music', 'disco', 'rap', 'bass music', 'house music', 'fluxwork', 'uk garage', 'house music', 'bass music', 'house music', 'fluxwork', 'uk garage', 'house music']
Krizzli	['disco', 'rap']
Kyrill & Redford	['groove room', 'groove room', 'groove room']
LAD	['disco', 'electronica', 'rap', 'hardcore']
LAWilliams DJAXUPKUMBA RECUSA	[]
LUCA GEROSA	[]
La fine Ã©quipe	[]
La fine équipe	[]
La soirée aura lieu au parc des Bastions	[]
Larytta	['rock', 'techno', 'hip hop', 'hip hop', 'rap', 'techno']
Leipzig	['classical christmas', 'classical', 'classical', 'orchestral', 'violin', 'classical christmas', 'classical', 'classical', 'orchestral', 'violin', 'classical christmas', 'classical', 'classical', 'orchestral', 'violin']
Lemka	[]
Lemonick	['disco', 'rap']
Leo	['techno', 'hip hop', 'house music', 'hip hop', 'house music', 'techno']
LeonÃ¡rd Bywa	['rap']
Leonárd Bywa	['rap']
Licht im Dunkel	[]
Limic aka Lio M	[]
Limmatbeatz	[]
Littlehouse	[]
Loscil	['ambient', 'ambient', 'dark jazz', 'drone', 'techno', 'electronic', 'fluxwork', 'fourth world', 'idm', 'intelligent dance music', 'mandible', 'microhouse', 'minimal', 'modern classical', 'nu age', 'rock', 'slow core', 'drone', 'ambient', 'ambient', 'dark jazz', 'drone', 'techno', 'electronic', 'fluxwork', 'fourth world', 'idm', 'intelligent dance music', 'mandible', 'microhouse', 'minimal', 'modern classical', 'nu age', 'rock', 'slow core', 'drone', 'ambient', 'ambient', 'dark jazz', 'drone', 'techno', 'electronic', 'fluxwork', 'fourth world', 'idm', 'intelligent dance music', 'mandible', 'microhouse', 'minimal', 'modern classical', 'nu age', 'rock', 'slow core', 'drone']
Lovers	['rock', 'preverb', 'rock', 'preverb', 'rock', 'preverb']
Low Jack	['house music', 'house music', 'house music']
LowTales	['house music', 'house music', 'house music', 'techno']
Luca Gerosa	[]
Lucas MonÃ¨me	[]
Lucas Monème	[]
Lucerne	[]
MALBEC	[]
MALEKOS BEUTEL	[]
MARC FUHRMANN PANTHERA RECILLUSIONROOMCH	[]
MARCO P  TURNING WEEL RECCH	[]
MATIJA	[]
MAXIM MAILLET	[]
MC Annie Jaklin	[]
MONSIEUR MELANGE b2b KORNY	[]
Maceo Plex	['disco', 'deep', 'deep', 'house music', 'microhouse', 'techno', 'techno', 'house music', 'house music', 'disco', 'deep', 'deep', 'house music', 'microhouse', 'techno', 'techno', 'house music', 'house music', 'disco', 'deep', 'deep', 'house music', 'microhouse', 'techno', 'techno', 'house music', 'house music']
Maceo Plex  Tale Of Us  Mano Le Tough  DJ Tennis  Mark Henning  Markus Lindner  Canson	[]
Magic Mixers	[]
Mahi	['disco', 'trance music']
Mainfloor Sven VÃ¤th	[]
Mainfloor Sven Väth	[]
Malekos Beutel	[]
Mannheim	['christmas', 'christmas', 'christmas']
Mano Le Tough	['disco', 'deep', 'house music', 'microhouse', 'techno', 'techno', 'house music', 'disco', 'deep', 'house music', 'microhouse', 'techno', 'techno', 'house music', 'disco', 'deep', 'house music', 'microhouse', 'techno', 'techno', 'house music']
Manon	['disco', 'techno', 'hip hop', 'house music', 'rap', 'techno']
Manuell	['hip hop', 'hip hop', 'hip hop']
Marco Berto	['disco', 'house music', 'rap']
Marco Falkone	[]
Marco Tegui	[]
Marcosis	[]
Mark Henning	['techno', 'techno', 'house music', 'techno', 'techno', 'techno']
Markus Lindner	['disco', 'techno', 'house music', 'rap', 'techno']
Marlon	[]
Massive Jay	[]
Master Margherita	['ambient', 'psychill', 'world fusion', 'disco', 'rap', 'dub', 'ambient', 'psychill', 'world fusion', 'ambient', 'psychill', 'world fusion']
Matija	[]
Matthias Tanzmann	['techno', 'microhouse', 'techno', 'techno', 'house music', 'disco', 'house music', 'house music', 'post-disco', 'rap', 'techno', 'techno', 'microhouse', 'techno', 'techno', 'house music', 'techno', 'microhouse', 'techno', 'techno', 'house music']
Mauro Muratti	[]
Max Tundra	[]
Mehmet Aslan	['disco', 'house music', 'rap']
Meikel	['techno', 'rap', 'techno']
MiSùmo	[]
Michael Schulte	['channel pop', 'pop', 'pop', 'channel pop', 'pop', 'pop', 'channel pop', 'pop', 'pop']
Michael Taschinski	[]
Michal Zietara	[]
Miguel	['pop', 'deep pop r&b', 'hip hop', 'hip hop', 'r&b', 'pop', 'pop', 'r&b', 'rap', 'hip hop', 'trap', 'urban contemporary', 'disco', 'house music', 'rap', 'pop', 'deep pop r&b', 'hip hop', 'hip hop', 'r&b', 'pop', 'pop', 'r&b', 'rap', 'hip hop', 'trap', 'urban contemporary', 'pop', 'deep pop r&b', 'hip hop', 'hip hop', 'r&b', 'pop', 'pop', 'r&b', 'rap', 'hip hop', 'trap', 'urban contemporary']
MinimalistiXProject	[]
Miss Jools	['techno', 'disco', 'rap', 'techno', 'techno']
Moderat	['electronic rock', 'electronic', 'electronic rock', 'microhouse', 'techno', 'electronic rock', 'downtempo', 'house music', 'electronic rock', 'electronic', 'electronic rock', 'microhouse', 'techno', 'electronic rock', 'downtempo', 'house music', 'electronic rock', 'electronic', 'electronic rock', 'microhouse', 'techno', 'electronic rock', 'downtempo', 'house music']
Modis Chrisha	[]
Mon Mec & Jean Charles de Monte Carlo	[]
Monpetitponey	[]
Mr Jonk	[]
Möwe	['house music', 'deep', 'house music', 'house music', 'deep', 'house music', 'house music', 'deep', 'house music']
NGOC LAN	['vietnamese pop', 'vietnamese pop', 'vietnamese pop']
NIK BÄRTSCH	['dark jazz', 'fourth world', 'dark jazz', 'fourth world', 'dark jazz', 'fourth world']
Nader	['disco', 'techno', 'rap', 'idm', 'techno']
Nathan Fake	['electronic', 'intelligent dance music', 'microhouse', 'techno', 'house music', 'rock', 'disco', 'house music', 'rap', 'techno', 'electronic', 'intelligent dance music', 'microhouse', 'techno', 'house music', 'electronic', 'intelligent dance music', 'microhouse', 'techno', 'house music']
Nathanael	[]
Navi Playful	[]
Ngoc Lan  CH  HipHop	[]
Nick Curly	['disco', 'house music', 'techno', 'house music', 'disco', 'techno', 'house music', 'hip hop', 'rap', 'house music', 'techno', 'disco', 'house music', 'techno', 'house music', 'disco', 'house music', 'techno', 'house music']
Niels	['dutch pop', 'dutch', 'dutch pop', 'dutch', 'dutch pop', 'dutch']
Nik dj	[]
Nkisi	[]
Nori	['disco', 'trance music', 'techno', 'rap', 'techno']
Noromal	['disco', 'rap']
Nous mettre feu à Usine On reprend la vieille équipe et on rajoute du poivre et du piment dans la vodka Paf  Soirée bien corsée en perspective pour les fans de drumnbass avec le rebelle pirate DJ Das	[]
Nybass	[]
Nôze	['microhouse', 'techno', 'microhouse', 'techno', 'microhouse', 'techno']
Olivier Kolly	['disco', 'rap']
Opuswerk	['techno', 'disco', 'rap', 'dub', 'drum and bass', 'techno', 'techno', 'techno']
Osba	[]
Otavio	[]
Otto Von Schirach feat Notorious Nastie	[]
Oy	['rock', 'disco', 'electronica', 'hip hop', 'hip hop', 'hip hop']
Ozien	[]
PASCAL PROSPER  TANZNATURBOLLWERKCH	[]
PASCI	[]
PLAY TECHNOODESSA  UA	[]
POSSA	[]
Paco Osuna	['techno', 'techno', 'house music', 'techno', 'disco', 'techno', 'rap', 'techno', 'techno', 'techno', 'house music', 'techno', 'techno', 'techno', 'house music', 'techno']
Pakalolo	[]
Panteros666	['techno', 'disco', 'techno', 'rap', 'electronic rock', 'techno', 'hardstyle', 'techno', 'techno']
Pasci	[]
Paul Eg	['disco', 'techno', 'house music', 'techno']
Paul Kalkbrenner	['techno', 'techno', 'house music', 'house music', 'disco', 'techno', 'hip hop', 'hip hop', 'rap', 'dub', 'techno', 'techno', 'techno', 'house music', 'house music', 'techno', 'techno', 'house music', 'house music']
Pazkal	['techno', 'hip hop', 'house music', 'rap', 'house music', 'techno']
Peak b2b Marc DArrigo	[]
Pets  Berlin	[]
Phil Parnell	[]
Philipp Aregger	[]
Philippe Petit	['disco', 'techno', 'rap', 'techno']
Pierre Raboud	[]
Polonium 88 b2b Tonga aka Toyboys	[]
Pour celles et ceux qui débarquent	[]
Primr	[]
Prélocations sur à Sounds Records	[]
Quarion	['electro jazz', 'techno', 'disco', 'techno', 'hip hop', 'house music', 'rap', 'house music', 'dub', 'techno', 'electro jazz', 'techno', 'electro jazz', 'techno']
Quentin Mosimann	[]
Quitim	[]
RAPU & Nekow	[]
RE	[]
REK	[]
RINGO MOON	[]
RINGO MOON  LIMMATBEATZCH	[]
ROHSTOFFLAGER	[]
Reto Ardour	['techno', 'house music', 'techno']
Rice&Beans	[]
Ringo Moon	[]
Rino	['rap', 'dirty', 'rap', 'rap', 'dirty', 'rap', 'rap', 'dirty', 'rap']
Ripperton	['chicago soul', 'rock', 'disco', 'funk', 'funk', 'funk', 'soul', 'motown', 'soul', 'post-disco', 'quiet storm', 'soul', 'soul', 'soul', 'urban contemporary', 'disco', 'techno', 'house music', 'rap', 'techno', 'chicago soul', 'rock', 'disco', 'funk', 'funk', 'funk', 'soul', 'motown', 'soul', 'post-disco', 'quiet storm', 'soul', 'soul', 'soul', 'urban contemporary', 'chicago soul', 'rock', 'disco', 'funk', 'funk', 'funk', 'soul', 'motown', 'soul', 'post-disco', 'quiet storm', 'soul', 'soul', 'soul', 'urban contemporary']
Robert Dietz	['techno', 'techno', 'disco', 'techno', 'hip hop', 'house music', 'hip hop', 'rap', 'drum and bass', 'techno', 'techno', 'techno', 'techno', 'techno']
Robin	['house music', 'edm', 'pop', 'house music', 'techno', 'house music', 'dub', 'techno', 'house music', 'edm', 'pop', 'house music', 'house music', 'edm', 'pop', 'house music']
Romeo	['bachata', 'tropical', 'disco', 'house music', 'house music', 'bachata', 'tropical', 'bachata', 'tropical']
Rozzo	['techno', 'techno', 'techno']
Ruslan Mays TOUCHED PHOBIQ RECORDSKAZANTIP KISS FM	[]
Ruta 5	[]
SCHAED	[]
SOMEAIR	[]
SOMI	['vocal jazz', 'vocal jazz', 'vocal jazz']
SSSS	['disco', 'rap']
SUNSUN live	[]
SUPERMARKET	[]
San Jack OFFICAL KONSUL KAZANTIPKISS FMUA	[]
Sandro Kuhne	[]
Sandro KÃ¼hne	[]
Sandro KÃ¼hne b2b Marco Trinkler	[]
Sandro Kühne	[]
Sandro Kühne b2b Marco Trinkler	[]
Schaed	[]
Schaed all night long	[]
Schnautzi	[]
Scout Klas	[]
Scène du Casino	[]
Sebastian Eduardo	[]
Sebatien B	[]
Selim & Armin	[]
Seteve	[]
Sevdaliza	['deep indie r&b', 'escape room', 'indie', 'vapor soul', 'deep indie r&b', 'escape room', 'indie', 'vapor soul', 'deep indie r&b', 'escape room', 'indie', 'vapor soul']
Shackleton	['bass music', 'techno', 'uk garage', 'fluxwork', 'idm', 'mandible', 'microhouse', 'house music', 'bass music', 'techno', 'uk garage', 'fluxwork', 'idm', 'mandible', 'microhouse', 'house music', 'bass music', 'techno', 'uk garage', 'fluxwork', 'idm', 'mandible', 'microhouse', 'house music']
Shades	['techno', 'ambient', 'techno']
SheDj Meenakshi	[]
SheDj Naima	[]
SheDj Sabi	[]
Shore Bar Axel	[]
Shows & Performances	[]
Simple & Sans	['rap']
SkatebÃ¥rd	['balearic', 'balearic', 'balearic']
Skatebård	['balearic', 'balearic', 'balearic']
Skyd	[]
Smalltown Collective	['disco', 'techno', 'house music', 'hip hop', 'rap', 'house music', 'techno']
Somi	['vocal jazz', 'vocal jazz', 'vocal jazz']
Sound of Neptune	[]
Space Factory	[]
StPaul	[]
Stacey Pullen	['techno', 'house music', 'techno', 'techno', 'hip hop', 'house music', 'hip hop', 'hip hop', 'house music', 'breakbeat', 'techno', 'techno', 'house music', 'techno', 'techno', 'house music', 'techno']
Starsand	[]
Steven Fox	[]
Steven Traffic	[]
Structure and VJing by Maak	[]
Styro2000	[]
Suffix visuals	[]
Superpoze	['disco', 'rap']
Susie Star	[]
Sweely	['disco', 'rap']
TESTOSTERONE CLUB	[]
THE TOYBOYS	[]
TIMOWOODTV	[]
TIMOWOODTV  Visuals & Deko	[]
TIMWOODTV	[]
TOBIAS BIENZ Kostüm & Ausstattung HENRIETTE HERM Musik DJ Ray CITO Video & Visuals BENJAMIN BURGER Kommunikation KAJA EGGENSCHWILER	[]
TOLYA SUHAR NOVOTECHKAZANTIPKISS FMUA	[]
TOYBOYS	[]
Tagtra3umer	[]
Tagträumer²	[]
Tale Of Us	['disco', 'deep', 'house music', 'microhouse', 'techno', 'techno', 'house music', 'techno', 'rock', 'disco', 'techno', 'house music', 'techno', 'disco', 'deep', 'house music', 'microhouse', 'techno', 'techno', 'house music', 'techno', 'disco', 'deep', 'house music', 'microhouse', 'techno', 'techno', 'house music', 'techno']
Tha Tuga	[]
The Cruzaders	['rock', 'disco', 'rap']
The Peaking Goddess Collective Outro Concert	[]
The Pilotwings	[]
Think Tank	['rap', 'rap', 'rap']
Think Tank DJs	[]
TillTape & Gray Chalk	[]
Tim Exile LIVE	[]
Timoteo	['brega', 'sertanejo tradicional', 'velha guarda', 'brega', 'sertanejo tradicional', 'velha guarda', 'brega', 'sertanejo tradicional', 'velha guarda']
TimowoodTV	[]
Tissu	[]
UK	['zapstep', 'zapstep', 'zapstep']
Uebel & Gefährlich  Hamburg	[]
Ugly Kids	[]
Unite Family	[]
VISIONS OF TREES	['grave wave', 'house music', 'grave wave', 'house music', 'grave wave', 'house music']
VJ Le Chat	[]
VJing Performance by Kreutzfeld & JJJakkob	[]
Vaghe Stelle	['disco', 'electronica', 'dub', 'uk garage']
Visionist	['bass music', 'fluxwork', 'uk garage', 'bass music', 'fluxwork', 'uk garage', 'bass music', 'fluxwork', 'uk garage']
Visuals Pizz	[]
Visuals by Dario DeSiena	[]
Visuals by Sophie Le Meillour	[]
Visuals vom TimowoodTV	[]
Walls	[]
West D	['disco', 'techno', 'house music', 'rap', 'techno']
Wide Soul	[]
Winter in Deutschland	[]
XV Killist & Rocco	[]
YabYum	[]
Yan Luong	['rock', 'disco', 'house music', 'hip hop', 'house music', 'hip hop', 'hip hop', 'techno']
Yannick Müller	[]
ZH	[]
Zest	['disco', 'techno', 'house music', 'rap', 'techno']
Zimon	[]
Zurich	[]
and more	['deep freestyle', 'deep freestyle', 'deep freestyle']
après plusieurs apparitions télévisuelles	[]
chicago house et plus si affinités	[]
comme cerise sur le pâté	[]
dj	['trap', 'house music', 'trap', 'house music', 'trap', 'house music']
dj Lynn Jordan	[]
débarque à PTR  Formé en 1996	[]
enregistrent leur premier album  Creature funk  en 2003 Alors que leur second  Creature Shock Radio  obtient un franc succès et les élève à un niveau supérieur	[]
et pour cette édition	[]
glasraum	[]
httpsoundcloudcomschaed	[]
httpswwwfacebookcomTIMOWOODtvfrefts	[]
ils construisent alors un vaisseau spatial et partent dans le cosmos à la recherche de signes nouveaux et de valeurs à transmettre à lhumanité Après un long périple riche en aventures	[]
ils tentent de bâtir un nouvel ordre mondial	[]
le coté obscur de DJ Kenhobiz	[]
live	['christian christmas', 'world worship', 'worship', 'christian christmas', 'world worship', 'worship', 'christian christmas', 'world worship', 'worship']
plus juste pour toutes les marionnettes et créatures Malheureusement	[]
rien ne change et les Puppetmastaz tombent en dépression Avec laide de leur psychanalyste Ziggy Scandalous et lappui financier de Sneakerboots	[]
sdanke	[]
une spécialité venant directement de Londres	[]
uvm	[]
visuals by Pizz	[]
yAn	['disco', 'techno', 'house music', 'dub', 'techno']
трип  ISL	[]
