	None
& Guests	None
& Local Support Kugl	None
&ME	screamo
0015  0130 Rico Rausch b2b Der Dirigent	None
0041 79 58 68 812	None
0100  0400 Dr Lektroluv	None
0130  end Luna City Express	None
0130 Klaus Frauenholz	None
0300 Juan Veloz	None
0330  0600	None
0400  0500 Marco Rossi	None
0500  0630	None
0500  0700	None
0630  0800	None
0630  0830	None
0700  0900	None
0800  0930	None
0830  End	None
0900  1030	None
0930  1100	None
10 April 2015  Moon	None
10 Jahre Rakete Openair presents The Lake	None
100Tons	None
1030  End	None
11 APRILE LE MOON	None
11 APRILE MODERNITY	None
11 April 2015  Moon	None
12 APRILE LE MOON	None
12 APRILE MODERNITY	None
12 April 2015  Modernity	None
13 APRILE MODERNITY	None
1300  1345 Niclas	None
1300  1400 DJ Noise	None
1300  1400 Stefano	None
1300  1400 The Sexinvaders	None
1300  1430 Solomun	None
1300 Dj Phala	None
13001400 Aly & Fila	None
13001400 Tin Man	None
13001430 FEGAcrew live	None
13002400 coming soon	None
1345  1430 Klangallianz	None
1400  1500 Reto Ardour	None
1400  1530 Giuseppe Ottaviani	None
1400  1530 Steve Angello	None
1400 Dj Cruz	None
14001500 Dr Kahn	None
14001500 Sander van Doorn	None
1430  1515 Trisha	None
1430  1600 Stimming	None
14301500 DJ Mastra	None
1500  1600 Smash FX	None
1500 Johnny Roxx	None
15001600 Commix	None
15001600 DJ Andrew	None
15001600 Silex	None
1515  1600 Sobuth & Weiss	None
1530  1700 Jennifer Rene	None
1530  1700 Yves La Rock	None
1600  1645 Ida	None
1600  1700 Muri	None
1600  1730 Turntablerocker	None
1600 Mr DaNos	None
16001700 James Zabiela & Nic Fanciulli	None
16001700 Nader	None
16001700 Zodiak	None
1645  1730 Chris Mono	None
1700  1800 Marco Berto	None
1700  1815 Felix KrÃ¶cher	None
1700  1815 Felix Kröcher	None
1700  1830 Kyau & Albert	None
1700 Requiem 4 Dj Energy	None
17001800 Perry O Neil	None
17001800 Pixelpunks	None
1730  1815 Mismo	None
1730  1830 Ryan Riot	None
1800  0200  MARTIN GIRALDO aka DJTAL	None
1800  1900 Le Noir	None
1800 Adam B	None
18001900 DJ Remy	None
18001930 Audioporno liveDJ Set	None
18002130 Love Mobiles	None
1815  1900 OGee	None
1815  1930 TV	None
1830  1930 DJ JayBase	None
1830  2000 DJ Dream	None
18h  22h  Jean Clef	None
18h  22h  Pascal Viscardi Saft Recordings	None
18h  22h  Seteve	None
18h0022h00 Pascal Viscardi  DEEP HOUSE  RARE GROOVE	None
1900  1930 Swiss Track	None
1900  2000 Mas Ricardo	None
1900 Tanja La Croix	None
1900 Vertical Surround Performance mimetic	None
19002000 Sander Kleinenberg	None
1930  2030 Franco Bianco	None
1930  2030 Round Table Knights	None
1930  2100 Martin Solveig	None
19302030 Markese live	None
1940 Vertical Surround Performance mimetic	None
19h  22h  Constellation  Juicy Fruity Funky Fresh Life Beats & Rhymes	None
19h  22h  Felix Et Chat	None
19h  22h  Marlon & Andreas	None
19h  22h  Rony KN	None
2000  2100 Turntable Babes	None
2000  2200 Dave 202	None
2000 GL Everest	None
2000 and One	house music
20002130 Markus Schulz	None
2020 Vertical Surround Performance mimetic	None
2020 Vision	None
2030  2115 Ponybomb	None
2030  2130 Einzelkind	None
20302100 Beda	None
2100  2200 DJ Gogo	None
2100  2200 Marloti	None
2100  2230 Sebastian Ingrosso	None
2100 Vertical Surround Performance mimetic	None
21002200 RegionalLiga	None
2115  2215 RegionalLiga	None
2130  2230 Lexy & K Paul	None
2130 Jazz T	None
2130 Sir Collin	None
21302215 TurntableBabes	None
21302230 Richie Hawtin b2b Magda	None
2200  0100  MEGABLAST & MAKOSSA	None
2200  2300 Maximizerz	None
2200  2300 Rene S	None
2200  2400 ALY & FLYA	None
22002300 Monoblock B live	None
2215  2315 Starshiptroopers	None
22152400 Smash FX	None
2230  2400 Jerome IsmaAe	None
2230  2400 Paul Van Dyk	None
22302400 Paul Van Dyk	None
2245 Avesta	None
22a Music	None
22h00  1h00  Metro Area	None
2300  0015 Felipe&Gusto	None
2300  0100 mastermark	None
2300  2400 Danie KÃ¶nig & Tom Novy	None
2300  2400 Danie König & Tom Novy	None
2300 PeeKay	None
23002400 Silvercity Bob	None
2315  2400 Johnny RoxxBildstÃ¶rung	None
2315  2400 Johnny RoxxBildstörung	None
237	None
237 Family	None
24	orquesta tropical
2400 Romanesko	None
2floor	None
2nd Floor	None
2nd Room	None
2room	None
2st Room	None
3010	rap
393389470704	None
3Some	None
3some	None
4057 BASEL	None
4T	None
4ton	None
8 Bit Records	None
88uw	techno
8Bit	None
9 April 2015  Moon	None
A Friend	emo
A coté de leur résidence dans différents clubs genevois	None
A touch of deep	None
ABRAHAM LICORNE  electroswing  GE	None
ABROTHERS  Gayle San Rec & Nachtstrom Schallplatten  AUT	None
AC204	None
ACES A	None
ACID	indie
ACIDHAT	None
ACOMA & MARCELINHO and his congas Groove Technology  Drifters  Freiburg	None
AG	hardcore
AGAPE	None
AGRO  UK	None
AIX	ambient
AKA	None
AKA AKA	techno
AKAY & NEEVO	rap
AKSHAN	ambient
AL	soul
ALAIN SZERDAHELIY	None
ALAN K	techno
ALEX PATCHWORK	None
ALGORYTHMIK live	None
ALLABY	None
ALON LEVI	None
AM	pop
AMARO	reggaeton
AMari	None
ANDON	None
ANDRES HERNANDEZ	None
ANDRI live Highgrade Records  Cityfox  ZÃ¼rich	None
ANDRI live Highgrade Records  Cityfox  Zürich	None
ANGEL	indie
ANGELICA FRAVI	None
ANIMARILYS	None
ANTHONY  TÉTON  NICOLAJ  Mr Silent & She DJ Vany	None
ANTHONY Kavanagh	None
ANswer	None
AOKI takamasa	ambient
AR	desi
ARG  Beatbrothers	None
ARMONIX	None
ARNAUD VINTAGE  Vintage records  FR	None
ART MAILLE	None
ASOK	techno
ASURA	trance music
ATA	techno
AURELIO DE MARSICO	None
AXL P Aleryde	None
AYOu2028	None
Aaawesome Colors	None
Aalbou	None
Aaron Haûs	None
AbEs	None
Abbruchhaus	None
Abdel Hady	disco
Abel	deep indie r&b
About Paula	None
Above & Beyond	house music
Abrocybe	None
Abstrhytmik	None
Academist	None
Acaso	None
Acid Arab	techno
Acid Pauli	house music
Acktivism	None
Acousmie	None
Acqua	None
ActFact Records	None
Actamin	None
Ad Noseeam	None
Ada	techno
Adam Port	disco
Adam Wiston	None
Adana Twins	deep
Addictive TV	rock
Addison Groove	uk garage
Adi	retro electro
Ado	None
Adolpho & Franky	None
Adrian Bergmann	None
Adrian Bergmann anyideas	None
Adrian Bermudez	None
Adrian Flavour	None
Adrian Martin	disco
Adrian Martin und Gianni Callipari	None
Adriano	rap
Adriano Mirabile	hip hop
Adriatique	techno
Adrien	None
Adryan	None
Adva	None
Adverblaster	None
Ady Montana	None
Aebeloe	substep
Aeed	abstract beats
Aeffryboedy	None
Aendy	None
Aerophobica	None
Africaine 808	fluxwork
Afrojack	house music
After Grauer	None
Agape	None
Agape  Koums	None
Agent C b2b Chemical Soul	None
Agent Sascha	None
AgnÃ¨s	pop
Agnès	chamber pop
Agonis	None
Agoria	techno
Agoria b2b Mirko Loko	None
Airone	None
Ajele	None
Ajele Naturklang	None
Akowa	None
Aktuelles Album Friede Freude	None
Aktuelles Album Mo Kolours	None
Aktuelles Album Observatory	None
Akwarium	None
Ala Vs Dinasty	None
Ala Vs Dynasty	None
Alain Heiniger	None
Alain Roy b2b Dirty Larry	None
Alan K	techno
Albert & Hofmann	None
Albert Hofmann aka Sins & GaLaBar	None
Albi	None
Alci	bolero
Ale Marquez	rap
Alec Troniq	deep
Alejandro Mosso	techno
Alek Sys	None
Aleksander Nesic	None
Alessio	None
Alesso	house music
Alex & Digby	rap
Alex Attias	breakbeat
Alex Austin	None
Alex Barck	None
Alex Costanzo	None
Alex Dallas	None
Alex Dallas b2b Kalabrese	None
Alex Dima	None
Alex Flitsch	house music
Alex Kennon	house music
Alex Kostic	None
Alex Lore	None
Alex Mine	techno
Alex Mota	None
Alex Niggemann	techno
Alex Sumi	None
Alexander Cherry	rap
Alexander Robotnick	None
Alexander Vogt	house music
Alexandre Eco	None
Alexis Cabrera	techno
Algorythm Rec  GER	None
Alice HÃ¤nseberger	None
Alice Hänseberger	None
Alice Hänsenberger	None
All Day I Dream	None
Alle Farben	deep
Allen D Shac	None
Allied	drum and bass
Alma Negra	None
Alma Soul	None
Alphajet  TheFamily  Winterthur	None
Alphonse du Toit	None
Altar of Flies	rock
Alternative	deep new wave
Alternative DJs	None
Aluk Todolo	metal
Alx	reggaeton
Alæ	house music
Amad vs Mented Wise	None
Amaro	reggaeton
Ambareesh	None
Ambivalent	techno
Amenthia	None
Amilcare	romantic
Amine Edge	disco
Amine Edge & DANCE	house music
Amine Heitz	None
Amsterdam	None
Amy Macdonald	pop
AnGy KoRe	techno
Ana Eva  The Kitchen Room	None
Anand B	None
And Hazel	None
AndId	techno
Andhim	house music
Andi Deutsch	None
Andre	techno
Andre Hommen	house music
Andrea Festa	techno
Andrea Frisina	rap
Andrea Giamboni	None
Andrea Oliva	techno
Andrea Roma	techno
Andreas	swedish
Andreas Foxx	techno
Andreas Foxxu200b & Daniel Demasoni	None
Andreas Henneberg	house music
Andreas Ramos	disco
Andreas Ramos Baked ZH	None
Andrew	indie
AndrewGee	None
Andri	deep
André Duracell	None
André Galluzzi	None
André Hommen	house music
André Reuse	None
Andrés Marcos	None
Andy Baxter	house music
Andy Moor	trance music
Angel Haze	hip hop
Angelica Fravi Aka Angy Dee	None
Animal Trainer	deep
Animation byAnish & The PDG	None
Anish	rap
Anja Schneider	techno
Ann Clue	None
Another Dark Swinging Room 5	None
Anthik	house music
Anthony Cat	None
Anthony Dandrea	None
Anthony Reber	None
Antislash	house music
Anton Madera	rap
Antoni Bios	rap
AnyIdeas Soundsystem	None
Aphex Twin	electronic rock
Apollonia	None
Apolloniau2028	None
Après minuit Entrée 20	None
Archetype	christian
Archie Hamilton	techno
Architectural	dub
Arg	None
Argenis Brito	None
Ariane	None
Ariane Effect	techno
Ariel Kinsky	None
Arival	None
Ark	vapor soul
Arne Spremberg	disco
Arno Vintage	None
Arnstroem	None
Arnstrom & Sascha Stohler	None
Aron Tanie	None
Arovane	ambient
Arran Lee	None
Art Department	techno
Artenvielfalt	techno
Arthur Russells Instrumentals Directed by Peter Gordon	None
Artikal  Black Box  NL	None
Artmaillé	None
Arttu	None
Arutani	None
Ash kidd	rap
Asic	None
Asile  Live   BP   Paris	None
Ataxia	techno
Atol	None
Atønal	None
Au niveau international	None
Audino	None
Audino & Barbir	None
Audio Soul	None
Audio Werner	techno
Audiofly	house music
Audiohm	None
Audiojack	house music
Audionatica	techno
Audioporno	house music
Audiotrix  FR	None
Aulay	None
Aulay Fou	rap
Aulay Fou aka Purabronca	None
Aulay Purabronca	None
Aus	metal
Aust	None
Autistic	techno
Automathi	None
Autostrada A2 direzione Lugano	None
Autostrada A9 direzione Como Nord	None
Avant minuit Entrée Gratuite	None
Avem	None
Avenue Shakerz	None
Avrosse	techno
Aware	None
Axel Boman	house music
Ayhasca Ernesto	None
Aytunç Köles	None
Azax	None
Azax Syndrom	trance music
Azimute aka Quenum & Cesare vs Disorder	None
Azuni	techno
Azur	None
B Y Z Å N C E  Deepethnic Music	None
B2B	None
BACALAO  live	None
BAD TRIP INC SPECIAL	None
BAD YARD SOUND	None
BAR STAGE	None
BASS BROTHERS  drum & bass  PRT	None
BASSMENT	None
BASSnSMILE Crew	None
BASTOR	None
BE	rock
BELLOMZ	None
BEN LARSEN	techno
BEN MUETSCH	None
BERLIN	house music
BERNARDO	None
BFLY STEINER	techno
BIFASICO	None
BIFASICO aka ManuHeme & LITCH	None
BIG HAIR	None
BIRD	indie
BLACK TIGER Basel City	None
BLUEFISH	None
BLine	None
BOLD	hardcore
BOM	vapor pop
BOUNCE  live	None
BP Zulauf	None
BPM  BS	None
BPST	None
BRAIN DAMAGE FEAT WILLI WILLIAMS	None
BRAINDRIVER	None
BRAINIAC	rock
BREKOWSKY b2b JONNYNES	None
BS	None
BUNKER	None
BURAQ	None
BUVETTE live	None
Baba Roga	None
Baby Brown	slow game
Bachstelzen	None
Backing band  THE HOMEGROWN BAND	None
Backspin Boys	None
Bad Man vs Dirty Harry	None
Bad Nelson Darsen	None
Bad Nelson from Losanna	None
Bad News	None
Bad Taste  UA	None
Baggy Bukaddor	None
Bagheera	rap
Bahia	pop reggaeton
Bahia BlancaAR	None
Baile Musik	None
Bakermat	house music
Bakyr Tenuta  Lausanne	None
Bala M	None
Balance Alliance Records Chicago	None
Bang Goes	None
Banga & Disco D	None
Banshee	escape room
Bar 25	None
Bar25	None
Bar25  Berlin	None
Bar3000	None
Bar3000Plattenrelease	None
Barbir	None
Barcelona	acoustic pop
Bardia Salour	None
Bardo & Salazar	None
Barem	techno
Bas Ibellini	None
Baschgi Schuub	None
Basel	consort
Basic Fingers	None
Basko	None
Bass Warriors	breakbeat
Bassbüro	None
Basskontrolle	None
Bastian Lehnert	rap
Bastian Schuster	techno
Batiment	house music
Batiment b2b Marla	None
Battles	otacore
Batuk	None
Bauchamp	None
Bauchamp  Live	None
Baumeister	None
BeaTTronic	None
Beam rec	None
Bear the Eagle	None
Beardyman	techno
Beatamines	house music
Beatbrothers  AG	None
Beatniks	None
Beats On Demand	None
Beautiful Swimmers	rap
Beda	rap
Bedouin	rock
Bedran	None
Beez & Simo	None
Belcastro	None
Belfort	None
Bella Sarris	None
Bellevue	rock
Bellomz	None
Belzebass	electro trash
Ben Aldred	None
Ben Ashton	None
Ben Def	None
Ben Kaczor	rap
Ben Larsen	techno
Ben Purple	None
Ben Purple  TheFamily  Winterthur	None
Ben Purple  Winterthur	None
Ben Rau	techno
Ben Yoo Suk	None
Beneath	None
Beni Jacksen	None
Beni Jacksen b2b Dan B	None
Benja	None
Benjah	hip hop
Benjamin Brunn	None
Benjamin Damage	house music
Benjamin Fehr	hip hop
Benjamin Freeney	None
Benjamin Gasser	None
Benjamin Visinand	None
Benna dj	None
Benno Blome	rap
Benoit & Sergio	disco
Benotmane	house music
Berber & Pasta	None
Berceuse Heroique  USA	None
Berghain  Berlin	None
Berin	None
Berlin	house music
Berlin Room Resident Dj Matteo Melillo	None
Berlin Room with Matteo Melillo	None
BerlinDE	None
BerlinZH	None
Bern	None
Bernardo	None
Bernoise	None
Bernstein & Stiglitz	None
Betolicious	None
Betty Boop	None
Betty&Ford	None
Big T	None
Big T  Subtl  GE	None
BigT	None
Bildstörung	None
Bill Kouligas	None
Bill Patrick	None
BillyO	None
Binh	vietnamese pop
Biosphere	ambient
Bird	indie
Birdy Nam Nam	turntablism
Biru	None
BitTuner	None
Bitsculpter	techno
BjÃ¶rn StÃ¶rig	house music
Björn Nimmich	None
Björn Störig	house music
Björn Torwellen	techno
Black Bunker djs	None
Black Coffee	house music
Black Forest	downtempo
Black Sally & The Grumbler	None
Black Spirit	rock
BlackForest Underground	None
Blackley	jump up
Blackphone666	None
Blaqq & Whyd	None
Bloc937  Ariane Effect	None
Blodvite	None
Blondish	house music
Bob Bellerue	None
Bobmo	techno
BodenLos	None
Bohnenblust	None
Bojanski	None
Bok Bok	None
Bomba Titinka  electroswing live  IT	None
Bonenergy	None
Bongalow Family	None
Bongo Kids	None
Bongo Pete	None
Bongoklub Züri	None
Bonnie	rock
Bonny & Clyde	None
Bonny & Clyde  BonnyClydezh	None
Bonobo	downtempo
Bontempi DJs	None
Bontempi Djs	None
Bonzzaj	None
Boo	None
Boo Boo Groove	None
BooBoo Groove	None
Boom Nasha	deep psytrance
Bora Bora	etherpop
Boris Brejcha	techno
Boris Werner	techno
Boris Why	rap
Born Bjorg	techno
Boston Bun	disco
Boumi B	None
Bourse aux vinyls et instruments dès 16h00	None
Bowmore	None
Bowser	None
Bowski	techno
Boy George	new
BoyAn	house music
Bradley Zero	None
Brandt Brauer Frick	microhouse
Brandt Brauer Frick feat Ommas Keith	None
Branislove	None
Braunbeck	techno
Breakbeat Movement	None
Breandan Davey	techno
Brett Jacobs  MOAN  Karton	None
BrettHit	techno
Brian Phyton	None
Brian Python	None
Brian Sanhaji	hip hop
Brodinski	house music
Brodinski  F  Bromance Rec	None
Bronson	hip hop
Brothers in Arms	None
Brown S	house music
Brown S a collaboré avec plusieurs artistes du label Defected Records tel que Simon Dunmore	None
Brown S a eu la chance de jouer lors de la WMC	None
Brown S a joué pour les plus gros Events de la place comme les Red Zone	None
Brown S est à la base du succès des soirées Tasty qui se déroulent à Genève depuis 2011 et qui regroupent 4 à 5 fois par année 1000 à 1500 personnes avec Brown S accompagné dun artiste international	None
Bruno Minimal	None
Bruno Pronsato	None
Bruno Pronsato  thesongsays	None
Bryan Coletta	None
Bryan Lewis Saunders	None
Bud Clyde	None
Buenos Aires & Mike Wall	None
Buenos AiresAR	None
Bugge Wesseltoft	jazz
Bulgaria	None
Bunte Bummler	disco
Bunte Kuh	None
Buraka Som Sistema	kuduro
Burnski	techno
Burt Cobain & Ali  Alburt	None
Busy P	house music
Butch	rock
Butterfly	rock
By HyperWerk HGK FHNW	None
BÃ¼rkliplatz	None
Bürkliplatz	None
C2Cu2028	None
CA	rap
CABIN CREW	house music
CAPE TOWN EFFECTS	None
CAPTAIN HOOK LIVE	None
CASA SHOW LIVE	None
CASQUE	None
CATWEAZLE  MinimalFraktion	None
CENACLE CREW	None
CEO Müller	None
CEZAR	techno
CFLOW	None
CFlow	None
CH	None
CH6850 Mendrisio	None
CHUK	redneck
CLAUDE TARRELL	None
CLAUDE aka Fulgeance	None
CLINCKER	None
CLUB Floor II	None
CMYK	None
COCOON STAGE Apollonia	None
COSINUS	None
COSMIC STUDIOS & WORKTIME EVENTS PRESENTS	None
CROCODILE SOUP	rap
CRay	trap
CRay & Guipei	None
CYPHER	None
Cab Drivers	None
Cabanne	None
Cadenza  Berlin	None
Cadenza  Lausanne	None
Caillou	None
Caleesi	None
Callis	None
Cameo	soul
Camo & Krooked	drum and bass
Canson	house music
CapohLitch	None
Caprices Festival	None
Card On Spokes	hip hop
Carex Human revolution	None
Cari Lekebusch  Stockholm	None
Caribou	electronic rock
Carl Cox	house music
Carl Craig	techno
Carla Du Riche	None
Carlo Malito  IT	None
Carlos J	None
Carlos Valdes & Sandrien	techno
Casa Show	None
Cascandy live	None
Caslau  Luke Haslau	None
Cassy	microhouse
Catacombs	funeral doom
Cathy JU	None
Catnappu200b LIVE	None
Catz N Dogz	house music
Cedric B	techno
Cedric Zeyenne	groove room
Cem	turkish
Central Rodeo	techno
CentreStage  BÃRKLIPLATZ	None
CentreStage  BÜRKLIPLATZ	None
CepheÃ¬	None
Cepheì	None
Ceri	techno
Chacal & Yakarta	cubaton
Chaim	rap
Channel X	house music
Chaos In The CBD	house music
Chapkmace	None
Charles Fenckler	rap
Charlotte de Witte	None
Chase & Status	house music
Chaton dj	None
Chemical Soul	techno
Chemical Soul b2b ZGroove  JurRecords	None
Chez Damier	house music
Chic Brown	None
Chic Miniature	None
Chic Miniature aka Guillaume & The CoutuDumonts & Ernesto Ferreyra	None
Chicks Luv Us & Medeew	hip hop
Chief	trap
Chill Chilla & Backdoorboys	None
Chillhat	None
Chimeric	None
Chino Flatbeat	None
Chipe	None
Chlär b2b Versatile	None
Choronzon	techno
Chris Ahn	techno
Chris Air	None
Chris Bailey	None
Chris Clayton	None
Chris Lattner	techno
Chris Leon	None
Chris Liebing	techno
Chris Liebingu2028	None
Chris Loud	None
Chris Power and Friends	None
Chris Raphael	techno
Chris Rockwell	techno
Chris Rockwell  MinimalFraktion	None
Chris Rockwell  MinimalFraktion  Eidgenoss	None
Chris Schwarzwälder	None
Chris Tietjen	rap
Chris Van Rock	None
Chris Vee  Techno Room From 2400 to 200	None
Chris de Bale	None
Chris de Luca vs Phono	None
Chris de Rebel	None
Chris the Rebel	None
Christian & Raphaël	rap
Christian Burkhardt	techno
Christian Knipp	rap
Christian Löffler	house music
Christian Tamborrini	None
Chriz Haze	None
Chronophone	None
Chuckie	house music
Chukks	None
Chymera	house music
Cika	None
Cipmo	None
Circumflux	None
Ciril Camen	None
Cirill	None
Cirillo	techno
Cirkus	downtempo
Citizen Kain	house music
City Flow  SLY INK	None
Cityfox  Zurich	None
Clap Clap	electronic rock
Claptone	house music
Clara	None
Clarisse	None
Clarisse  Lausanne	None
Clash	rock
Claude Laurier	None
Claude Staffieri  LaFamiglia  CH	None
Claude Tarrel	None
Claudio Carrera	None
Claudio Loco  Psy Group	None
Claxon	None
Clearvision	None
Clem	hip hop
Clem  Specimen	None
Click  Click	pop
Clincker	None
Clive Henry	techno
Cloud Boat	None
Club	electronic rock
Club Bonsoir	None
Club Q	None
CnD	None
CoMini	None
Coast	None
Cobeia	hip hop
Cockboy	None
Cocktails Bar	None
Cocoon	chanson
Cocoonnet	None
Code Club	None
Coldcut	breakbeat
Colludo	None
Colt Seavers	None
Coma Cruise Live	None
ComaCorp Showcase Cassatta & Soapy LIVE	None
Come raggiungerci	None
Comfort Fit	hip hop
Comfortnoise	None
Commix	drum and bass
ConAction	None
Condor	cumbia sonidera
Coni	house music
Consor	techno
Constell rassemble et unit dans la diversité	None
Conzuela Numez	None
Cool Cat	None
Cool Tigers	None
Copains Sauvages	None
CopenhagenDK	None
Copyright	disco
CordobaAR	None
Corpataux	techno
Cosi Dee	None
Cosme Tenuta  Lausanne	None
Cosmo	None
Cosmokolor	rap
Costa Del Soul DJ Team	None
Counterstrike	drum and bass
Crazy Daisy	None
Create w DOMA & TheAlchemist	None
Creative Discotheque	None
Cristi Cons	rap
Cristian Tamborrini	house music
Cristian Varela	techno
Critical  UK	None
Critical Mitch	None
Croatia Squad	house music
Crookers	house music
Crosstown Rebels  Berlin	None
Crotek	None
Crowdpleaser	techno
Cruz Jr	None
Cruz Jr and Tony Tide	None
Cryin Soul	None
Cryptonites	house music
Crystal Fighters	electronic rock
Cuartero	techno
Cubex & La Vitamina	house music
Cubique	None
Culoe De Song	house music
Culprit Sentiment	None
Curly Project	techno
Current Value	drum and bass
Custom Tea	None
Cutkachi  rest  dubtopia  Bern	None
Cuushe	ambient
Cyberpunkers	house music
Cyclic	None
D	rock
DAN NOEL	house music
DANI FABREGA	None
DARKSIDE	techno
DAVE 202  OXA  S2 Records  Mayday	None
DAVID FRAKA	None
DAYDIN	None
DAYSOMMAR OPEN AIR	None
DAndy vs TRony	None
DB7 & DJ NYLE	None
DCP	None
DE	norteno
DEIKO	None
DEKO MIR	None
DEKO by MINIMALFRAKTION	None
DELOR	deep sunset lounge
DEYAN	None
DFA	None
DGRZ	None
DHARMA	rock
DIEGO	banda
DIEGO INDIGO	None
DIONYSOS	chanson
DIRTYMADSOUND	None
DISCOfloor	None
DIVINE ADVENTURE	None
DJ	trap
DJ ATN	None
DJ Alex B Hard	None
DJ Andrew	None
DJ Arg	techno
DJ Arg b2b Score	None
DJ BATTLE	None
DJ BRADD	None
DJ Bakerman	None
DJ Bedran Marquez	None
DJ CELLSKI	None
DJ Can	None
DJ Chemical Soul	None
DJ Cipmo	None
DJ Cosmokolor & Raouf Djazz	None
DJ DONAT	None
DJ DOSQ	None
DJ DREAM  OXA  Special closing set	None
DJ Dangerous Dave	None
DJ Dario La Mazza	None
DJ Deenastry	None
DJ Deep	house music
DJ Denostra and friend	None
DJ Dierlijk	None
DJ Dino Pergola	None
DJ Dk13	None
DJ Don Vincent	None
DJ Doom	hip hop
DJ Doug	None
DJ Dream	None
DJ Dylan	None
DJ EUPHORIA  Baldoria  Pickle	None
DJ EZ	house music
DJ Eva Peel	None
DJ F	None
DJ FAFF	None
DJ FAITH	None
DJ Fett Burger	None
DJ Focus	None
DJ Fokus	None
DJ Food & DK	rap
DJ GILB	None
DJ Geisha	None
DJ Gelber	None
DJ Girl	None
DJ Girl  3	None
DJ Giusy S	None
DJ Grandmaster Flash The Turntable  Legend	None
DJ HERA	None
DJ Hidden	drum and bass
DJ Highman	hip hop
DJ IN DA MIX	None
DJ ISMASH	None
DJ Inferal Basterd	None
DJ JELLY ROLL	None
DJ Jack Slaughter	None
DJ Jaj	None
DJ Jamie Lewis	None
DJ Jerome	None
DJ Jerome Antiny	None
DJ Jerome Antony	None
DJ Jibone	None
DJ Jon Travolta	None
DJ Josko Antek	None
DJ Juri	rap
DJ Jutzi	None
DJ KAMA	sunset lounge
DJ Kon  Boston	None
DJ Kosta Greco	None
DJ Koze	house music
DJ LCP	None
DJ Le Baron	rap
DJ Le Roi	hip hop
DJ LukJlite	None
DJ M T Dancefloor feat DJ Mischpult liveDJ Set	None
DJ MITCH  old school swing  CH	None
DJ MITCH  swing old school  GE	None
DJ Madwave	techno
DJ Madwave  OXA  Trance4life  Phoenix Records	None
DJ Mandrax	None
DJ Marjanski	None
DJ Markus haZe  save the VINYL	None
DJ Marvin J	None
DJ Mateo	None
DJ Merk	None
DJ Mibor  electroswing  SP	None
DJ Mitch	None
DJ Mitch  swing  GE	None
DJ Moishe	None
DJ Moule	None
DJ Nactal	None
DJ Nader	house music
DJ Nakadia	None
DJ Nat	None
DJ Never	None
DJ Nissque	None
DJ Nonames	None
DJ Nukem	rock
DJ Nyle	None
DJ ORDOEUVRE	None
DJ PBell	None
DJ PRIMACY	None
DJ Pasci	None
DJ Phil Will	None
DJ Placid	techno
DJ Public	None
DJ Q	uk garage
DJ Quad Damage	None
DJ RAMSES	None
DJ RECAREY	None
DJ ROMAN CLEISS	None
DJ ROSS	None
DJ ROUNI  electro swing  CH	None
DJ ROUNI  electroswing  GE	None
DJ RTorkk	None
DJ Ralf	hip hop
DJ Remo	None
DJ Result	None
DJ Rocca	downtempo
DJ Rouni  electroswing  GE	None
DJ Rumory	None
DJ Ryck Plan B	None
DJ STEEL	None
DJ STOPPA	None
DJ SYX	None
DJ Sam Divine	None
DJ Score	None
DJ Shadow & Cut Chemist	hip hop
DJ Sixxxx	techno
DJ Sneak	house music
DJ Soulstrip	None
DJ Spinna	None
DJ Spiri	None
DJ Steaw	house music
DJ Sticka	None
DJ Style	coverchill
DJ Style & UniT	None
DJ T	hip hop
DJ Tennis	house music
DJ Tomic	None
DJ Tonic	None
DJ Tray	None
DJ Trigun	None
DJ Tyrone B Nelson	None
DJ Voltec	house music
DJ WU3	None
DJ ZGroove	None
DJ Zebra	mashup
DJ Zippy	None
DJ Zör Gollin	None
DJ lukJLite	None
DJANE VALEA	None
DJDuo Katzentanz	None
DJERRY C	None
DJOANNA	None
DJS	new jack swing
DJS GSwing  swing  CH	None
DJamency	techno
DJs	new jack swing
DJs André Marvin	None
DJs Atol	None
DJs BitTuner	None
DJs JussiPekka	None
DJs with bad haircuts	house music
DJulz	techno
DK	None
DK Brown	None
DK13	None
DLC	None
DMX Krew	techno
DOSCI Look Like Plattentaufe	None
DPC	None
DR JONES	tone
DRAXON	None
DRENAN	None
DRESSCODE all in white	None
DRHELMUT	None
DUDU GALVAO	None
Da Benni	None
Da Brenner	reggae fusion
Da Ron	None
Dachshund	techno
Dacid	None
Dada Und Cosili Live	None
Dadaglobal	rap
Daisuke Ichiba	None
Daitan & Shivan	None
Dalibox	hip hop
Dalibox  BS	None
Dalibox  MinimalFraktion  Basel	None
Dalibox  MinimalFraktion  Salidamusic	None
Dalibox  Salidamusic	None
Dalibox & Sandro Falletta	rap
Damian Deroma	techno
Damian Lazarusu2028	None
Damon Jee	techno
Dan Andrei	None
Dan B	None
Dan Beaumont	rap
Dan Berglund	classic swedish pop
Dan Lagardère	None
Dan Noël	None
Dan Shake	house music
Dan Welton	house music
Dance Affair	None
Dance Classics & Disco	None
Dandara	None
Dandi & Ugo	techno
Dandy	rock
Dandy Jack	techno
Dandy Jack & Junction SM	techno
Dandy Jack ET LE SERPENT QUI DANSE  ruta5	None
Dani Casarano	techno
Daniel Bell	techno
Daniel Broesecke	None
Daniel Dreier	techno
Daniel Lao	None
Daniel Mehlhart	techno
Daniel Sanchez	techno
Daniele Cosmo	None
Daniele Crocenzi	None
Danielson	swedish folk pop
Danielson & Norbertto	None
Danilo Plessow	techno
Danilo Plessow aka Inverse Cinematics	None
Danilo Rossini	None
Danilo Schneider & Eveline Fink	rap
Danni B	house music
Danny Coleman	None
Danny Daze	disco
Danny Faber	techno
Danny Freakazoid	None
Danny Howells	house music
Danny Krivit	hip hop
Danny Mansfield	None
Danny Serrano	techno
Danny Settimio	house music
Danse Noire djs	None
Daparec	techno
Darek	None
Daria	techno
Dario DAttis	disco
Dario DAttis Official	None
Dario La Mazza	None
Dario Rivas	rap
Dario Rohrbach	None
Dario Todorovic	None
Dario Zenker	techno
Dariolem	None
Darius Syrossian	house music
Darko Stronqvist	None
Darkstar	microhouse
Darkstep	None
Darrien	hardcore
Das Balz	None
Das Balz b2b Adrian Bergmann	None
Das Balz b2b Amelié	None
Das Blenden	None
Das Fest	None
Das Volca Massaker Orchester	None
Das polnische Abgang & Chinchi	None
Dash Berlin	house music
Daso	techno
Datendrang	None
Dave 202	trance music
Dave Canina	None
Dave Clarke	techno
Dave Dinger  Bachstelzen  Bar25	None
Dave Dinger & Matija	hip hop
Dave Eleanor	hip hop
Dave Martins	rap
Dave Multitask	None
Dave Neff	house music
Dave Phillips	psychobilly
Dave Saved	None
Dave202	trance music
David Armada	rap
David Armada  Specimen	None
David Cumplido	None
David Delgado	hip hop
David Durango	techno
David Faust	rap
David Fjörgenson	None
David Fjörgenson Live	None
David Glass	hip hop
David Jach	house music
David Keno	house music
David Rodigan	None
David Smile b2b Pat KP	None
David Suivez	None
David Torr	rap
David5	None
Davide Squilace	None
Davide Squillace	techno
Davidlab aka DDL	None
Davidon	rap
Davix	None
Dax J	techno
De Suso	None
De fêtes marathon où amour rime avec toujours en afters rocambolesques en passant par le cockpit de la Ruche ou du Hoppetosse nos deux compères semploient à distiller leur goût immodéré du bon groove	None
De la bonne Deep suivit dun live de minimal cest vendredi prochain au The Spirit Bar  Ca va taper du pied	None
DeWalta	techno
Dead As Disco	None
Dead Bunny	None
Dead Poets	None
Deadbeat	techno
Deborah De Luca	techno
Decktro	None
Deconstructing Drumboys	None
Dee Joe	None
Dee Nelli	None
DeeTree 9	None
Deejay Mimmo	disco
Deejota	None
Deeno	None
Deep Bros	None
Deep Dishu2028	None
Deep Seven	None
Deep n Dub	None
Deep und TechHouse	None
Deepfreeze	None
Deepwave	None
Deepwhite	None
Deetron	techno
Definition	hardcore
Dego  2000Black  UK	None
Dejan	None
Dejan & Patrischa  Cityfox  Naturklang	None
Dekmantel	None
Dekmantel  San Francisco	None
Deko by Night Facotory DekoKollektiv	None
Delakeyz	house music
Delano	pop
Delorian Cloud Fire	None
Delphic	electronic rock
Demegy	None
Dement3d  Geneva	None
Demetrio Giannice	house music
Demir & Seymen	None
DemonD	None
Dene Anthony	None
Denis Dzigal LIVE	None
Deniz Bul	None
Denostra	None
Der BRONX Bar ShuttleBus befördert unsere Gäste zwischen 2300 und 0430 Uhr kostenlos und bequem zu uns in die BRONX Bar	None
Der Dirigent	None
Der Dritte Raum	techno
Der Gekaterte Stiefel	None
Der Held	None
Der Junge mit der Trompete	None
Der Kleine Italiener	None
Der Schlechte Einfluss	None
Der Schmeisser	None
Der Schuft	None
Der Tietz	None
Der schlechte Einfluss	None
DerStein	None
Derrick May	techno
Dersu	None
Di Bastardo	None
DiTosca	None
Diatek	techno
Dicke Lauscher	None
Die Galoppierende Zuversicht	None
Diego Hostettler	techno
Diego Suarez	disco
Diego Tony	None
Digital Natives	None
Digital Switchover	None
Digitaline	techno
Digitalism	electronic rock
Digitule	None
Dilbert	peruvian
Dilek	None
Dilek Records	None
Dillon	house music
Dilusso	None
Dim  Eevy	None
Dim & Eevy	None
Dimb	None
Dimitri	house music
Dimlite	abstract beats
Dinan	None
Dinky	techno
Dino Pergola	None
Dino White	None
Dirt Crew	house music
Dirty Beat	house music
Dirty Cultures Official	None
Dirty Doering	deep
Dirty Flav	None
DisOrder	rap
Disciples	house music
Disco Channel	None
Disco Dave	rap
Discod  Banga	None
Discø Chånnel	None
Disko Dario	None
Disprove	None
Divalvi	house music
Divine Adventure	None
Dixonu2028	None
Diynamic	None
Diynamic  Lausanne	None
Diynamic Label Night	None
Dj Adryan Galantucci	None
Dj Arode	None
Dj Aroy	None
Dj Bliss	None
Dj Christo	None
Dj DFyne	None
Dj Dubstep	None
Dj Faith	None
Dj Fenomen	None
Dj FinalX	None
Dj Gino	None
Dj Giuly	None
Dj Gunnar Stiller	None
Dj Infernal Bastard	None
Dj Jestics	None
Dj Johnny & Dj Fonseca	None
Dj Kemikal	None
Dj Kulturshock	None
Dj La Febbre	None
Dj Lorenz	None
Dj Lu K & Fionom	None
Dj Lucc	None
Dj Mark  Commercial Room From 2400 to 200	None
Dj Martin Meier	None
Dj Mauri	None
Dj Miguel	None
Dj Montes  Goldfinger Brothers  Basel	None
Dj Never Die	techno
Dj Nikolaz	None
Dj Ouch	hip hop
Dj Pasci	None
Dj Pitch	None
Dj Polyrithmo	None
Dj Ram Vee	None
Dj Raver	None
Dj Reas	None
Dj Rolla	None
Dj Rotation  Hip Hop Room with Dj Pitch	None
Dj Rouni	None
Dj Rumba Stéréo	None
Dj Sat El Flaco	None
Dj Scream	trap
Dj Shepdog	None
Dj TAG  Tresor	None
Dj Tom Vibe	None
Dj Tonic	None
Dj Vidy	rap
Dj Zano P	None
Dj depuis 10ans	None
Dj dion	None
Dj set & visual show by Kreisprozess	None
Dj set FAB	None
DjMitch	None
DjMitch & Urban Panik	None
DjS	new jack swing
Djaimin	None
Djamency	techno
Djebali	techno
Djeniz	None
Djerry C	None
Djs with Bad Haircuts	house music
Dmori	None
Doctor Dru	disco
Dododbeatz  Mallow Rec	None
Dog Almond	None
Dollar Mambo	rap
Dollarman	None
Dom	rap
Dom & Roland	drum and bass
Dom&Roland	drum and bass
Doma	hi-nrg
Domi Chansorn	None
Domingo Romero b2b Michel Sacher	None
Dominic	pop
Dominik Auderset	house music
Dominik Eulberg	techno
Don Malastas	None
Don Ramon	argentine reggae
Don Ramon & MA	techno
Don Ramon & San Marco	techno
Don Ramon San Marco Pasci joey	None
Don Ranking	None
Don Tetris	None
Don Vincent	None
Don Williams	country
Donnerwetter	None
Doomwork	techno
Dope Ammo &Shaddy MC	None
Doppelpack	None
Doppelt Gemoppelt	techno
Dorian	None
Doris Stemmel	None
Douala	None
Double & Parkz	None
Double You  Jokari	None
Doublescore  Renesanz Rec & Italo Business	None
DoubtingThomas	techno
Douster  Sound Pellegrino	None
Dr Bitstream	None
Dr FadR	None
Dr Jones	tone
Dr Lektroluv	None
Dread J	techno
DreadJ	techno
Dreksler & Haerle	None
Dreksler & Haerle LIVE	None
Drifter	drum and bass
Drime  Hexagon Dubs  UK	None
Drinks & Food	None
Driscoxa0 GE	None
Droplex	techno
Drum & Bass  Kalvingrad	None
Drum That Bass  CH	None
Drum and bass	None
Drumcode  Firenze	None
Drumder  the Bonggos	None
Drumedar	None
Drumpoet	None
Drumpoet Night	None
Drumpoet ZH	None
Drve	None
Dser	None
Dser  Dark Manoeuvres  GE	None
Dual Channel	None
Dualism	progressive psytrance
Dualism ZH	None
Dub Dummies	techno
Dubculture  Event	None
Dubfire	techno
Dubfire LIVE HYBRIDu2028	None
Dubhead  Istein	None
Dublex Inc	electro jazz
Dubnova	house music
Dubois	None
Dubstep	None
Dubstep & Aulay Fou	None
Ducks on Repeat	techno
Dunwich	rap
DuoRhythm	None
Duplex	techno
DvX	electro bailando
Dynalor	None
Dynalor & Wasabideluxe	None
Dynamic Range	None
Dysonc	None
DÑlÑrÑs	None
DÑÐÑÐ¸Ñc	None
DâmFunk & Band	None
Dürerstuben	house music
Dфlфrєs	None
DфПіиіc	None
EAGLEEYE CHERRY	None
EChord	None
ED Function	None
EDDIEKEY	None
EDMX	video game music
EFunker	None
EL COLLERA  cumbia digital	None
EL NIÑO  TICINO	None
ELECTRYPNOSE	dark psytrance
ELEMENT	rap
EMI	None
EMRE ECE	None
ENDON	None
ENTRÉE FLOOR	None
ENØS	None
ERISU  Artjacking et F&S	None
EUGENE THE CAT  electroswing live  AUS	None
EULENKIND	None
EXTRASTUNDEN	None
EZoo resident DJs	None
East End Dubs	None
Easton	country
Easy	rap
Eats Everything	disco
Eclektic  Winterthur	None
Eco  Voisinage  Genève	None
Ed Luis	None
Eddie Fowlkes	techno
Eddie Hyde	rap
Eddie Queen	None
Eddie Thoneick	house music
Eddy Queen	None
Eddy Ramich	trap
Edelstahl	techno
Edgar Peng	rap
Edison Cabrino	None
Edison Cabrino b2b Helder	None
Edison Cabrino b2b Teo Ermotti	None
EdisonCabrino b2b TeoErmotti	None
Edivad	None
Edward Classen aka EDI LE CHEF	None
Eevy	None
Efdemin	techno
Efdemin  Dial  Berlin	None
Eftn	None
Eftn live	None
Egotronic	electronic rock
Egyptrixx	uk garage
Eiffel	hi-nrg
Einmaleins	None
Einmusik	techno
Eintakt	None
Einzelkind	techno
El Alusinante	None
El Mundo	rap
El Rino	None
El Tigre Sound	None
El Tigre Sound System	None
ElMar	None
Elay	None
Eldo	hip hop
Electro Floor	None
Electron  Geneva	None
Electronica Floor	None
ElectronicaBoy	None
Electrons Libres	None
Electrons Libres  JU	None
Electrophil Rec	None
Electrophil Records	None
Electrosanne by Night	None
Elektro Guzzi	techno
Elektrohandel	deep chill
Elektroschneider	None
Element	rap
Eli Escobar	house music
Eli Verveine	techno
Eli Verveine  Tardis Records	None
Elias 308	None
Eliott	None
Eliphino	uk garage
Elk  Grillmaster b2b Le Horla	None
Elk  The Grillmaster	None
Ellen Allienu2028	None
Elliver	None
Elrino	None
Elvira	hip hop
Elvis Cassetta	house music
Ema	None
Emanuel La Roche	None
Emanuel Satie	house music
Emanuele Errante	warm drone
Emely&Scum	None
Emeteria	None
Emi	None
Emilie Nana	hip hop
Emilie Simon	chanson
Emmat	techno
Emptyset	mandible
Emre Bektas	None
Emre Bektas & Denny & Mouseen	None
En dehors de Genève cest au Liquid Club de Berne	None
Ena Lind	techno
Enchufada  CH	None
Enei	drum and bass
EnfanTerrible	None
Enfant DOr	None
Enrico Valenti	None
Enterbt Recods	None
Enterbt Records	None
Entrance by the back on the street	None
Entre habitudes et nouveautés la programmation de cette nouvelle semaine annonce la couleur	None
Enzo Lo Conte	None
Enzo Pianzola	rap
Enzo Pianzola  Mauro Capitale  Gio Mbg & more	None
Enzo Pianzola MrTrend Dj	None
Enzo Pianzola aka Mrtrend	None
Enzo Siffredi	house music
Enzo Siffredi  Minimal Kids	None
Enzo Siragusa	techno
Enzo Siragusa  Randall M  Chad Andrew  Hash Hendrex  Ferro  Kamran Sadeghi	None
Enzo lo Conte	None
Epi	None
Era & Falter Visuals	None
Eramina	None
Eric Borgo	techno
Eric Fox	None
Eric S	None
Erick Morillo	house music
Ernesto Ferreyra	techno
Erobique	None
Erol Alkan	hip hop
Esben and the Witch	grave wave
Escape From Gravity b2b Introvert	None
Eskimo Live	None
Esna	None
EtN	None
Etn	None
Etn b2b Matteo Melillo	None
Etruria Beat Showcase	None
Euphoria	None
Eurokai	None
Eva Peel Neopren Records  Paris	None
Eva Shaw	big
Evelinn Trouble	rock
Evento	None
Everstone	house music
Evil Business	None
Evil Moisture	None
Evil Oil Man	None
Evolent	hip hop
Ewan Onou	None
Exium	techno
Exlab	None
Extrastunden	None
Extrawelt	techno
Ez Raidler	None
Ezikiel	techno
F	classical
F Raphaël K	None
FAB	rock
FABI HAAS	None
FABRi	None
FAITH	pop
FATK	None
FCKN Crew	electro trash
FELIPE PUERTES	None
FIN	None
FKJ	house music
FLAVIO CALZADO	None
FLOOR A	None
FLOOR B	None
FLORE  POLAAR  FR	None
FLOXYTEK  Diable au corps	None
FM Belfast	electronic rock
FOG & PHOBOS	rap
FOOL	None
FORSITION	None
FOXY	hip hop
FOYER	None
FRANK RICH	None
FRANKY	None
FRED	christian christmas
FREE ENTRANCE	None
FREITAG & FREINACHT ZH	None
FRIDAY NIGHT	pop
FRITZ FIRULIN	None
FRONTLINE	anthem worship
FRQNCY	None
FRST	None
FS Bart	None
Fabian Binkert	None
Fabian Kozelsky	None
Fabian Kozelsky b2b Somi	None
Fabian Reichelt & Raycoux Jr	None
Fabian Ulmer & more	None
Fabien	None
Fabio Papa	None
Fabio Tamborrini	disco
Fabo	hip hop
Fabri	None
Fabrizio Maurizi	None
Fabrizio aka Dee Nelli	None
Face B	None
Face Design	None
Facebook  Pascal Visacardi	None
Fagins Reject	None
Faith	pop
Fall  Sonotown  Paris	None
Fan Erhalder	techno
Fannik&Phil	None
Fantastic Friends	None
Fantastic Friends  CH	None
Fantastic Friends  La Ruche	None
Fantastic Friends  La ruche	None
Fantastic Friends Recordings  Lausanne	None
Far East Network	None
Farbenklang	None
Fat Sushi	techno
Favila&Valentine	None
Feadz	techno
Fedde Le Grand	house music
Fedde Legrand	house music
Federico Gardenghi	house music
Federico Molinari	techno
Fedo Mora	None
Feldermelder	None
Felipe & Gusto	None
Felipe & gusto	None
Felipe Acevedo	None
Felipe La Main Mise  Lausanne	None
Felipe Puertes	None
Felipe Puertes b2b Robel Volkshaus	None
Felipe Valenzuela	techno
Felix Acaso	None
Felix Et Chat cest un peu comme Starsky et Hutch mais en mieux	None
Felix Jaehn	house music
Felix Kröcher	schranz
Feodor	deep opera
Festival IN   t	None
Festival IN t   t	None
Fiat Bux	None
Fiber	None
Fichtre visuals	None
Fiedel	soundtrack
Figure Düsseldorf	None
Figure Francfort	None
Filastine	None
Filippo Vicario	None
FinalX Alex Pro	None
Finefood	None
Finnebassen	house music
Fionom	None
First Claz	None
Flavio	channel pop
Flavio Calzado	None
Flavio Sunday Breakfast	None
FlexFab	None
Flexus vs Joe Panic	None
Floating Points	house music
Floor 1  Hazienda	None
Floor 1  Shrubbn	None
Floor 2  Miss Flora	None
Floor 2  Taurus	None
Florian Hecker	lowercase
Florian Kunicke	None
Florian MSK	None
Florian Meindl	techno
Florian Meindl Flash Recordings  Berlin	None
Florian Rawyler	None
Flow	reggaeton
Flow Box	chill groove
Flowdrian & LaMeduza	None
Flumroc	None
Flying Lotus	hip hop
Foals	electronic rock
Follow Me	None
Food For Ya Soul	None
Format B	house music
FormatB	techno
Forsition	None
Foupoudav	None
Four Roses	None
Four Tet	electronic rock
Fr	None
Fracture	uk garage
Fran Serrano	techno
FranG and Bee Lincoln	None
France	jazz
Francesco Ballato	None
Francesco Diaz	house music
Francesco Rossi	rap
Francisco DJ  Techno Room From 330 to 500	None
Franco Bianco	techno
Franco Bianco Fucking Alive	None
Franco Biancou200b LIVEDJ Set	None
Franco Mento	hip hop
Francois Antico	None
Frank Lorber	None
Frank Rich	None
Frank Storm	None
Frank Vespari	None
Frankfurt	None
Franko Lopez	house music
Franky	None
Franky Rizardo	house music
Franz Bianchi	None
Franz Carl	None
François Bayle interpreted by François Bonnet	None
Freak Slaughter	uk garage
Freaks behind the Deck	None
Fred	christian christmas
Fred 34	None
Fred Licci	None
Fred Linger	rap
Fred P	house music
Fredomat	None
Fredy S	rock
Free Entrance	None
Free entrance	None
Freedom Fighters	trance music
Freiberg	None
Freitag ab 2300	None
Frenchwerk	None
Freudenreich	None
Freundchen	None
Friday 270315	None
Friede Freude Freitag  FFF Events ZH	None
Friends	emo
Friends With Displays	None
Fritz Kalkbrenner	house music
Frontline	anthem worship
Fuga Ronto	None
Fulvio Calà	None
Fumiya Tanaka	techno
Funk Flavour	None
Funky Chap	None
Funky Chap & Morris Malone	None
Funky Chap & Space K	None
Futura	None
Future Stage Opernhaus	None
FutureStage  KONGRESSHAUS	None
Féline	None
G Work	None
GALLO	None
GANZ	trap
GARCON	None
GARFLD	hip hop
GASTON  MAHMOOD  VLAD  IANOO	None
GATAN	None
GD	k-pop
GE BROS	None
GE Brothers  Basel	None
GEOERGE LAMELL	None
GER	None
GET PHYSICAL BERLIN  ANTS IBIZA	None
GMCA All Stars	None
GMCAAllstars DerSchlechteEinfluss	None
GRANT LAZLO  electroswing  FR	None
GREEKfloor	None
GREEN SYSTEM	None
GREG LA BRELLE	None
GRISE	None
GROGGIZZ	None
GROOVAH  cumbia funk  GE	None
GROUND CONTROL	hip hop
GROUND CONTROL Ñá¹Ò­ÑÒÒÑr	idm
GROUND CONTROL фṔҭіҝҝєr	hip hop
GUCCI	rap
GUEST Sebas O Verde	None
GUILLAUME P  Ge	None
GUNMAN  drum & bass  BE	None
GaLaBar	hip hop
GaLaBar  WF  Toulouse	None
GaLaBar  WFmusik	None
Gabriel Dor & Bordoy	rap
Gabriel Pellicano aka DJ Pellicano	None
Gabry C	None
Gaggiolo confineCH	None
Gaiser	techno
Gaiser Minus live	None
Gallo	None
Gameboy	None
Garage	rock
Garance	techno
Gareth Emery	house music
Garibovic	rap
Garlo	None
Garry Klein	None
GarÒ«on	None
Garçon	None
Garçon & Agonis	None
Garҫon	None
Gaspard	None
Gaspard de La Montagne	techno
Gaston	mbalax
Gaty Lopez	rap
Gel Abril	techno
Gelber	None
Gemini	trap
Gemini from Pyra all Stars	None
General Wolf	None
Genetic Dysfunction	techno
Geneva Street Food Festival dès 18h00	None
Georg Stuby	None
Georg Stuby Naturklang	None
George Lamell	None
German Brigante	house music
German Lachs	house music
Germany	indie
Geronimo	opm
Gertrude Tuning	None
Gesaffelstein	house music
Geschwister Schumann	house music
Get Physical	None
Getting Any	None
Ghetto Po	None
Ghinzu	rock
Ghosting Season	rap
Gianlukino	None
Gianni Callipari	rap
Gianni Mori	None
Gianni Palumbo	rap
Gianni Sabato	rap
Gibraltar Vacuum Live  OUS	None
Gigi Fabiani	None
Gigi LP	None
Gigolo Romantic	None
Gigolo Romantico	None
Gil Glaze	None
Gil Von De & Mica	None
Gil Von De & Sebastien Dupuis	None
Gil Von De accompagné de Francesco Vallance	None
Gil von De & Daniel Branco	None
Gill&Gill	country
Gilles Peterson	downtempo
Gilles Peterson & more TBA	hip hop
Giomar	classic peruvian pop
Gion  Chris Ahn	None
Giorgio Gigli	dub
Giorgio Maulini	techno
Girl	mashup
Girl  3	None
Giulia Regain dj	None
Giuly	hardcore
Giusb	None
Giuseppe Cennamo	techno
Giusy S	None
Giusy S b2b Maickel Esse	None
Gleichschritt	None
Gleichtackt	None
Gloria Bulsara	None
God Made us Funky Records	None
Godié EOW LU	None
Gogo	jazz
Gold Club	None
Gold N Silver	None
Golden Gate	None
Gomorra	techno
Goose	children's music
Gorillaz Sound System	None
Gotan Project	downtempo
Government Alpha	None
Graham Lambkin	None
Grand Corps Malade	chanson
Grand passionné de musique	None
Grant Nelson	uk garage
Grauwind b2b SYOM	None
Gray Chalk	None
Green Cat	None
Greg Brockmann Half Baked	None
Greg Robert LIVE	None
Greg Shepherd	None
Gregor Dubster	None
Gregor Tresher	techno
Gregory Whitehead	None
Gregorylla & Poljak	None
Gregorythme	techno
Gregster Browne	None
Greman	None
Grillmaster	None
Grnd lop prod	None
Grogizz & BigRaph	None
Groove Defenders	None
Grueter & Buergin	None
Guerolito	None
Guest	electronic rock
Guest DJs	None
Guest Simone Liberali	None
Guido Rami	None
Guido Schneider	techno
Guido aka FreeJ Rumi	None
Guillaume & The Coutu Dumonts	techno
Guillaume Delattre	hip hop
Guillaume P	None
Guillaume and The Coutu Dumonts	techno
Guipei	None
Guitar Wolf	rock
Gulasch Mafia ZH	None
Gunes Ergun	None
Gunman & Judah	rap
Gunnar Guess	house music
Gunnar Guess Naturklang	None
Guti	disco
Guy Gerber	techno
Gwyn Wurst	None
Gábor Lázár	None
Görlitz	None
GöteborgSE	None
Günes	turkish
HARKAM	None
HECTOR DMB b2b ALEX ANDER	None
HEIDI	country
HEIKO MSO	techno
HIDDEN PEAKS  Argent Sale	None
HIGHMAN  dnb jungle jump up	None
HISTORIA Trance Classics Stage	None
HJ Roedelius	None
HOSH	techno
HOSTED BY MOUSS MC	None
HOUSE	None
HOUSEHEADZ	None
HUND KOEKET	None
HVOB	house music
HYPERFREQUENCIES	None
Hack & Nick	None
Hackey	None
Hage	big room
Hamburg	None
Handan	classic turkish pop
Handbandits	None
Hanfry Martinez	rap
Hansim Glück	None
Hard Droppers	None
Hardly Booked	None
Hardtek  Raggatek  Tribecore  Zoo	None
Harris Kale	None
Harris Kale  Deep Fuzz  CH	None
Harry Klein	None
Hart aber Herzlich	None
Harysive	None
Hathor	None
Hatsune Kaidan	None
Hatzler	techno
Headbanger	hardcore
Heartthrob  Mnus	None
Heartthrob Minus live	None
Hecht & Zander	None
Hector Couto	techno
Hedoromeruhen	None
Heiko	coverchill
Heimat	hip hop
Heinz Music	None
Heiser	None
Helder	techno
Helder Costa & Lee Low	None
HelloRepeat	None
Hellquist	deep psytrance
Helm	country
Hendrikz	None
Henrik Schwarz	techno
Henrique	sertanejo universitario
Henry Wu	fluxwork
Hepp	None
Herkul	None
Hermansson	None
Hernan Cayetano	None
Herr Johann	None
Herr Mehr	None
Herr Vogel	None
Herrrouine	None
Herzschwester	techno
Hetan	None
Hexler	None
Hfs Dub	None
HiGHFi	None
HighLive	None
Highgrade	jump up
HighgradeRec  ClockArt  La Ruche  Recycle  Gimmick  Villa magica  Caduceus	None
Hiivemind	techno
Hintergrundrauschen	None
Hirsute	None
Hito	techno
Hive	indie poptimism
Hive Audio	None
Hive AudioZurich	None
Hobbs	christian christmas
Hobo	None
Hobo  Mnus	None
Holger Hecler	techno
Homeless	folk punk
Honoree	techno
Hood Regulators	None
Hopen	None
Horatio	techno
Horn Richterswil	None
Horstmeier	hip hop
Hosted by	None
Hot Jam DJTeam	None
Hot Since 82	techno
Hot Trax	None
House	None
House  Techno  Deephouse  Techhouse	None
House Floor	None
House music	None
House poudrée et pas chassés	None
Housemeister	techno
Houseworx	None
Howling	house music
Huazee	None
Hudson Mohawke	indie r&b
Hug & Schiemann	None
Human Garden Music  ITA	None
Humour	None
Hund Koecket	None
Hvitling	rap
Hypercolour	None
HӳҏnфЯєӽ	None
I	hip hop
IMPERIAL TIGER ORCHESTRA	ethiopian pop
INDEFINITE VJ	None
INTRESST & LOUIS	None
INTRODUCING MINIMAX BERN	None
ISLE OF DREAMS STAGE Avicii	None
ISLE OF DREAMS STAGE Calvin Harris	None
ISLE OF DREAMS STAGE David Guetta	None
ITA	None
ITee	None
IVVVO	house music
IXINDAMIX  SP 23	None
Ian F Colours	None
Ianoo	None
Ibo Levini	None
Ibolya Zombory	None
Icicle	drum and bass
Ida Engberg	None
Idriss D	rap
Ieva	None
Igloo	None
Igor Blaska	None
Ikosa	None
Ilario Alicante	techno
Ill Dubio  Neuchâtel	None
Illan Nicciani	techno
Illg	None
Imm & LeeO	None
In Flagranti	disco
In list con drink chf 25   20	None
InTakt	downtempo
Indeed	None
Inderrock	None
Indiana Tones	None
Infernal Bastard b2b Quad Damage  JurRecords	None
Infinity Ink	house music
Info Liste Prenotazione Tavoli	None
Ingrosso	house music
Ink	pop
Insel	None
Instabil  Köln DE	None
Instant Rave	None
Instramental	None
Introducing Minimax BE	None
Introvert	None
Introvert KonterBass	None
Iori Wakasa	techno
Irreversible	atmospheric post-metal
Isidore	None
Isidore  Salidamusic	None
Ismail & Clive	None
Isolated Lines	techno
Isolée	house music
Israel	christian christmas
Issa Maïga	None
ItaloJohnson	None
Italy	None
Itchi & Scratschy	None
Ito	None
Its Moonrack  Oscil8	None
Ivan Alvarez	None
Ivan Alvarez b2b Kenny Ground	None
Ivan R	None
Ivan Stantoro	None
Ivo Christow	None
Ivo Cristow	None
Iyad El Qirinawi aka EL Q	None
J Koofla	None
J ROCC	hip hop
J Velez AKA Professor Genius	None
JACK & JUUS	None
JAH WORK SOUND	None
JAMIE LEWIS	disco
JAMIE LEWIS & RESIDENT	None
JANK	emo
JANNI SALPINGIDIS  Durstlöscher	None
JANSKI BEEEATS  live	None
JAVIER LEMA	None
JCX	None
JEHROMM	None
JEREMY ELLIS	breakbeat
JESSE HACKETT live	None
JEUDI 12 AVRIL	None
JFTH  Minimal Kids	None
JG Thirlwell aka Foetus	None
JK Flesh	mandible
JKoofla  Barcelona	None
JO SINCLAIR	None
JOE GALEN	None
JOE VENDETTA  MinimalFraktion  Grünwerk Rec	None
JOHNNY OSBOURNE  reggae  JAM	None
JOHNSON	neo mellow
JOKE	industrial music
JOne	hip hop
JP Candela	None
JP Gross	None
JPN	None
JSanders	techno
JUJU	None
JUNIOR B	None
JUR Records Allstars DJs	None
Ja Gern	None
Jack & Juus	None
Jack & Stella	None
Jack Cinch	None
Jack Demon	None
Jack Pattern	techno
Jack Pryce	None
Jackie Greco	None
Jackmate	microhouse
Jacob Groening	house music
Jacopo Carreras	None
Jacques Obsone	None
Jacques Palminger	None
Jacqui	jazz
Jacqui  minishake  VD	None
Jagged	rap
Jake the Rapper	house music
Jako	hip hop
Jakob Jones	None
Jama	house music
Jamahr	house music
James Bay	pop
James Mc Hale	None
James Mc Hale  Tanzkarusell	None
James Mc Hale B2B SHE NIONIKA	None
James Mc Hale Sunday Breakfast	None
James McHale	None
Jamie Berry	electro music
Jamie Jones	techno
Jamie Lidell	funk
Jamie Shar	techno
Jamie White	techno
Jan Blomqvist	deep
Jan Blomqvist & Band	techno
Jan Jelinek	electronica
Jan Ketel	rap
Jan Krueger	None
Jan Oberlaender	None
Jan Penarrubia	techno
Jan Raphael k	None
Janina	concert piano
Janis	rock
Janiv Damti	None
Janiz	None
Jann Bronsky	None
Jannik Schaller	None
Jaona	None
Jaques Palminger	None
Jardin Collectif	None
Jaser Mushkolaj	None
Jaset	None
Jasmin de Souza	None
Jason Lescalleet	lowercase
Jasper Jules	None
Jauss	None
Jay Decay	None
Jay Hardway	house music
Jay Mack	None
Jay Veedee	None
Jayda G	rap
Jaydan	jump up
Jaymo & Andy George	techno
Jazmin Ng	None
Je Dâvu	None
Jean Charles De Monte Carlo	None
Jean Clef attache une attention particulière à la selection de ses morceaux Il est capable de commencer un set avec des sonorités Soul	None
Jean Toussaint	None
JeanFrançois Laporte	None
Jeans for Jesus	None
Jee37	None
Jeff Mills	techno
Jeff Mills  CINEMIX FUTURISTE	None
Jeff Swing	techno
Jeff Swings	None
Jello Biafra & le Dernier Cri	None
Jem Haynes	house music
Jembo62 & Lindon	None
Jennifer Cardini	microhouse
Jens Bond	techno
Jens Bond b2b Daniel Dreier	None
Jens Lewandowski	techno
Jens Zimmermann  FRANKFURT	None
Jeremias	pop reggaeton
Jeremy Underground	None
JeriJeri	None
Jerome Antony	None
Jerome Cerilla	hip hop
Jerome Ferra	rap
Jerome Le Baron	disco
Jerome Le Baron invites	None
Jerry Jerome & Jan Ehlen	None
Jesco Schuck	None
Jesse Rose	house music
Jessie	pop
Jestics	None
Jet Himiko	None
Jeudi 110 Electro Thursday	None
Jeudi 1510 Electro Thursday	None
Jeudi 22 Electro Thursday  SMorSillo	None
Jeudi 810 Electro Thursday	None
Jibone	None
Jichael Mackson	None
Jihell	None
Jimi Jules	rap
Jimmy Edgar	idm
Jin Chillah	None
Joah	None
Joe Claussell	hip hop
Joe Dooro	None
Joe El	None
Joe Maker	techno
Joe T Vannelli	house music
JoeFarr	techno
Joel Fabrice Volkshaus	None
Joel Gautschi	None
Joey	rap
Joey Beltram	techno
Joey Miesch	None
Johann S	classical
Johanna Knutsson	techno
Johannes Heil	techno
John B	drum and bass
John Daly	None
John Haden OnOff Recording	None
John Hegre	electroacoustic improvisation
John Khan	None
John Mad b2b Björn Lomar	None
John Paul Jones	None
John Player	None
John Player B2B Jauss	None
John Talabot	electronic rock
Johnny D	techno
Johnny Holiday	rock
Johnny Marshall	None
Jokari	rap
Joker feat Mc Nomad	None
Jon Donson	techno
Jon Gaiser	None
Jon Hopkins	electronic
Jonas Rathsman	house music
Jonathan Brown	None
Jonathan Brown B2B Markus haZe	None
Jools	post-disco
Jools vs Kid Baba	None
Joram	disco
Jordan & AslanKan	techno
Joris Delacroix	house music
Jose De Divina	None
Jose Wated	rock
Joseph Hammer	None
Josey Rebelle	techno
Josh Gabriel	trance music
Josh Milan	rap
Josh Milan from Blaze	None
Josh Tree	None
José Parra	cante flamenco
Journée Standard	None
Joyce Muniz	vienna indie
Jstar	hip hop
Juandroid	None
Juen	None
Juen & Bach	None
Juice Crew	None
Juicy julz	None
Jul Nako  Neuchâtel	None
Juli Holz	techno
Juli Lee	None
Juli N More	None
Julia Holter	indie
Julian Perez	techno
Juliano Lopez	rap
Julien Aubert	None
Julien Kano	None
Juliett	rap
Julio Bashmore	house music
Jungle Street Groove  BS	None
Junior B	None
Junior Jack & Kid Creme	house music
Junior Tshaka	None
JuniorB	None
JurRecords	None
Jus Deelax	techno
Just Alae	None
Just Music  23 febbraio 2013	None
Just like that	None
Justin Martin	house music
Justin Nozuka	acoustic pop
Jutzi	None
Jutzi Flinstones b2b Don Tetris	None
Juzz	rap
Jörn Fleig	None
Jürgen Dobner	None
Jürgen&Ich  Visuals  Köln	None
K15	None
KABAKA PYRAMID & THE BEBBLE ROCKERS	None
KAEGŌN	None
KAIN&GABEL	None
KALVIN BERG	None
KARLSRUHE	None
KEIKOWASGREAT	None
KEM KEYL	None
KEYS	pop
KITTEN AND THE HIP electroswing live  UK	None
KIZOMBA	None
KLANGBANANE	None
KMS	techno
KOMSOMOL	None
KONPIUTA LIVE	None
KONTAKT	disco
KRAFTECK	techno
KRamba	None
KTL	drone
KUAGE live	None
KUVA  Oscil8DEEPINRECORDS	None
Kabale und Liebe	techno
Kadebostan	None
Kaegōn	None
Kairo Is Koming	None
Kalabrese	microhouse
Kalabrese & Rumpelorchester	house music
Kalabrese and the Rumpelorchestra	None
Kalvin Berg	None
Kami	None
Kanax	None
Kaolin	None
Kaosbrothers  T wie Techno	None
Kapara	techno
KaraMaehl	None
Karera	None
Karl Möstl	rap
Karmina	techno
Karotte	techno
Kartel Klub	None
Kaschemme Basel	None
KasselDE	None
Kassette Boys	rap
Kastil	house music
Katakomben	None
KaterBlau	None
KaterBlau  Hive	None
Katermukke	None
Kathrin De Boer	None
Katta	None
Kaz James	australian dance
Kejeblos	None
Kellerkind	deep
Kellerkommando	None
Kenel & Sonne	None
Kenny Ground	house music
Kenny Ground b2b Ivan Alvarez	None
Kenny Ground b2b Riccardo Farina	None
Kenny Larkin	techno
Kent Brockmen Digital Frequenz Rec Human Revolution	None
Kent Brockmen LIVE	None
Kent Kaina	None
Kettel	intelligent dance music
Kev the Head	None
Kevin Shala	techno
Kez Ym  Faces Records  Japan	None
Keziah Jones	None
Khainz	progressive psytrance
KiNK	techno
KiYota	None
Kiasmos	ambient
Kid Baba	None
Kid Koala	turntablism
Kid Konzoom Berlin	None
Kidkanevil	abstract beats
Kiko C Esseiva	None
Killian Noorlander	None
Killing Sheep	None
Kily	None
Kim Kemi	techno
Kim Prevedello  Little House Castle Music	None
Kina Music	None
King Arthur	house music
Kiste	None
Kiwistar	electro music
Klaaar	rap
KlangFormer	None
KlangKuenstler	house music
Klangdruide	None
KlangfabriK	techno
Klarsicht	None
Klein und Lang	None
Klico  Freakouts	None
Klimperei	None
Klingande	house music
Knackeboul	hip hop
Knobs	techno
Knox  Zurich	None
Knuff&Knuff	None
Knut	mathcore
Knut2010	None
Knäckebröd	None
Kollektiv KlangGut  Katermukke	None
Kollektiv Ost	house music
Kollektiv Turmstrasse	techno
Kombé	None
Komsomol	None
Kongresshaus	None
Konpiuta	None
Konpiuta Live	None
Konrad Dycke	None
Konvex 1	None
Konvex 2	None
Kooperative Röschtigraben	None
Korsett Kollektiv	None
Kosta Dee	deep freestyle
Kotelett&Zadak	None
Kracoon	None
Krassen Krastev	None
Kreisprozess	techno
Krenzlin	techno
Krink	electronic rock
Krisitian	barnmusik
Kristel Morin	house music
Kriz Fade	None
Krizzli	rap
Kroman Celik	techno
Krumelur	None
Kryder	house music
Kubin	None
Kun	None
Kuno	None
Kuppel	None
Kutmah	idm
Kyodai	techno
Kyoka	idm
Kyrill & Redford	groove room
Köln D	None
KölnDE	None
König Balthasar	None
König der Fischer	None
LA4A aka Ambivalent	None
LAN MUZIC	None
LARS LINDENBERG	None
LATINO	duranguense
LCMDF  Le Corps Mince De Françoise	electrofox
LE HORLA	None
LEAFCUTTER JOHN	drum and bass
LEON	rock
LES	hollywood
LEXIS	schranz
LINE UP	None
LITCH	None
LITTLE LION & DEEP SOUL	None
LITTLE LION SOUND	None
LIVE	christian christmas
LIVE Marc Houle	None
LNF	hip hop
LOGIC WAVE	None
LOKD	None
LOKD ALLSTAR TEAM	None
LONE	acoustic pop
LSM Productions	None
LTJ Bukem feat MC Conrad	None
LU	vallenato
LUCIO Malatoid	house music
LUDOVIC B	None
LUFT	techno
LUKAS FREUDENBERGER	None
LUKII	None
LV	None
LYCTUM	progressive psytrance
La Bohème	rock
La Bohème B2B Chapkmace	None
La Cava Stage	None
La Duracelle	techno
La Fleur	techno
La Foret	techno
La Forêt	None
La Gale	None
La Ruche  Lausanne	None
La Ruche Présente	None
La Suite	None
La Vie Cest Facile	None
La Vue VJ Collective	None
Labrador City	None
Lacrema	None
Lady Noon	None
Ladybruce	None
Lago	None
Laila M	None
Lain	None
Laolu	techno
Lapalux	indie
Lara Valentina	None
Laris Alexander & Gil Von De	None
Larkian	None
Larry King	None
Larry Les Vannes	None
Lars Wickinger	None
Larytta	techno
Lastest mix  Take it as it is  Vinyl	None
Laura Jones	disco
Laurel Halo	house music
Lauren Lane	rap
Laurent Charbon	hip hop
Laurent Garnier	techno
Lauro	classical guitar
Lausanne	None
Laut & Luise	None
Lawrence	country
Layer V	None
Lazare Hoche	dub
Lazare Hoche & SAM & Malin Genie	house music
Lazerslut  Berlin	None
Lazy Mouth	rap
Le Bérger	None
Le ChatMan	None
Le Citadin	None
Le Horla	None
Le Petit Prince	None
Le Peuple de LHerbe	dub
Le collectif Oscil8 fait son premier tour de piste à Lausanne	None
Le collectif genevois CNSTL a été crée en 2011 Il est composé de 4 djs	None
Le team Brown S a été créée en 2007 Il regroupe deux amoureux de House Music à savoir Black Martini et Alex Kuem	None
Le1f	strut
LeZed	None
Lecture w Sassy J	None
Lee Burridge  Akowa	None
Lee Curtiss	techno
Lee Fraser	None
Lee Gamble	mandible
Lee Jokes	rap
Lee Jones	folk
Lee Van Dowski	techno
LeeO	None
Leeman	None
Leeroy Thornhill	breakbeat
Lefrip  Urbanstructure	None
Lefto	hip hop
Leif Elggren	lowercase
Leipzig	classical
Leisure Options	None
Lejuste	None
Leke da Loco	None
Lele DeeJay	None
Lemka	None
Lemonick	rap
Lemonick  Argent Sale  Couleur 3	None
Len Faki	techno
Leo	techno
Leon Licht	house music
Leonardo	bolero
Leone Music  Suruba X  London UK	None
Lerosa	techno
Leroy	channel pop
Les Chicklettes	None
Les Diplomates aka Mambo Chick & Jean Toussaint	None
Les Frères	kompa
Les Points live	None
Lesničar	None
LethargyZH	None
Levin	rock
Lewis Duggleby	None
Lewski	None
Lewski & Benito	None
Lexer	house music
Lexfinger	None
Lexis	schranz
Lexx	rap
Lexy	None
LiVe	christian christmas
Licht Lichtdeffekte	None
Lichtsport vs Bruno Tait  Visuals  DE	None
Lila Hart	house music
Lilith	spanish punk
Lilith  NoVus  Amazing Music  Draft	None
Lilly Palmer	None
LilÐ´ HÐ´rt	None
Lilд Hдrt	None
Lim Giong	None
Lime	freestyle
Limited Brothers	None
Limited brothers	None
Limmatquai	None
Limmatquai Swiss Innovations Stage presented by SUISA	None
Lindon & Jembo62	None
Line Up Dienstag 162	None
Line Up Montag 152	None
Line up	None
LineUp Friday	None
LineUp Saturday	None
Lineas De Nazca MEX	None
Ling	None
Lino Loud	None
Liquid	healing
Liquid Audio	None
Little Barrie	rock
Little Louie Vega	house music
Little Lu	None
Little Martinez	None
Live	christian christmas
Live Dread J	None
Live Dürerstuben	None
Live I Heart Sharks	None
Live Jeans Team	None
Live Suspect One	None
Livia Moretti voice	None
Livia Wallace & Manish	None
Living on the Outside	None
Livio & Roby	techno
Liviu Groza	rap
Local support by Audiobox Suspects	None
Loccomotion  Argent Sale  CH	None
Locloise Électro NE	None
Loco Dice	techno
Loco Lita  Basel	None
Logistics	drum and bass
Lolo & Romeo	None
London	classical
London UK	None
Look Like	house music
Loops Haunt	idm
Lorax	movie tunes
Lorenz Rhode	house music
Lorenzo Chiabotti AKA IENA SAW	None
Lorik	hip hop
Loris Palermo	None
Loris Scaglia	None
Los Abstractos	None
Los Suruba	disco
Los Wenamigos	None
Losoul	rap
Lost & Found	None
Lost Heritage	None
Lost Heritage live	None
Lost at	None
Louie Cut	techno
Louie Vega	house music
Louisahhh  US  Bromance Rec	None
Louise	None
LoveMEAlex b2b MAD  Deep Tech Records  Malicious Smile	None
Low Tales	house music
LowTales & Vanita	house music
Lu K	None
Lu K & Dubstep	None
Lu K vsFionom	None
Lu Siegwart	None
LuK	estonian pop
Luc Ringeisen	hip hop
Luca Agnelli	rap
Luca Agnelli & Marco Faraone	house music
Luca Barletta	None
Luca Castagna	None
Luca Castillo	house music
Luca Eminenti	None
Luca F	None
Luca Fioretti	None
Luca Firrincieli	None
Luca Gerosa	None
Luca Parravicini	None
Luca Torre	techno
Luca Torre vs Ben Larsen	None
Luca de Grandis	None
Luca de Grandis aka Der Schuft	None
Lucalain	None
Lucas Aliu	techno
Lucas MonÃ¨me	None
Lucas Monème	None
Lucas Ramirez	None
Luciano	adult standards
Lucianou2028	None
Lucien Dubuis	None
Lucigene	None
Lucretio	rap
Ludwig Van Electro	None
Luft	techno
Lui Young	techno
Luigi Forte	electro music
Luigi Tozzi	dub
Luis Cunha	rap
Luis Hill  Crave	None
Luka Torre	None
Lukas Kleesattel	techno
Lukas Siegwart	None
Lukas Walker	None
Luke	country
Luke Redford	None
Luke Redford  Miteinander Musik	None
Luke Vibert	techno
Luki Music	None
Lukii	None
Luna City Express	techno
Lusine	electronic
Luzern	None
LuzernCH	None
Lvov	rap
Ly Sander	rap
Lynx  Hospital  Detail  UK	None
Lé Berger	None
Léonard de Léonard	None
MADWAVE	None
MAIN Room	None
MAIN STAGE	None
MAKA	None
MANDEG ZH	None
MANDY	pop
MANNA	None
MANS1	None
MANZI b2b SOCI	None
MARABOUT	zouglou
MARKO BLAZE	None
MASH	halloween
MATT MANIK	None
MATTHEW HALSALL live	None
MATTHIAS SCHAFFHÄUSER	None
MAUY	None
MAXXDRUMS	None
MAnimals	None
MC Blackeye	None
MC FAVA	None
MC Fava	None
MC Fava  Commercial Suicide	None
MC Fave	None
MC Ksailev  Sekoïa	None
MC Matt	None
MC PAPS  Mc  GE	None
MC Paps	None
MC Raf	None
MC Riya	None
MC SOLAAR	chanson
MC STONE  Neurocide  CH	None
MC Skywalker	None
MC Skywalker  GE	None
MC Soze	None
MC Stone	None
MC Stone  Neurocide  Fribourg	None
MDR	None
ME	screamo
ME & her	rap
MEL Y  Stuttgart	None
MERCREDI 11 AVRIL	None
MERCURY FALL	None
METRIK TEKNOMAD  Astrofonik	None
MEX	deep cumbia sonidera
MF Jaeger	None
MGMS  CH	None
MIA	electronic rock
MIAU STUDIO	None
MINDX meets SNOWMAN  OXA  Harem Records	None
MINIMAL	None
MIRCO MENDOSTA	None
MIRIAM SCHWEIZER	None
MISCHKULTUR BERN  BAILE MUSIK  TIP TAP RECORDS	None
MITIKAL  dnb jump up	None
MITIKAL  drum & bass  GE	None
MIZOO	trance music
MM	regional mexican pop
MN	None
MNNSK	None
MNÃVR	None
MNØVR	None
MONEELOVE	None
MONICA DIAS	None
MORGANJ	None
MR RIDDLER	None
MR ROX & MR SIMON	None
MRI	None
MRZ	None
MTDF	house music
MXProject	None
MYKE	hip hop
MYND	None
Maayan Nidam	techno
Maceo Plex	house music
Maciek Norowol	None
Macromism	techno
Macy Gray	soul
Mad Rey	house music
MadKatz DJTeam	None
Madame Patate	None
Madben	techno
Madfunk	None
Madmotormiquel	house music
Madnax	techno
Mads Penthouse named JetLag	None
Madwave	None
Mafou	None
Magda	techno
Magdalena	harpsichord
Magit Cacoon	rap
Magnetic	indie
Mah Mood	None
MahMood	None
Maho & Jackin	None
Main Floor	None
Main Room	None
Main Stage	None
Mainfloor	None
Mainstage Bürkliplatz presented by Fordt	None
Maja Ratkje	laboratorio
Makam	None
Makau AND FILAFERRO	None
Makorokosmos AG	None
Mala  Digital Mystikz	None
Malicious Joy	None
Malik	pop
Malki	None
Malki  Deep Fuzz	None
Maloon TheBoom	None
Mambo Chick	None
Man of Tomorrow	None
Manali Shah	None
Mandar	None
Mandrax	None
Mangali	None
Manic Mike	techno
Mannequine	disco
Mannequine from Zurich	None
Mano Le Tough	techno
Manoletto	None
Manolo	trap
Manon	techno
ManuHeme	None
Manuel Fischer	None
Manuel Moreno	None
Manuel Resch	None
Manuel Sahagun	house music
Manuheme	None
MarT	swedish punk
Maral Salmassi	techno
Marc DArrigo	techno
Marc Deriaz	None
Marc Deriaz und viele Mehr Nid verpasse	None
Marc Fuhrmann	None
Marc Houle	techno
Marc Hype	jump up
Marc Klein	None
Marc Loin	None
Marc Poppcke	techno
Marc Romboy	techno
Marc Vedo	house music
Marcel	r&b
Marcel Dettmann	techno
Marcel Heese	techno
Marcel Vivo aka mrrox	None
Marcel Vogel	None
Marché sans puces dès 16h00	None
Marcism	None
Marco Bailey	techno
Marco Basile	None
Marco Berto	rap
Marco Carola	techno
Marco Carvalho	None
Marco De Rosa	house music
Marco Di Natale	None
Marco Effe	hip hop
Marco Falkone	None
Marco Faraone	techno
Marco Repetto live	None
Marco Resmann	techno
Marco Rossi	None
Marco Silva	None
Marco Trinkler	None
Marco Zenker	dub
Marco da Mata	None
Marcus Schossow	house music
Mardoch	None
Mareena	None
Marek Hemmann	techno
Marek Hemmann Freude am Tanzen  DE	None
Margaret Dygas	dub
Maria Blessing	None
Mariachi	bolero
Marina	pop
Mario Aureo	None
Mario Ferrini feat Ylenia	None
Mario Neha	None
Mario Robles	None
Marion K	None
Mark A Brook	None
Mark Ernestus	fluxwork
Mark Faermont	rap
Mark Henning	techno
Mark Lamski	None
Mark Main	None
Mark Rhein	house music
Mark Stone	None
Mark off & Curtiss	rap
Markantonio	techno
Markus Homm	techno
Markus Kenel	house music
Markus Schulz	trance music
Markus Steinhauer	None
Markus Suckut	dub
Markus haZe	None
Marlon	None
Marlon Hoffstadt & HRRSN	rap
Marquez Illu200b	None
Marrocco	None
Marshall White	techno
Martello Bros	None
Martha van Straaten	None
Martin Baur	techno
Martin Buttrich	techno
Martin Huergo	techno
Martin Ikin	house music
Martin Meier	None
Martin Solveig	house music
Marvin Aloys	None
Marvin J	None
Marwin	None
Mas Ricardo	None
Masa Saji	None
Masaya	hip hop
Masaya  Official Fanpage	None
Mass Davey	None
Massimo Brugnera	None
Massimo Stefanelli	rap
Massive Jay	None
Massive Jay  DJPlacid  Everstone  Quitim  Fabian Kozelsky  Joel Gautsch  Nenad J	None
Master Margherita	world fusion
Mastra	deep
MatJoe	techno
Matador	francoton
Matek	None
Mateo Morales	None
Mathew Jonson	techno
Mathon	None
Matias Aguayo	microhouse
Matija	None
Matrixxman	house music
Mats Lindström	None
Matt Grey	None
Matt Kay	house music
Matt Newman	None
Matt Tolfrey	techno
MattX	None
Mattafix	None
Matteo Melillo	None
Matteo Melillo  Techno Room From 200 to 330	None
Matthew Adamas	None
Matthew Dekay	deep progressive trance
Matthew Square	None
Matthew Styles	house music
Matthias Meyer	house music
Matthias Tanzmann	techno
Mattia Presta	None
Mattia Presta b2b Sthepan Esse	None
Matto	shibuya-kei
Mattoo	techno
Maurer & Toepfer	None
Max Albàn	None
Max Bragantini aka Max B	None
Max Cadence	None
Max Cooper	house music
Max Graef	house music
Max Grell	None
Max Romeo	reggae
Maximilam Stolze	None
Maximilian Berg  Official	None
Maxmillion Dunbar	idm
Maxxi Soundsystem	disco
May Kay	None
Maya Jane Coles	house music
Maztek	drum and bass
Mc Fava	None
Me & My Monkey	rap
Median Structure DJs	None
Medley Mo	None
Medo	None
Meerganglied	None
Meffekt	None
Mefjus	drum and bass
Meienberg	None
Meikel	techno
Mel Mercury	None
Melbourne	deep orchestral
Melchior	garage pop
Melodiesinfonie	abstract beats
Membrane	covertrance
Mendez & Lombardo	None
Mendo	house music
Mental Groove	None
Mental X	None
Mercury	rock
Merico	channel pop
Merik & GStone	None
Merik& GStone	None
Merk	None
Mess Me	electro trash
Metaboman	microhouse
Metalheadz	None
Metodi Hristov	house music
Metrik	drum and bass
Mewa Moog Lee	None
Mexico	cumbia
MexicoGE	None
MiNa	ye
Mia	electronic rock
Mia Kaltes	None
Mia Kaltes  Finefood rec	None
Miami Dave	None
Miami Room Resident Djs Paolo Di Mirò	None
Miami Room with Anthony Dandrea	None
Michael Gull	None
Michael Mayer	house music
Michael Placke  Exquisite Berlin  Shitlabel  Deine Lieblingsraver  Suicide Circus	None
Michael Placke Exquisite Berlin  Shitlabel  Deine Lieblingsraver  Suicide Circus	None
MichaelPfister	None
Michaelmusic	None
Michalski	None
Michel Cleis	None
Michel Degen B2B Atila	None
Michel Degen b2b Atila	None
Michel Mathis aka DJ Pun	None
Michel Morard	None
Michel Sacher	None
Mickail	None
Mickey Morris	None
Micrometropolis	None
Mideric	techno
Midilux	None
Miguel	hip hop
Miguel Campbell	disco
Miguel Puente	disco
Mihajlo K	None
Mihalis Mavros	None
Mihalis Safras	techno
Miiir	None
Mik Maroo	None
Mike & Nika	None
Mike Candys	house music
Mike Dyson	None
Mike Huckaby	house music
Mike Kay	None
Mike Leon	None
Mike Peters	rap
Mike Servito	techno
Mike Shannon	techno
Mike Teixeira	None
Mike Teixeira B2B Jan Penarrubia	None
Mike Texeira & Jan Pennarubia	None
Mike Väth	None
Mike Wall	rap
Mildred Guy B2B Condor	None
Millivolt	None
Milosz	None
Milow	rock
Mimanos	techno
Mimi Love  Kater Blau  Bachstelzen	None
Min	pop
Min King	None
Mind Against	techno
Mind Void LIVE	None
Mindsurfer	None
Mindtrick  NL	None
Mini Floor by Schwarzmatt	None
MiniGui98	None
Minidetail VD	None
MinidetailLausanne	None
Minilogue	techno
MinimalHouse Floor	None
Minimalfraktion	None
Minimalwasser	None
Minimetal	None
Minton  MinimalFraktion	None
Minus	emo
Mio Martini	rap
Mio Martini & Pepé	rap
Mira	classical
Mira b2b Chris Schwarzwälder	None
Mirco Caruso	hip hop
Mirco Esposito	None
Mirco Many dj	None
Mirco Mendosta	None
Miriati	None
Mirio Live	None
Mirk Oh	None
Mirko Di Florio	house music
Mirko Loko	techno
Mirko Loko aka Lazy fat People	None
Mirko Paoloni	rap
Miro Pajic	rap
Mirus & Hazy	rap
Mirweis Sangin	None
Mischkultur	None
Misi Berczelly	None
Mismo	None
Miss Golden G & Crotek	None
Miss Jools	techno
Miss Loira Louca  Freakouts	None
Miss Lollipop	None
Miss Peel	None
Miss Shine	rap
Missil	None
Missy Jay	house music
Mista Mista	trap
Mister Desolation	None
Mister Kriz	None
Mitika	None
Mitikal  Sinister	None
Mitsutek	techno
Mitsutek DJ	None
Miwon	ambient
Mix	pop
Miyagi	house music
Mlk  Dnh	None
Mo Kolours	abstract beats
MoTek	rock
Moa Club	None
Mobile 41 76 236 52 11	None
Mobilee	None
Mobilee  Zurich	None
Mobylette	None
Mode Of Motion	None
Modernity	None
Modestep	uk garage
Modulaw	None
Modulove	None
Moe & Zard	None
Moe&Zard	None
Mohammad	arab pop
Moinsen	None
Mokship	None
Mole	indiecoustica
Molly	punk
MonNsta	None
Monaberry	None
Monica Dias	None
Monica X  TOM VIBE	None
Monika Kruse	techno
Monkberry Moon Orchestra	None
Monkey Breeders	None
Monkey Coops	jungle
Monkey Maffia	techno
Monkey Safari	deep
Monkeys Beatz	None
Monoblock B	None
Monolix	techno
Monome	rap
Monome & Mitsutek	techno
Monoteque	None
Monotox	None
Moon B	post-disco
Moon Harbour	None
Moonbootica	house music
Moonraisers	rock
Moral	None
Morard	None
Morgan Button	None
Morgan Hammer	rap
Moritz & Max	rap
Moritz Praxmarer	None
Moritz Wettstein	None
Morris Malone	None
Mother Recordings  DE	None
Motherland Soundsystem	None
Motion Lab VJ Team	None
Motor City Drum Ensemble	techno
Mountain People	techno
Mountain People DJs	None
Mov Elan	None
Moving Shadow  UK	None
Moxie	techno
Mozart	classical
Mozzy	trap
Mr Mendel	None
Mr Pablo & guests	None
Mr Pigman  Tomorrow is Today  BIENNE	None
Mr Raoul K	techno
Mr Riddler	None
MrLucky	house music
MrOuch	None
MrParanoia	None
MrTimeless	None
Ms Hyde	None
Mucho Stylez	techno
Muck	redneck
Muck b2b Trigun	None
Mueller	broadway
Mukuna	None
Mule Musiq	None
Muller System	None
Multivitamins	None
Multivitamins  Argentina	None
Munich	classical
Murciano	house music
Murcof	ambient
Murcof & Philippe Petit	None
Muri	None
Murphy	rap
Music is Music	None
Musics Light	None
Mutlu	rap
Muzi	None
My My	emo
Mykki Blanco	strut
Mylky Way	None
NACA	None
NAKED PILOTZ LIVE	None
NATURKLANG JUNGLE	None
NDroo	None
NEIGHBOUR GUIZ	None
NESHA  MinimalFraktion	None
NESTOR KEA	None
NEW LOCATION Roter Korsar UFERSTRASSE 40	None
NHKKoyxen	None
NICO MASSA	None
NICOB	None
NICODISCO	None
NICOLAS DUVOISIN	rap
NIGHTSOMMAR	None
NIK FRANKENBER VS JOHN DEPARDY	None
NIRSO  electro tropical sonido tropico dj set  BR	None
NIXX	None
NL	house music
NOIR	hip hop
NOISE	None
NOK	hip hop
NORA DÜSTER	None
NORBERT DAVENPORT & MGJ	None
NOVALIMA  afroperuvian	None
NUKLEALL	None
NVRWRK	None
Nabin	None
Nabin & RamyRes	None
Naca	None
Nader	techno
Naikido	None
Nakadia	techno
Naked Tunes	None
Narod Niki	None
Naskal	None
Nast Le Chat	None
Nastia	None
Natan H	rap
Nate Young	uk garage
Nathanael	None
Natis Merio	None
Nebukat Nezar	None
Nebukat Nezar b2b Nicola Noir	None
Ned ONeal	None
Ned ONeal  MinimalFraktion	None
Neekee	None
Neet	techno
Neevo	None
Nekow	disco
Nekow Newfact Music	None
Neljane	None
Nelson De Jesus	None
Nelson Garcia	ecuadoria
Nemelka	None
Nenad J	None
Nenad J  Mickail  Senyc  Massive Jay	None
Nenad J & ToBe	None
Neneh Cherry & Rocketnumbernine	None
Neon Indian	electronic rock
Nervo	house music
Nessuno	None
Neu ab sofort jeweils um 0200 Uhr und 0315 Uhr fixe Abfahrtszeit im Jack Klub Bern Transfer in die BRONX Bar	None
Never	pop
Never Die	None
New Order	rock
New York Room DJ pitch	None
New York Room with Pitch	None
Newcom	None
Newfact Music	None
Ngoc Lan	vietnamese pop
NiKo	techno
Niall Redmond	hip hop
Nic Fanciulli	house music
Nici Faerber	hip hop
Nick Curly	house music
Nick Evans	None
Nick Frankenberg	None
Nick Larson	None
NickBee  Invisible recordings	None
Nickodemus	downtempo
Nicky Blackmarket	jump up
Nicky Blackmarket  dnb jump up  UK	None
Niclas	None
Nico Audiowave	None
Nico B	None
Nico Calado	None
Nico Massa	None
Nico Morano	rap
Nico Pusch	house music
Nico Sonne	dub
Nico Stojan	deep
Nico Wilde	None
Nicola Kazimir	rap
Nicola Koch	techno
Nicola Koch b2b Peter Szanto	None
Nicola Noir	None
Nicolas Bernier & Martin Messier	None
Nicolas Duvoisin	rap
Nicolas Haelg	house music
Nicolas Harver	None
Nicolas Jehouda	None
Nicolas Lutz	None
Nicolas Ruiz	rap
Nicole Moudaber	techno
Nicone	house music
Niconé	house music
Nicos Oldies	None
Night Talk	house music
Nik	rock
Nik Frankenberg	None
Nik OUS	None
Nik dj	None
Nikitch	indie jazz
Niko Schwind	deep
Nikola Kotevski	None
Nikos Voutsas	None
Nils Hoffmann	deep
Nils Twachtmann	rap
Nils Weimann	None
Nima Gorji	techno
Nina Kraviz	techno
Nkelo Live	None
No Mercy	hi-nrg
No list con drink chf 30   25	None
Noa	None
Noar	None
Nobee	hip hop
Nobodys Perfect Dj	None
Noir	hip hop
Noise	None
Nolé	None
Nomarel	None
Nonchalance	None
Nooncat	None
Norbert Möslang	lowercase
Norbertto	None
Nordstern	None
Nore En Pure	None
Noromal&Somi	rap
Norway	rock
Nos partenaires	None
Nouvelle Vague	electronic
Nozinja	None
Noé Weigl	None
Nu Audio Collective	None
Nu Disco ou encore Indie dance	None
NuAudio Collective	None
Nuemp	None
Nungan	None
NÄD MIKA	electronic rock
NØ TWINS	strut
Nôze	techno
OHANNA	None
OHM 10	None
OLIVER ADEN & LUIS CRUZ	None
OLIVER M & SMER	None
OLΔF	techno
OMAR PERRY  reggae  JAM	None
ONNO	techno
OP9  live feat Air Bacha	None
ORION & MOLE	None
OSSIE	uk garage
OWNO	None
OXA	None
Oase	None
Oben Am Berg	None
Obscene	None
Obscene  USA	None
Ockham  Neuchâtel	None
Offstream DJKollektiv	None
Ogoya Nengo & The Dodo Womens Group	None
Ohm 10 Biel	None
Okidor	None
Oktay	None
Oktay  XtraTamed  Lausanne	None
Olafson	techno
Olafson  MATTHEW SQUARE  Damian Deroma	None
Oliver & Buzz	None
Oliver Aden & Luis Cruz	None
Oliver Eich	techno
Oliver Huntemann	techno
Oliver K	hip hop
Oliver Koletzki	house music
Oliver Koletzki Stil vor Talent  DE	None
Oliver Schories	house music
Oliver Spiess	None
Oliver von Mentlen	None
Olivier Kolly	rap
Olström	None
Olöf Arnalds	icelandic pop
Omar Souleyman	arab pop
On the wheels of steel	None
Ondrej	techno
One Track	None
OneFootStep	techno
OneShotOchestra	None
Oneothrix Point Never	None
Onory	None
Onur Ãzer COCOON RECORDINGS	None
Onur Özer	techno
Onur Özer COCOON RECORDINGS	None
Onur Özman	deep
Onur Özur	None
Oo  Plak Records	None
Opossumini	None
Opuswerk	techno
Oracy	dub
Oram Modular	None
Oram Modular  12 Club  Genève	None
Oram Modular  12 Club Genève	None
Orange Dub	None
OrangeMusic  On The Top	None
OrangeMusic on the Top Winner	None
Orion & Mole	None
Orion&Mole	None
Orsett	None
Oscar C	rap
Oscar Der Winzige	None
Oscar Niczzo	None
Oscar Schubaq	techno
Oslo	orchestral
OstGut TonEdinburgh	None
Ostbahnhof	None
Ostkost Djkollektiv	None
Osunlade	house music
Otavio	None
Otezuka	house music
Otto Knows	house music
Overless	None
Overwerk	uk garage
Ovum Recordings  IRL	None
Oxensa	techno
Oxsa	None
Oy	hip hop
Ozan	turkish
PAIN JERK	industrial music
PAPS  MC  GE	None
PARADISE STAGE Jamie Jones	None
PASSEUR DE DISQUES	None
PAT KP	None
PATKP B2B ALEX ANDER	None
PBell	None
PBell & Mitsutek	None
PER CHI ARRIVA DA MILANO	None
PER CHI ARRIVA DA VARESE	None
PERIGOSO & MR PARANOIA	None
PHIL RISS & ALI C	None
PIERICK	None
PIERO P	None
PIXELPUNX	None
POR	nu-cumbia
POSITIVE FORCE	post-disco
PR3SNT	techno
PROFESSOR M	None
PROOF OF CONCEPT	None
PSYCHO WEAZEL	None
PSYCHOPHONIC	None
PSYCO WEAZEL	None
PTess	None
PTess dj	None
PURE TECH	None
PYTHIUS  Blackout	None
PaTee & Maria Blessing	None
PaTee & Pbeat	None
Pablo Bordon	None
Pablo Einzig	techno
Pablo Einzig & Samsara  Miteinander Musik	rap
Pablo Nouvelle	house music
Paco Osuna	techno
Pako S	house music
Pampa Records  Stockholm	None
Pan	trap
Panacea	None
Pandallougi	techno
Pantha Du Prince	electronic rock
Pao	techno
Paolo Di Mirò	None
Paolo Mentonelli	None
Paolo Montenelli	None
Para Club	None
Para One	electrofox
Parabois	None
Paris	uk garage
ParisFR	None
Parquet Recordings	None
Parris	uk garage
Partikel ZH	None
Party Killers	None
Pasa	None
Pascal FEOS	techno
Pascal Inc	None
Pascal Oliver	None
Pascal Tockar	None
Pascal Viscardi	rap
Pascal Wirz	None
Pasci	None
Paste 20	None
Pat Farrell	None
Pat K P	None
Pat KP	None
Pat Patrisha	None
Patlac	rap
Patric la Funk	None
Patrick Podage	groove room
Patrick Podage & Laura Wiesmann	rap
Patrique	None
Patrischa	house music
Patryk Molinari	house music
Paul Mad	techno
Paul Oakenfold	trance music
Paul Poulson	None
Paul Taylor	jazz
Paul Trouble Anderson	None
Paul Van Dyk	trance music
Paulo César	brazilian gospel
Paulo Oliveira	None
Pavel Plastikk	disco
Pavel Prince b2b Tiano Thomas	None
Pawas	techno
Pawlikowski	classic polish pop
Paws	rock
PazTeQ	None
Pazkal	techno
Pazul	house music
Peace Club	None
Peak	None
Pedro Andrade	None
Pedro Pereira	None
Peer Kusiv	house music
Pele	rap
Penetration Records	None
Pentagonik	None
Pepe Brogna	None
Pepé	mariachi
Per pagare meno	None
Percussion congas Edwin Sanz	None
Perigoso	None
Perigoso&MrParanoia  Freakouts Events	None
Perlon	None
Perlon  Amsterdam	None
Permanent Triangle	None
Perry Pierce	None
Perry Pierce & Doncivico	None
Pesoa & cie	None
Pete Lewis	None
Pete Tong	house music
Peter Hook	None
Peter Lavelle	None
Peter Wanden	None
Petre Inspirescu	None
Pezzner	techno
Phace  Neosignal	None
Phala b2b Lazy Mood	None
Phear	None
Phil	rock
Phil Cole	rap
Phil Kieran	techno
Phil Martins	None
Phil Riss & Ali c	None
Phil Weeks	house music
Phil Wild	None
Phil Wild b2b Agent C	None
Phil Wild b2b ZGroove	None
Phil Zviel	None
Philip Bader	techno
Philip Weibel	None
Philipp & Cole	rap
Philipp Weibel	None
Philippe	harpsichord
Philippe Carson interpreted by François Bonnet	None
Philippe Jeanneret	None
Philippe Vilfroy	None
Phillip Inäbnit	None
Phillip Pirreguer	None
Philosophy	None
Phobiq  Italy	None
Phobos	None
Phoibass	None
Phonokiller	None
Phree Music	None
Phurpa	None
Pi Why	None
Piero P	None
Pig&Dan	techno
Pikaya	hip hop
PillowTalk Concert &	None
Pingu	None
Pion Tek	None
Pipol	None
Piratenkind	None
Pit Mitchel	None
Pitch Black	psychill
Pitch Black  BS	None
Pixelpunx	None
Placid	house music
Plaid	techno
Planetary Assault Systems aka Luke Slater	None
Planktom	house music
Plassix	None
Platform	None
Play  Rex Club Paris	None
Play Lego Bitch	None
Playground	rock
Playlove81	None
Ploonz	None
Plyone	None
Pnom Pen  Oscil8	None
Poker Flat	None
Pokerphil	None
Pol Wise	None
Poljak	None
Polonium 8879	None
Polydance DJs aka Alan Bolumar & Androo	None
Polydance Djs aka Alan Bolumar & Androo	None
Pomassl	idm
Pomelo  Zurich	None
Pool party Stage	None
Porn Sword Tobacco	ambient
PortableBodycode	None
Possessedby	None
Post Scriptum	techno
PowLow	rap
Powder & Louder	techno
Pranava	None
Praslea	rap
Praslea arpiar	None
Presales STARTICKET	None
PressC	None
Presscode	None
Presscode  JurRecords	None
Presscode b2b Muck	None
Prestige weltweit	None
Prezzi	None
Primal Scream	rock
Primero	None
Princess P	None
Prins Thomas	hip hop
Private Fiction & Shake It DJTeam	None
Profilter	None
Profondo	None
Profound	None
Prog On Syndicate	None
Proof of Concept	None
Prop&Lean	None
Propz & Rowney	None
Prospect	None
Prosumer	techno
Psy Jes	None
PsyPiggy	None
PsyWala	None
Psycho Weazel	None
Psyk	dub
Psyorama	None
Public Possession	hip hop
Puma	house music
PumpNKing	None
Punks Jump Up	electronic rock
Pupkulies & Rebecca	house music
Pure Tech  Freakouts	None
Purp	None
PushAnimal	None
PÃ¤r Grindvik	dub
Pär Grindvik	dub
QBig  Elevation Music	None
QBig & Zenith B	None
Qbig & Zenith B	None
Qebeq	None
Quad Damage b2b Infenal Bastard	None
Quad Demage	None
QualityTime	None
Quartier Kruz	None
Quentin Harris et Sandy Rivera	None
Quesadillas Jr	None
Question & Exclamation Mark	None
Quintessential	None
Quinto Elemento	regional
Quitim	None
R3hab	house music
RBDdrive	None
REKLOK	None
REM	rock
REUNION	deep norteno
RICCARDO DE CICCO	None
RICO LOCO	None
RICO RAUSCH	None
RMEK	None
ROBYN CHAOS	None
ROCCA	None
ROMANO THE ALCHEMIST	None
ROMEO	bachata
ROOFTOP	None
ROYCE	merengue urbano
RP Boo	bass music
Rabré & Les Petits Chats	None
Radi & Keith	None
Radio Ghost Town  Basel	None
Radio Slave	techno
Radiorifle	None
Radro & Daniel Marrone	None
Raf Marchesini	rap
Rafeeq	None
Ragesh Nair	techno
Raijn Reed	None
Rainer Trüby	None
Raise	None
Ralf	None
Ralph Good	techno
Ramin	video game music
Ramin  Wuzztäzz	None
Ramon Lorenzo	None
Ramon vs Mercury Fall	None
Randall M	None
Ranno	None
Raphaello	None
Raphaël Belfiore	None
Rapu & Nekow	None
Rare Movement	hip hop
Raresh	None
Rauschkraft	None
Raven Scott	None
Raw & Mental House Music	rap
Raycito	None
Rayos de Sol	None
Razha	None
ReUP	None
ReYou	deep
Rearte	None
Reas	hip hop
Reber	house music
Reboot	techno
Recarey	None
Recondite	techno
Record Release Party	None
Red Jam	None
Reese Bau	None
Regenbogen	ostrock
Regional Liga	None
RegionalLiga	None
Rehbellen	None
Reiter & Hofer	rap
Rekah	None
Rekah  CBK	None
Reklok	None
Reklok live	None
Remady & ManuL	None
RemarK	None
Remute	techno
Renato Broccini	idm
Rene LaVice	drum and bass
Rene Lahar	None
Rennie Royma & Kare Kyl	None
Rennie Røyma & Kåre Kyl	None
Renè	norteno
Reset Robot	techno
Reto Ardour	techno
Rework	techno
Reznik  Berlin	None
Rhadoo arpiar	None
Rhadow	None
Rho	rap
Ricardo Santos	easy listening
Ricardo Villalobos	techno
Ricardo Villalobosu2028	None
Riccardo De Cicco	None
Rich vom Dorf	None
Richard Dorfmeister	downtempo
Richie Hawtin	techno
Richtaste	None
Richy Ahmed	house music
Ricky Morrison	house music
Rico Rausch	None
Rico Rausch b2b Der Dirigent	None
Rico Rausch b2b der Dirigent	None
Riddler	None
Rider	lift kit
Riki Ustrell	None
Rina Lou	None
Rino	rap
Rio Wolta	None
Riot School	None
Riot School & KRamba	rap
Riotboy b2b Third2Second	None
Ripperton b2b Deetron	None
Rize	bluegrass
Rize  ChocolaKe  Neuchâtel	None
Rize  Neuchâtel	None
Rizzoknor	None
Ro&Mat	None
Robbie Naish	None
Robby Naish	None
Robel	None
Robert Dietz	techno
Robert Henke Dust	None
Robert Nesta	None
Roberto De Carlo	hip hop
Robin & The Sidekick	rap
Robin Hirte	rap
Robin Martinelli	None
Robin Schulz	house music
Rocca	None
Rock Artisti	None
Rodney	country
Rodri	None
Rodrigo Rivera	rap
Rodrigo y Gabriela	flamenco
Rodriguez Jr	techno
Roger Müller	None
Roger Sanchez	house music
Roger the Doger	None
Rolf Imhof	None
Rolf Saxer	rap
Rollercone	world chill
Rollin John	None
Rollin John  Divercity  Zurich	None
Rom Beads	None
Roman	None
Roman Flügel	techno
Roman Klinger	None
Roman Klinger b2b Murciano	None
Romano 4the Groove  Salidamusic	None
Romano 4the groove  Urban Structure	None
Romano Corsini	None
Romano Rapeso	techno
Romanov	None
Romeo & Tarco & Lolo  Miau Studio	techno
Ron Costa	techno
Ron Shiller	None
Ron7	None
Ronald Grauer	None
Roon	hip hop
Rosalinda	None
Rossko	techno
Rosso&Capriice  Freakouts	None
Rostock	None
Rottun	None
Round Table Knights	hip hop
Roustam	techno
Royal Muzik RMS	None
Rozzo	techno
Ruede Hagelstein	techno
Rumlaut	None
Rumlaut  Musig mit Seel	None
Rumpeldisco	None
Rusconi	None
Russ Yallop	disco
Russell Haswell	mandible
Ruy Hankil	None
Ryan Crosson	techno
Ryan Hawkin	techno
Ræve	house music
Rødhåd	techno
Rüssel & Pfeffer	None
Rüssel & Pfeffer  WORLD PREMIER	None
S 233 direzione Malnate	None
S Rubinfeld Live Act & Vinyl only	None
SAAL	rap
SAD Visuals	None
SAMEDI 14 AVRIL	None
SANKEYS STAGE Davide Squillace	None
SATURDAY NIGHT	None
SAUL	regional
SAv	None
SCHNAUTZI  Argent Sale  CH	None
SCRATCHOPHONE ORCHESTRA  electroswing live  FR	None
SDANKE	None
SDANKE  SBAR  A TOUCH OF DEEP	None
SEBASTIAN KOS	None
SEE YOU	None
SENSE	None
SENSIFEEL	progressive psytrance
SENSITYVES	None
SENSUAL SQUEAK	None
SEVEN	house music
SHADED	techno
SHAKE & DANCE PARTY  Bronx Bar Ittigen mit den Chartstürmer FLAVA&STEVENSON	None
SHAKE YOUR BODY	None
SHE NIONIKA	None
SIGMASIX	None
SIMON STK	None
SIOPIS	techno
SIS	hip hop
SK Supreme  Zurich	None
SKANKIN SOCIETY  GE	None
SLOW BURGER	None
SMEGMA	german oi
SMorSillo	None
SNORK	None
SOLARIS	rock
SONIC SPECIES	trance music
SONO PIRATE UNIT CREW  SPU	None
SOSO	hip hop
SOULTOWN LOUNGE hosted by Audiotheque	None
SPHINX	None
SPIRAL HAND	None
SPY	drum and bass
ST LÔ	techno
STAGGA	uk garage
STAVA	None
STEFANO MTM b2b MIRKO GROOVE FREQUENCY	None
STEPHAN EICHER	rock
STRESSu2028	None
STUBETE ALLSTARS  elektrostubete  BE	None
SUBTIF 2	None
SUBURBAN MINDS Deepwave & Spiess nSchiffer  Basel	None
SUPANOVA	None
SUPERMAFIA	None
SUPERSMAX	None
SUPPORTED BY	None
SVKRE & SLODOWSK	None
SWINDLE	uk garage
SYNTHETIK CHAOS	None
Saalschutz	german indie
Sabb	techno
Saben Volkshaus	None
Sacha Robotti	techno
Saigo No Shudan	None
Saint Pauli	electronic rock
SaintHarare	None
Sajjanu	None
Sakro	hip hop
Sakrou200b	None
Salento	None
Salida Basel	None
Salida Zürich	None
Salidamusic	None
Salvatore Freda	house music
Salvatore Romeo	None
Salz & Pfeffer	None
Salzunpepper	None
Sam Bangura Half Baked	None
Sam Corso	None
Sam Divine	house music
Sam Hauser	None
Sam Jog	None
Sam K	rap
SamHauser	None
Samanta Fox	hip hop
Samantha	europop
Samedi 1010 Les 30 ans du Patron  Deep to Tek	None
Samedi 1710 Desperados Night	None
Samedi 24 Mind  Agape	None
Samedi 310 Vinyl Only	None
Samithy Sam	None
Sammy Dee	hip hop
Sampayo	None
Samy	german
Samy Demonti	None
SamyDemonti	None
San Marco	deep orchestral
San Proper	techno
Sandro Augello	None
Sandro De Marco	None
Sandro Falletta	techno
Sandro Falletta  Colludo Records	None
Sandro Falletta  Colludo rec  Salidamusic	None
Sandro Falletta & Dalibox	techno
Sandro Kuhne	None
Sandro Kühne	None
Sandro Vitalini	None
Sandro ZH	None
Sanity	melodic metalcore
Santiago Cortes	techno
Santoro&Blair	None
Sany Sanderson	None
Sari	musica para ninos
Sascha Braemer	house music
Sascha Braemer & Niconé	house music
Sascha Dive	techno
Sascha Stohler	None
Sascha Stohler & Arnstroem	None
Sascha Stohler & MNOVR	None
Sasha Carassi	house music
Sassy J	fake
Saturday 280315	None
Saty	None
Sauce Jacqson	None
Saul	regional
Sav	None
Sav Manganaro	None
Saved	anthem worship
Saved  Switzerland	None
Sayan Sobuth	rap
Schaffhausen	None
SchallLounge	None
Schallplatz	None
Sche Sche	hip hop
Schild K	None
Schlaasss	None
Schlachthofbronx	house music
Schlechter Einfluss	None
Schlepp Geist Live	None
Schmerol	None
Schmolke7	None
Schnautzi	None
Schnautzi  Argent Sale  GE	None
Schulz Neopren Records  Basel	None
Schwebekastenjunge	None
Schwedenparty	None
Scissor me Senseless	None
Scody live	None
Scot Project  Druck Records  All Major Festivals	None
Scott Kemp	techno
Scream	trap
Scum	horrorcore
Sdanke	None
Sdanke & Style	None
Seamus Haji	house music
Sean David	None
Seb Blake	disco
Seb Mara	None
Seb Zito	techno
Sebas O Verde	techno
Sebas O Verde vs Adam Winston	None
Sebastian Bosco	None
Sebastian K	None
Sebastian Wojkowski	None
Sebastien Leger	None
Sebb Bash	None
Second Florr	None
Second floor	deep chill
Secondfloor	None
Secret Island	None
Secret Island Nation Special Guest	None
Sedna & Dubhe	None
Seidensticker & Salour	None
Seiji  London	None
Sekoïa	None
Senefelder	None
Senking	techno
Senoo	anime score
Senor Zazou	None
Sensational	rock
Sensient	psytrance
Sentiment	None
Senyc	None
Senzen	None
Seph	techno
Septentrio & Askemwhy	None
Serafin	orchestral
Serge	chanson
Sergio Mauri	disco
Serkan Denizer	None
Serotonic	None
Servet Argin	None
Sese	None
Setaoc Mass	dub
Seteve	None
Seth Troxler	techno
Sety	techno
Seuil	techno
Sevenstyler	hip hop
Several Definitions	house music
Sezo	None
Sezo vs Artkill	None
Shabba	reggae
Shabba & Daitan	None
Shades	techno
Shadi Megalla	None
Shadi Megallaa	None
Shahira	None
Shaka	grupera
Shake It Maschine  Tomorrow is Today  BIENNE	None
Shanti Celeste	house music
Shawn Cloud	None
Shawnecy	techno
She Dj Nionika	None
She Nionika	None
Sheila She Loves You	None
Shibo Gonzales	None
Shimono	None
Shinedoe	techno
Shivan & Medo	None
Shlomi Aber	techno
Shogun Audio	None
Shovell	None
Shrubbn	hip hop
Shy Lajoie & Whisker	None
SiMareli	None
Sick Spud	None
SidJoe	None
SideJoe	None
Sieber	None
Siegair	None
Sierra Sam	None
Sigmasix	None
Signori Misteriosi	None
Sil B	None
Silencio  Genève	None
Silva & Loco	None
Silvano	None
Silver & Loco	None
Silvision	techno
Simbad	breakbeat
Simbad and Gilles Peterson	None
Simian Keiser	None
Simo	house music
Simoli Brothers	None
Simon Lemont	None
Simon Mike	None
Simon Slice	None
Simon T	house music
Simpig	uk garage
Simplistic	None
Simply Simon	None
Sinitrio	None
Sinjin Hawke	house music
Sinkane	None
Sinner DC	techno
Sinneswandel	None
Sins	None
Sins  WF  Genève	None
Sins  WFmusik	None
Sir Kay	None
Sirion Rec	None
Size	drum and bass
Skail Master M	techno
Skaos	ska
Skizofred	None
Sky Janssen & Ezikiel	None
Skywalker  GE	None
Slat 5	None
Sloven	techno
Slow To Speak La Main Mise  Paris	None
Slowhands	rap
Slowly Rico	None
Slowly Rico & Looney Tune	None
Smalltown Collective	house music
Smallville  US	None
Smart Monkeys	None
Smash FX	None
Smash TV	None
Smoking Room	None
Smoky Smoky	None
Soame	rap
Soame Arosa Electronica	None
Sobuth & Weiss	None
Sobuth&Weiss	None
Society	metal
Society Music Recordings	None
Soe	None
Soft b2b Mister Desolation	None
Softy	None
Soleyu	None
Soloduo	classical guitar
Soloduo  Wuzztäzz	None
Solomunu2028	None
Solothurn	None
Solvane	techno
Sometimes in arts	None
Somtek	disco
Somtek & Jools	rap
Sonica	rock
Sonidy	None
Sonja Moonear	None
Sonja Moonear  Perlon  Genève	None
Sonja Moonearu2028	None
Sonny Catanese	None
Sonny Catanese b2b Lucas Ramirez	None
Sonny Garcia	None
Sorgenkind Human revolution	None
Sory Kaba	None
Sossa	rap
Soukie & Windish	deep
Soul Clap	disco
Soulfinder	house music
Soulfooled  Geneva	None
Soulsonic	ambient
Soult	None
Sound Centric	techno
Soundcloud  httpssoundcloudcomfelixetchatmangolakedrive3	None
Soundcloud  pascalviscardi	None
Sous Sol	rap
Sous Sol & Dread J	rap
Sous Sol vs Martin Baur	None
Soussol	rap
Space Dimension Controller	bass music
Space K	None
SpaceK	rock
Spaghuzz	None
Spain	None
Spanks	None
Spartaque	techno
Special Guest	None
Special Night by Cadenza	None
Special Request	bass music
Special guest	None
Special guest Murat Kilic	None
Specialivery	techno
SpectraSoul	drum and bass
Spectron	None
Spektre	techno
Spice 52	None
SpinL	None
Spiral Hand	None
Spitfire	techno
Spitfire & Tigris	techno
Spitfire & Xcess	techno
Spleen United	danish
Sprout Haris	None
Squash	None
Squep	techno
StPaul	None
Stabio  Mendrisio	None
Stacey Pullen	techno
Stallo	None
Stallo & Etn	rap
Stanton Warriors	breakbeat
Starsand	None
Stasis Recordings	None
State of the Art	None
Stay	chamber pop
Steefunk	None
Steeve March	rap
Stefan Goldmann	techno
Stefan Nolic	None
Stefan Roigk	None
Stefano MTM b2b Grow Frequency	None
Stefano Pedretti	None
Stefano Pedretti  Commercial Room From 200 to 500	None
Stefano Ritteri	None
Steff La Cheffe	hip hop
Steiner	soundtrack
Stephan Bodzin	techno
Stephan Grieder	None
Stephen Beaupré	None
Stereo Express	house music
Steve Bug	techno
Steve Cole	smooth jazz
Steve Cole Neopren Records  Schallbox Records  Basel	None
Steve Massive	None
Steve Massive  TICINO	None
Steve Sanders	None
Steven Davis	None
Steven Engelmann	rap
Steven Sanchez  La ruche	None
Steven Stone	None
Steven Wallace	None
Stig	hip hop
Stiglitz & Bernstein	None
Stikmoo	None
Stil vor Talent	None
Stilbruch	None
Still Pitch	None
Stilspiel & BodenLos	None
Stimming	techno
Stipé	None
Stof Terrier	None
Stoga	None
Stoil  BE	None
Stonato	None
Stony Ahead & Soe	None
Stony Ahead & SortE	None
Storlon	None
Storm	environmental
Strahlemann & Töne	None
Strassenmajor	None
Strb	None
Strb b2b Nemelka	None
Strictly Rhythm  Zurich	None
Stride Night  be	None
Stripe	hardcore
Strobetech	None
Stuart Hawkins	None
Stubborn Pace	None
Studer TM & MC 45	None
Studio Barnhus  SE	None
Studio affairs	None
Style & UniT	None
Stéphane Attias	breakbeat
SuCré SaLé	None
Suara	anime
Subotagerecords  Density Radio X  Basel	None
Subsistenz	None
Substanz	None
Subversion officiel	None
Suddenly Neighbours	None
Sue Ann	None
Sueshi	None
Suffix Visuals	None
Suffix support	None
Suffix visuals	None
Sugarcraft	None
Suibheallan	None
Sundro  TheFamily  CH	None
Sunisit	None
Sunny Graves ES  Live	None
Supermafia Vjs	None
Supermario	None
Superpitcher	techno
Suport PBell	None
Support	None
Suspect One	None
Sutsche	None
Svart	black
Sven Dohse	hip hop
Sven Kerkhoff	techno
Sven Väth	techno
Sven Väthu2028	None
Svensk Fisk	None
Svenskj	None
Sw	None
Sweden	None
SweetLife	None
SwissInnovationsStage  LIMMATQUAI	None
Swit Honey	None
Sydney dry	None
Sylek	None
Symoh Sares	None
Syndrom	None
Synergee	None
Synonym Blau	None
Synthquest	None
Sysmic	None
Sysmik	None
System Of Survival	techno
Systematic	metal
SØS Gunver Ryberg	None
T Williams	None
TAG	breakbeat
TANJA LA CROIX	None
TBA	techno
TBC	None
TBC for 2014	None
TECHNICAL ITCH	drum and bass
TECHNO	None
TECHNO UNDERGROUND	None
TECHNOKEKS	None
TELEPATHIC VISION	None
TELEPHATIC ANIMALS	None
THE ANIMALS	rock
THE CAT	None
THE LEGISTS	None
THE SKATALITES	ska
THEK VOLZ	None
THEO	jazz
TIMESFLY	None
TINI	hip hop
TIT  CH	None
TIVE	house music
TMSV	uk garage
TNT	None
TOASTY	uk garage
TOM BLAKE	None
TOMMY LIEBHARDT	None
TONBOHRER	None
TOYANER	None
TRX b2b DJ Frontline b2b Mr Breakds  Project Riot	None
TRaumschmiere DJ	None
TWilliams	uk garage
TYRONE BNELSON	hip hop
Tableturner Duo	None
Tadeo Toberska	None
Tagedeep	None
TagtrÃ¤umerÂ² BlackFoxMusic  Schallbox Records  Berlin	None
Tagträumer² BlackFoxMusic  Schallbox Records  Berlin	None
Takcom	None
Take Me Home	None
Taktlos	german street punk
Tale Of Us	techno
Talentfrei Bern	None
Talentfrei Label	None
Talentfrei Official	None
Talentfrei Records	None
Talib	hip hop
Talin	None
Tambien	house music
Tania Vulcano	house music
Tanua	techno
Tanua Neopren Records  Mexico	None
TanzTanz	techno
Tanzkarussell	None
Tanzmuster	None
Tanzstunde	None
Tanzsubstanz	None
Tarco	None
Tardis Labelnight	None
Tarik	rap
Tarpon	None
Tastatur	None
Tatum Rush	None
Tba	techno
Techno	None
Techno  Makhno	None
Techno Venus  Lausanne	None
TechnoTech House Floor	None
Techrifice	None
Tecktonik	None
Tedi B2B Bigraf	None
Teenage Mutants	house music
Teki Latex	techno
Teki Latex & DJ Orgasmic	uk garage
Teki Tekua	None
Teklicit Marsatek  FR	None
Telepathie & Pendler	None
Telepathie & pendler	None
Telepathie&Pendler	None
Ten Walls	house music
Teo Ermotti	None
Teo Fionom	None
Terell Gucci Winchester	None
Terranova	downtempo
Terri B	None
Terrorist	None
Terzini Bros	None
Tesdorpf	None
Tevo Howard	house music
Thalstroem	house music
The Advent	techno
The Alchemist	hip hop
The Animen	None
The Architects	None
The Bad Rabbit	None
The Bassment	None
The Bassment  PleasureLAB	None
The Black Madonna	house music
The Bontempi DJs	None
The Chosen Two	house music
The Chronics	None
The Club	None
The Cruzaders	rap
The DIFFIKULT Crew	None
The DJ	trap
The DJ Milieu Mauri	None
The Disciplines	rock
The Dj Marathon	None
The Essentials	None
The Frankenberg Show	None
The Gladiators	reggae
The Groovebrothers	None
The Haxan Cloak	drone
The Hiiters	None
The Jezabels	rock
The Kooks	pop
The Legendary Lightness	None
The M & B Experiment	None
The M&B Experiment	None
The Martinez Brothers	techno
The Mind Opener	None
The Mole	techno
The MorningSounds	None
The Name Game	None
The National Fanfare of Kadebostany	None
The Necks	dark jazz
The Panacea	drum and bass
The Pirates	None
The Rapy	None
The Robot Scientists	disco
The Son of Dog	None
The Space Lady	hauntology
The Spirit Bar	None
The Spirit of October Week  1	None
The Stereo Youth	None
The Tight tINI Groove And Handsome Rumpelfunk	None
The Titties  Das Hutwerk	None
The Toxic Avenger	house music
The Toyboys	None
The Trilogy Tapes	None
The Zimbabwebird	None
Theo Pas Riche	None
Therapy Session	None
Theydream	None
Thom Mayr	None
Thom Nagy	None
Thomas AS	None
Thomas Jack	house music
Thomas Mayr	None
Thomas Schumacher	techno
Thomas T	rap
Thomas Zopf	None
Thorsten Hammer	techno
Thris Tian	hip hop
Throne	None
Thursday 260315	None
Tiano Thomas b2b Pavel Prince	None
Tief	None
TiefenRausch	euroska
TiefenRausch  MinimalFraktion	None
Tiefschwarz	techno
Tiefschwarz Souvenir  Basti	None
Tigris & Neustadtneurothiker	None
TillTape	None
Tillup	None
Tim Davidson	None
Tim Exile	hardcore
Tim Green	techno
Tim Grothe	techno
Tim Knopf	None
Timnah Sommerfeldt	None
Timnah Sommerfeldt & Cephei	rap
Timo Maas	breakbeat
Timoteo	sertanejo tradicional
Timoteo LET	None
Timoteo Les Enfants Terribles	None
Tini B	None
Titbit	None
Tito Torres	None
Tive	house music
To Be	None
ToBe	None
Toast Terry	None
Toasty	uk garage
Tobas	None
Tobi Hoeppner	None
Tobi Neumann	house music
Tobi Neumann  cocoonnet  Berlin	None
Tobias Becker	None
Tobias Kramer	None
Tobias Oliver	None
Tobias Thomas	hip hop
Todd Bodine	hip hop
Todd Terry	house music
Toddler B2B SAM	None
Toilet Acoustic	None
Tokoloten	None
Tom Alemanno	rap
Tom Alemanno b2b Divalvi	None
Tom Blake	None
Tom Brunner	None
Tom Hades	techno
Tom Novy	disco
Tom Sun	None
Tom The Godfather Brunner	None
Tom Vibe	None
Tom Wineman	None
Tombass	None
Tomm Aso	house music
Tommy Four Seven	schranz
Tommy Vee	rap
Tomorrow is Today  GE	None
Tompaul	None
Tomy Gips	None
TonTon	None
Tonfa	None
Tonfa & Dan B	None
Tonga	None
Toni Tanzbei	None
Tonic	rock
Tonic & Tremendo	house music
Tonwerk feat Bagheera	None
Tony Garcias  Borderline	None
Tony Lionni  Berlin	None
Tony Sylvester	None
TonyP	None
Too Late Productions	None
Tool & DieRecords	None
Toolroom	None
Toots & The Maytals	reggae
Toppaz  Berlin	None
Torn	None
Total Science	drum and bass
Totally Enormous Extinct Dinosaurs	electronic rock
Toutes les infos sur wwwmambobarclubch	None
Township Rebellion	hip hop
Toxicangel	None
ToxinOhm	None
ToyO	rock
Traffic Jammers	None
Trakt 10 E Floor IV	None
Trakt 9a	None
Trakt 9a Floor III	None
Trakt9a	None
TranceStage  SWISS LIFE	None
Traumer	None
Trauminic	None
Traumtief	None
Treffpunkt Parkplatz Schützenmatte	None
Tremendo	house music
Trevor Jackson	deep pop r&b
Tricky	downtempo
Tricykl	None
Trigun	None
Trinidad	rap
Trip In	None
Tristan Bohn	None
Tristen	house music
Tropic Of Cancer	nu gaze
Tropical Continent Soundsystem	None
Tropical Continent SoundsystemZH	None
Tropics	indie
Troste	None
Trotzkopf	techno
Troy Pierce  Minus  Detroit USA	None
Troy Pierceu200b	None
Truce	None
Truci  Relogical Rec & Define Rec  ITA	None
Truedat & Alæ	None
Truncate	techno
Tube & Berger	deep
Tuccillo	techno
Tucillo	None
Tunay Can	None
Tuncay Celik	hip hop
Tunne	None
TurKo	hip hop
Turno  Low down deep  UK	None
Twerking Class Heroes	None
Twinsmatic	rap
Two Loops Low Tek	None
Two loops low tek	None
Tyie  237 Family  Lausanne	None
Tyrone B Nelson	hip hop
UFORIK	None
UFREQS	None
UG Bülach ZH	None
UK	zapstep
UMUT	None
UP HIGH COLLECTIVE	None
URSL	None
USA	None
Ubik	idm
Ueno Masaaki	None
Uffie & Feadz	rap
Ugly Kids	None
Ulrich Schnauss	electronic
Umami	house music
Umut Yasin	None
Un JeNeSaisQuoi  F	None
Und weitere TopDJs wie Fabiano	None
UnderStanding	None
Undercatt  Diynamic Music	None
Underground Chronicles	None
Underground Stage	None
Underworld	electronic rock
Universal Dog	None
Universalfilter	None
Uone	house music
UponYou	None
Urban Structure	None
Uriel	None
Urla Ender	None
Ursprung	None
Uschi & Hans	None
Uto Karem	techno
V Kawumski	None
VACUUM  jump up  Lux	None
VALENTINO & HENRYSURE	None
VANDAL  Kaotik Records  FR	None
VD	None
VENDREDI 13 AVRIL	None
VERY SPECIAL GUEST	None
VETO	danish
VILLABOSSO	hip hop
VISHUDHA	None
VITO	techno
VJ AbsUrda	None
VJ La Vue VJ Collective	None
VJ LeinaD	None
VJ Viggo	None
VJing by Maak	None
VJs	None
VLT Mannequine	None
VOMIR	noise
Vacca Ft G Nano	None
Vacintosh	None
Vacuum  Biological beats  LUX	None
Vadims Soundcatcher Tour feat DJ Vadim	None
Vaghe Stelle	uk garage
Valentin Boesch	None
Valentin Bösch & Jan Meier  The Company	None
Valentino	hip hop
Valentino Mora	None
Valerio Raponi	house music
Valeron	hip hop
Valico autostradale di ChiassoBrogeda	None
Valo	None
Vanita	rap
Vanita b2b LowTales	None
Vario Volinski	house music
Varoslav	hip hop
Vatsgoed	None
Vector Reality Neopren Records  Basel	None
Vegetative Wachstumsphase	None
Veli	trap
Velvet Two Stripes	None
Vendredi 1610 Sound Mechanc	None
Vendredi 210 EHL Sound presents House  Techno Night Vol3	None
Vendredi 23  Deep in LausAngeles  Burning Man Decompression  Space K	None
Vendredi 910 Black Beats	None
Venedig	None
Venti	None
Venus	None
Vera	deep australian indie
Verliebt in Musik	None
Via Angelo Maspoli	None
Vicino al Casino Admiral e Fox Town	None
Vicky Devine	None
Victoria Engel	techno
Vielfarbig	None
Viens taper du pied sur des rythmes électro et régaler tes oreilles de sonorités nouvelles Entre techno et house	None
Viking Music	None
Viktor Marek	None
Villa Bosso	hip hop
Vince	christmas
Vince & DJ Mile	rap
Vincent Lemieux	None
Vinyl Speed Adjust	rap
Vinyl Team	None
Vinz Da Groove	None
Viper Recordings	None
Virgil Enzinger	schranz
Virus	uk garage
VisionE	None
Visual Sensation By Van Nutt	None
Visuals	None
Visuals by Gregel Oirom	None
Visuals by Spir	None
Visuals by VJ LUPIN & GERTRUDE TUNING  FR & CH	None
Visuals von Kollektiv Packungsbeilage	None
Visuels Gertrude Tuning  Argent Sale  CH	None
Visuels Gertrude Tuning  Argent Sale  GE	None
Visâge Pale	None
Vitronic	None
Viuels & support  Tenuta	None
Viva Music	None
Vkee Madison	None
Vlad	None
Vlnolam Kawumski	None
Volkan Ocak	None
Volkan Ocak & Claudio  Christoph & Oliver van den Miescher  Dario Todorovic	None
Volta	neo-psychedelic
Voltage	uk garage
Voltmar	None
VonD	None
Vonderfluh	None
Voodoohop	None
Vrank Pauer	None
Vril	dub
W4LLE	None
WAEV	None
WAREHOUSE	None
WENOTME	None
WENOTME  Boris Why & Nico	None
WF	None
WHITY	None
WILDLIFE	electroacoustic music
WINTERGARTEN	None
WTBRK SOUND SYSTEM  Live	None
WTF	None
WYCLEF JEAN	hip hop
Waev	None
Walk Off the Earth	viral pop
Walter Albini	None
Walter June	None
Wandler	techno
Wankala	rap
Wankelmut	house music
Warm up	None
Wasabidelux	None
Wasabideluxe	None
Washerman	disco
Wasulu Selecta	None
Watergate	bubble trance
Watergate  Switzerland	None
Watergate Records	None
Waterkant Souvenirs	None
Waveform	ambient
Wax de Molf	None
We Invented Paris	rock
We came in peace	None
Weith	None
Welcome  FR	None
West D	techno
Whim	techno
White  Berlin	None
White Wall LIVE	None
Wicked Wiggler and later Fabien	None
Wicked Wilma	None
Wien	None
Wiesage	None
Wiggaz	None
Wighnomy Brothers	techno
Wild & Surf	None
Wild Belle	pop
Wild Surf	None
Willi P	None
William White & the Emergency	None
William Wood	None
Willie Burns	house music
Willow	pop
Wirrwarr	rock
Wobham LIVE	None
Wolf Eyes	experimental
World Wide Connects  GE	None
Wunderbaum	None
Wunschkinder	None
Wuzz TazZ Boys	None
Wuzz Täzz Boys	None
WuzzTazzClan	None
WuzzTäzZ Boys	None
X BADKLAAT	None
X DUBDAVE	None
X MRPIGMAN	None
XCess & Spitfire	None
XCut	None
XTAJ	None
Xander Valley	None
Xavier Quérel	None
Xetal	None
Xose	None
YANN LAMBIEL	None
YASMEEN DE SOUZA	None
YM	vocaloid
YONI BANKS & YAN KA	None
Yan & Dan	rap
Yan Jun	rock
Yann Kulovsky	None
Yann Ou	None
Yannik Cserhati	None
Yapacc	techno
Yarah Bravo	None
Yare	None
Yasunao Tone	lowercase
Yaya	techno
Yin & Klang	None
Yoav	None
Yodelice	chanson
YokoO	house music
Yoni Banks	None
Yoni Banks & Yan Ka	None
Yosko	None
Youcef   BP   Paris	None
Yougene	None
Youn Caro	techno
Yuen Chee Wai	None
Yuksek	electronic rock
Yvan Genkins	techno
Yves Helbling	None
YÃ nkov aka yAn	None
Yàn	None
Yànkov aka yAn	None
ZANO P	None
ZGroove	None
ZH	None
ZITTO & SPLENDINI	None
ZanoP	None
ZanoP b2b She Nionika	None
Zebra Katz	indie r&b
Zecher	rap
Zecher  Subotage Records  RadioX  Basel	None
Zedd	pop
Zenit  Faust  Raphallus	None
Zenker Brothers	None
Zeno	christian relaxative
Zepherin Saint	house music
ZerO	downtempo
Zero	downtempo
Zest	techno
Zgroove	None
Zh	None
Ziggi	dancehall
Ziiva aka Lukii	None
Zimmerpop	None
Zip	house music
Zodiak	None
Zombidou	None
Zomboy	uk garage
Zoo Underground floor	None
Zora Jones	fluxwork
Zukunft	None
Zukunft Rec	None
Zurich	None
Zuzarte La Main Mise  Lausanne	None
Zwei mit Stil	None
Zähler & Nenner	None
Zähler &Nenner	None
ZüriStage  SÄCHSILÜÜTENWIESE	None
Zürich	None
a 300 mt uscita autostrada	None
adlib	techno
aerophobica	None
analsticks	None
and Guest	None
and cosongwriter for Led Zeppelin	None
and many more	None
and more	deep freestyle
anima	rock
are you electrified	None
areage	rap
arnstroem & uglyfunker	None
au Zoo du Mad à Lausanne	None
audiomiditweaker	None
avant denchainer sur lelectro	None
b2b	None
batteur de la formation GROOVTANK	None
beatbrothers	None
beatis	None
berneoptimistallstarz	None
boogie et soulfoodmusic Un large spectre que les 4 jeunes artistes abordent avec passion	None
bprodukt	None
brazilian girls	downtempo
buraq	None
but certainly in life and especially in the art of sound the eye and the ear are equal partners Talking about the young and talented KlangKuenstler	None
bwhat	None
cette semaine	None
conflict area	None
cristina souvenir	None
daniele zaccone	None
danielson & norbertto	None
dans cette recherche du son juste qui simpose avec évidence Nétant pas à leur coup dessai et sétant produits dans la plupart des clubs à Genève	None
darkstep	None
das Batz	None
das Schiff	None
de la Deep House à la Techno Mais audelà des mots le meilleurs moyen de le découvrir est de venir lécouter	None
deep bros	None
der Dirigent	None
disco	emo
dj Khalab	None
djs tiniberneoptimist	None
dolores	bolero
drum and bass	None
duble	rock
edison cabrino	None
electro	tracestep
electro live  PERU	None
electroclash	None
electrodudes	None
electrostep floor saal	None
elex morano & sandro s	None
elias3O8	None
elm	video game music
entropi Visuals	None
era	None
era & tweet	None
eskimo & Lila Hart	None
event canceled	None
exclusive at Street Parade	None
fabien	None
fatti mettere in lista	None
follow me	None
girl	mashup
greets Baur & Cherry	None
hosted by Thomas Brunner	None
hosted by Tony Nwachukwu	None
house	None
httpsoundcloudcommrpigman	None
httpssoundcloudcomdremusicgva	None
httpssoundcloudcomjeanclef	None
httpswwwfacebookcombenlarsenffrfrefts	None
idle	comic
ieva	None
iiiü	None
ivan alvarez	None
jay veedee	None
jliGht	None
joey	rap
jurrecords	None
k1k3	None
keyboardist	None
lOurs	None
la deep	None
la luciole	None
la tekhouse Fondateur en 2010 du crew BOOM FACTORY	None
le Bypass et pour la Lake Parade	None
le digital rencontre Le vinyl pour un mélange explosif	None
liebedetail	None
limbus revolution	None
liquid	healing
live	christian christmas
live Buvette	None
live FELL	None
live ZACHOV	None
liveacts tba	None
m50	None
mOOving	None
magdesign	None
manuheme & Litch aka BIFASICO  Guest	None
many more	None
marco k	None
mas Ricardo	None
mas ricardo	None
mastra	deep
mc soze	None
miau musik	None
mimetic	industrial music
mimetic & Sigmasix	rap
minimal	None
minitek	None
mobilee records	None
monsieur juste	None
more TBA	None
more TBA soon	None
more tba	None
moving shadow  UK	None
nemoy	None
neurofunk floor Foyer	None
newcom	None
nika	spanish pop
noch nicht bestätigt Les Yeux sans Visage	None
nopi aka Alberto Pino	None
novamute	None
nthng	None
nudevinyl vinyl	None
nuit 1	None
nuit 2	None
olan	ambient
parkcity	None
peel	chamber psych
perlon  CHILI	None
peter wanden	None
quark	None
qui vagabondent entre microhouse	None
reverse	emo
riQ&liGht  ChocolaKe  Neuchâtel	None
riQ&liGht  Neuchâtel	None
sCs	None
screamo floor Foyer	None
senyc	None
shaka	banda
soleyu	None
ssenqiR	None
stefano m	None
strictly on vinyl	None
suffixtv	None
sydney	None
t	hip hop
tINI	hip hop
tant est grand le soin quils apportent à leurs sélections	None
tanzsubstanz	None
tba	techno
tech house floor Saal	None
techno machine	None
therapy session	None
tickle out our endorphins and  in the best case  be a joyful escapism from the hectic everyday life Welcome to the world of KlangKuenstler	None
tom tek	None
tomkay42	None
trackmaster69	techno
tropical bass	None
tsacK	rap
tsacK ET FIL  Volt bar  CH	None
tsuba	None
tsunami	punk
tt	escape room
turntable babes	None
tweet	r&b
u2028	None
undef	None
uscita Mendrisio	None
very special Guest DJ	None
violinist Elsa	None
visuel  ABSÜRDA vjing	None
vocalist singer Monika Kiss	None
von Allmen	None
von Allmen b2b DGRZ	None
wAFF	disco
wankäla	None
warm up	None
what counts is solely to enjoy here and now Music should preserve our feelings	None
wwwthecratesch	None
yAn	techno
yoni banks	None
you have to add another organ of perception the heart Music without emotion is useless Emotional music reminds us that we shouldnt think about yesterday or tomorrow	None
zenon rec	None
zouk bass dj set  PERU	None
zuckerstück	None
zweikommasieben	None
Âme	None
Âme live	None
à la Majestic Night Montreux ainsi quau Studio du Montreux Jazz Festival quils se sont distingués	None
évoluant dans la Techno	None
ЈєϨтЇϲϨ	None
МирАӏӏ Яєsidents	None
