	[]
&	['pop', 'pop', 'pop']
& more TBA	[]
0100  End KombÃ© & Mafou	[]
0100  End Kombé & Mafou	[]
0130  0330 Agonis	[]
0330  End Jeff Mills	[]
2 FLOORS	[]
2300  0130 Jamie Shar	[]
2TAKT	[]
2nd Floor	[]
3 LIVE Bands	[]
3024WASHINGTON	[]
35plis	[]
808 State	['house music', 'breakbeat', 'breakbeat', 'house music', 'techno', 'electronic', 'hardcore', 'house music', 'intelligent dance music', 'madchester', 'techno', 'house music', 'breakbeat', 'breakbeat', 'house music', 'techno', 'electronic', 'hardcore', 'house music', 'intelligent dance music', 'madchester', 'techno', 'house music', 'breakbeat', 'breakbeat', 'house music', 'techno', 'electronic', 'hardcore', 'house music', 'intelligent dance music', 'madchester', 'techno']
A	['trap', 'rap', 'trap', 'trap', 'rap', 'trap', 'trap', 'rap', 'trap']
A LiveDJJam reinterpreting some of Dumb Units best pieces from the last 10 years	[]
A Made Up Sound aka 2562	[]
A&F	[]
ADRIANO live bern	[]
AFTER 5PM  OPEN END	[]
AFTER HOUR bis 1200	[]
AKA AKA	['house music', 'hip hop', 'techno']
AKN & DITEK	[]
ALAIN ROY & Dirty Larry	[]
ALAN LECTOR	[]
ALEXI	['acoustic pop', 'pop', 'folk christmas', 'folk', 'christmas', 'indie', 'indie', 'neo mellow', 'pop', 'singer-songwriter', 'stomp and holler', 'acoustic pop', 'pop', 'folk christmas', 'folk', 'christmas', 'indie', 'indie', 'neo mellow', 'pop', 'singer-songwriter', 'stomp and holler', 'acoustic pop', 'pop', 'folk christmas', 'folk', 'christmas', 'indie', 'indie', 'neo mellow', 'pop', 'singer-songwriter', 'stomp and holler']
ALLP ch wallis	[]
ANDRI LIVE	[]
ANDRI Live  Cityfox  Highgrade ZÃ¼rich	[]
ANDRI Live  Cityfox  Highgrade Zürich	[]
ANNA ULLRICH	[]
ASSH	[]
ASVF b2b Bodom	[]
AT	['emo', 'pop punk', 'vegas indie', 'emo', 'pop punk', 'vegas indie', 'emo', 'pop punk', 'vegas indie']
ATOMITA	[]
AUSTRIA	[]
Aaron Khaleian	[]
Abdel Hady	['rap', 'disco']
Abel	['deep indie r&b', 'indie', 'deep indie r&b', 'indie', 'deep indie r&b', 'indie']
Abnormal Boyz	[]
Absolutive	[]
Abstrhytmik	[]
Adam Beyer	['techno', 'house music', 'microhouse', 'minimal', 'techno', 'schranz', 'house music', 'techno', 'house music', 'techno', 'techno', 'techno', 'house music', 'microhouse', 'minimal', 'techno', 'schranz', 'house music', 'techno', 'techno', 'house music', 'microhouse', 'minimal', 'techno', 'schranz', 'house music', 'techno']
Adana Twins	['disco', 'deep', 'deep', 'groove room', 'house music', 'house music', 'hip hop', 'rap', 'hip hop', 'techno', 'techno', 'disco', 'disco', 'deep', 'deep', 'groove room', 'house music', 'disco', 'deep', 'deep', 'groove room', 'house music']
Adrian Martin	['disco']
Adrian Martin b2b Albi	[]
Adriano	['disco', 'rap']
Adriano Mirabile	['disco', 'dub', 'house music', 'hip hop', 'rap']
Adriatique	['disco', 'deep', 'deep', 'house music', 'microhouse', 'techno', 'techno', 'house music', 'hip hop', 'rap', 'hip hop', 'techno', 'techno', 'disco', 'disco', 'deep', 'deep', 'house music', 'microhouse', 'techno', 'techno', 'house music', 'disco', 'deep', 'deep', 'house music', 'microhouse', 'techno', 'techno', 'house music']
Adva & Purpurea	[]
Affani	['rap', 'disco']
After Grauer	[]
After Grauer & Phil ZViel	[]
Agaric	['techno', 'disco', 'techno', 'rock', 'house music', 'techno', 'rap', 'techno', 'techno']
Agonis	[]
Ajele	[]
Al Tourettes	['techno', 'dub', 'uk garage', 'techno', 'hip hop', 'hip hop']
Alain Szerdahelyi	[]
Albee	[]
Albi	[]
Alci	['bolero', 'classic colombian pop', 'cumbia', 'merengue', 'salsa', 'vallenato', 'rap', 'techno', 'techno', 'disco', 'bolero', 'classic colombian pop', 'cumbia', 'merengue', 'salsa', 'vallenato', 'bolero', 'classic colombian pop', 'cumbia', 'merengue', 'salsa', 'vallenato']
Alec Trusk	['disco']
Alek X	['techno', 'techno', 'hip hop']
Ales	[]
Alex Celler	['techno', 'techno', 'house music', 'techno', 'techno', 'techno']
Alex Dallas	[]
Alex Flatner	['techno', 'house music', 'techno', 'techno']
Alex Kostik Teknologik Rec	[]
Alex Neri	['chill lounge', 'house music', 'chill lounge', 'chill lounge']
Alex T Rauch	[]
Alexandre Navarro	['abstract', 'abstract', 'abstract']
Alladin K	[]
Alphatronic live	[]
Amaro	['reggaeton', 'reggaeton', 'reggaeton', 'reggaeton', 'reggaeton', 'reggaeton']
Ambivalent	['techno', 'house music', 'techno', 'techno', 'techno', 'house music', 'techno', 'house music']
Amelie	['disco', 'rap']
Amiant	[]
Amine Edge & DANCE	['rap', 'house music', 'house music', 'disco']
AmsterdamNL	[]
An den Decks	[]
AnGy KoRe	['techno', 'minimal', 'hip hop', 'techno', 'hardstyle', 'techno', 'disco', 'techno', 'minimal', 'techno', 'minimal']
Anatol  cosili  P45  zurich  CH	[]
And Hazel	[]
AndHazel	[]
Andaloop	['rap', 'disco']
Andhim	['disco', 'deep', 'deep', 'house music', 'techno', 'techno', 'house music', 'house music', 'rap', 'techno', 'disco', 'disco', 'deep', 'deep', 'house music', 'techno', 'techno', 'house music', 'house music', 'disco', 'deep', 'deep', 'house music', 'techno', 'techno', 'house music', 'house music']
Andre	['rap', 'techno', 'house music', 'techno', 'disco']
Andre Jimenez	[]
Andrea Oliva	['disco', 'house music', 'techno', 'techno', 'house music', 'rap', 'hip hop', 'disco', 'disco', 'house music', 'techno', 'techno', 'house music', 'disco', 'house music', 'techno', 'techno', 'house music']
Andreas Ramos	['disco']
Andri	['house music', 'deep', 'ambient', 'rock', 'rap', 'techno', 'techno', 'disco', 'house music', 'deep', 'house music', 'deep']
Android muziq	[]
AndrÃ©s Marcos	[]
André Lodemann	['techno', 'techno', 'techno']
Andrés Marcos	[]
Andy Catana	['house music', 'disco', 'dub', 'techno', 'house music', 'techno', 'rap']
Andy Dee	['hardcore', 'hardcore', 'hardcore']
Andy Katz	[]
Andy Purden	[]
Anek	['house music', 'house music']
Angelica Fravi	[]
Angemi	['deep big room', 'deep big room', 'deep big room']
Angy Dee	[]
Animal Trainer	['house music', 'deep', 'house music', 'deep', 'house music', 'deep']
Anja Schneider  mobilee  berlin  D	[]
Anthik	['rap', 'house music', 'house music', 'disco']
Anthony Naples	['bass music', 'house music', 'house music', 'fluxwork', 'house music', 'rap', 'dub', 'disco', 'bass music', 'house music', 'house music', 'fluxwork', 'house music', 'bass music', 'house music', 'house music', 'fluxwork', 'house music']
Apollonia	[]
Archie Hamilton	['techno', 'house music', 'techno']
Ariol & Pawlikowski	[]
Arnika	[]
Aromamusic	[]
Art & Weise	[]
Asic	[]
Association Specimen EventBookingLabel	[]
Aston Martinez	[]
Atomita	[]
Audino	[]
Audiofly	['disco', 'deep', 'deep', 'house music', 'microhouse', 'techno', 'techno', 'house music', 'disco', 'hip hop', 'house music', 'techno', 'rap', 'disco', 'deep', 'deep', 'house music', 'microhouse', 'techno', 'techno', 'house music', 'disco', 'deep', 'deep', 'house music', 'microhouse', 'techno', 'techno', 'house music']
Audiologism	[]
Audion	['techno', 'uk garage', 'house music', 'techno', 'techno']
Audionatica  Gon Records zh	[]
Audionatica Gon Records	[]
Audiovisual techno set	[]
Aula magna	[]
Autonome Essenz	[]
Ayhasca Ernesto	[]
Azabeats	['hip hop', 'hip hop', 'hip hop']
BANOPROD	[]
BAROZ  elektrostubete	[]
BBC Radio1	[]
BE	['rock', 'anti-folk', 'comic', 'rock', 'rock', 'indie christmas', 'permanent wave', 'christmas', 'pop', 'zolo', 'rock', 'anti-folk', 'comic', 'rock', 'rock', 'indie christmas', 'permanent wave', 'christmas', 'pop', 'zolo', 'rock', 'anti-folk', 'comic', 'rock', 'rock', 'indie christmas', 'permanent wave', 'christmas', 'pop', 'zolo']
BE  Finefood Records	[]
BE  Legend Club  Ohm10  djanthonyvegacom 1030  1200 Play Time	[]
BE  Ohm10  Tunnelenergych	[]
BOMB DISPOSAL SQUAD RITCHIE PITCH	[]
BOOGIE JACK & NAT	[]
BORN  BassOnRepeatNetwork	[]
BPitch  UK	[]
BROUQADE	[]
BS	[]
BUQS	[]
Baalsaal	[]
Bach	['baroque', 'classical', 'classical', 'romantic', 'baroque', 'classical', 'classical', 'romantic', 'baroque', 'classical', 'classical', 'romantic']
Back2Back Mr Jonk and DJ Schield	[]
Backspin Boys	[]
Bakermat	['house music', 'deep', 'edm', 'house music', 'techno', 'house music', 'house music', 'house music', 'deep', 'edm', 'house music', 'techno', 'house music', 'house music', 'deep', 'edm', 'house music', 'techno', 'house music']
Balance Alliance	[]
Bambounou	['bass music', 'techno', 'bass music', 'techno', 'bass music', 'techno']
Bang Goes	[]
Bar25	[]
Barcelona	['acoustic pop', 'dreamo', 'acoustic pop', 'dreamo', 'acoustic pop', 'dreamo']
Bardo	['dream pop', 'drone', 'experimental', 'experimental', 'freak folk', 'japanese psychedelic', 'rock', 'rock', 'psychedelic', 'new weird america', 'no wave', 'pop', 'noise', 'nu gaze', 'rock', 'shoegaze', 'slow core', 'electronic rock', 'dream pop', 'drone', 'experimental', 'experimental', 'freak folk', 'japanese psychedelic', 'rock', 'rock', 'psychedelic', 'new weird america', 'no wave', 'pop', 'noise', 'nu gaze', 'rock', 'shoegaze', 'slow core', 'electronic rock', 'dream pop', 'drone', 'experimental', 'experimental', 'freak folk', 'japanese psychedelic', 'rock', 'rock', 'psychedelic', 'new weird america', 'no wave', 'pop', 'noise', 'nu gaze', 'rock', 'shoegaze', 'slow core', 'electronic rock']
Barem	['techno', 'techno', 'house music', 'disco', 'dub', 'techno', 'rock', 'house music', 'techno', 'rap', 'techno', 'techno', 'techno', 'techno']
Bari	['trap', 'disco', 'rap', 'trap', 'trap']
Barker & Baumecker	['techno', 'house music', 'dub', 'house music', 'techno', 'techno', 'techno', 'house music', 'dub', 'house music', 'techno', 'house music', 'dub', 'house music']
Bas Ibellini	[]
Basel	['consort', 'consort', 'consort']
BassbÃ¼ro	[]
Bassbüro	[]
Bassforscher	[]
Bassjackers	['trap', 'big room', 'uk garage', 'big', 'house music', 'edm', 'house music', 'trap', 'house music', 'house music', 'house music', 'house music', 'tracestep', 'house music', 'trap', 'big room', 'uk garage', 'big', 'house music', 'edm', 'house music', 'trap', 'house music', 'house music', 'house music', 'house music', 'tracestep', 'house music', 'trap', 'big room', 'uk garage', 'big', 'house music', 'edm', 'house music', 'trap', 'house music', 'house music', 'house music', 'house music', 'tracestep', 'house music']
Bassport	[]
Baumeister	[]
Beda	['disco', 'rap']
Beda  DekaDance	[]
Belair	[]
Bella Sarris	[]
BellaBerlin	[]
Ben Kaczor	['rap', 'disco']
Ben Parris  foundsound  baltimore  USA	[]
Ben Parris  more TBA	[]
Ben UFO	['house music', 'dub', 'uk garage', 'uk garage']
Ben Yoo Suk	[]
Benja	[]
Benjamin	['alternative metal', 'alternative', 'metal', 'pop punk', 'post-grunge', 'rap', 'alternative metal', 'alternative', 'metal', 'pop punk', 'post-grunge', 'rap', 'alternative metal', 'alternative', 'metal', 'pop punk', 'post-grunge', 'rap']
Benjamin Damage	['bass music', 'house music', 'uk garage', 'dub', 'house music', 'jungle', 'house music', 'rap', 'techno', 'techno', 'disco', 'bass music', 'house music', 'uk garage', 'dub', 'house music', 'bass music', 'house music', 'uk garage', 'dub', 'house music']
Benno Blome	['house music', 'rap', 'dub', 'disco']
Benotmane	['house music', 'house music', 'house music']
Berlin	['big room', 'big', 'deep', 'edm', 'house music', 'house music', 'house music', 'trance music', 'trance', 'house music', 'trance music', 'big room', 'big', 'deep', 'edm', 'house music', 'house music', 'house music', 'trance music', 'trance', 'house music', 'trance music', 'big room', 'big', 'deep', 'edm', 'house music', 'house music', 'house music', 'trance music', 'trance', 'house music', 'trance music']
BerlinJapan	[]
Bern	[]
Bernardo Zitto & Roberto Splendini	[]
Betoko	['disco', 'deep', 'groove room', 'house music', 'techno', 'house music', 'rap', 'trap', 'techno', 'disco', 'disco', 'deep', 'groove room', 'house music', 'techno', 'house music', 'disco', 'deep', 'groove room', 'house music', 'techno', 'house music']
Bfly Steiner	['house music', 'techno']
Bfly Steiner and friends	[]
BigenericMarco Repetto	[]
Bio & Larkian & Les Poissons Autistes	[]
Bird	['rock', 'anti-folk', 'chamber pop', 'chicago indie', 'folk', 'folk', 'folk', 'indie', 'indie', 'indie', 'indie', 'melancholia', 'neo-psychedelic', 'new americana', 'pop', 'singer-songwriter', 'slow core', 'stomp and holler', 'rock', 'anti-folk', 'chamber pop', 'chicago indie', 'folk', 'folk', 'folk', 'indie', 'indie', 'indie', 'indie', 'melancholia', 'neo-psychedelic', 'new americana', 'pop', 'singer-songwriter', 'slow core', 'stomp and holler', 'rock', 'anti-folk', 'chamber pop', 'chicago indie', 'folk', 'folk', 'folk', 'indie', 'indie', 'indie', 'indie', 'melancholia', 'neo-psychedelic', 'new americana', 'pop', 'singer-songwriter', 'slow core', 'stomp and holler']
Bird  sirion  Bern	[]
Bishop & Goldberg	[]
BitTuner	[]
BitTuner live	[]
Bjoerng	[]
Black Coffee	['house music', 'house music', 'house music', 'house music', 'hip hop', 'techno', 'house music', 'house music', 'house music', 'house music']
Black Cracker  spoken words	[]
BlackCat	[]
Blaqq & Whyd	[]
Bleepsequence	[]
Bloody Mary	['rap', 'techno', 'house music', 'techno', 'disco']
Bogota	['cumbia', 'rock', 'cumbia', 'rock', 'cumbia', 'rock']
Bohnenblust	[]
Bonny & Clyde	[]
Booka Shade	['electronic rock', 'disco', 'deep', 'house music', 'deep', 'electronic', 'techno', 'house music', 'microhouse', 'techno', 'house music', 'house music', 'house music', 'rock', 'rap', 'hip hop', 'disco', 'electronic rock', 'disco', 'deep', 'house music', 'deep', 'electronic', 'techno', 'house music', 'microhouse', 'techno', 'house music', 'house music', 'electronic rock', 'disco', 'deep', 'house music', 'deep', 'electronic', 'techno', 'house music', 'microhouse', 'techno', 'house music', 'house music']
Borderline	['antiviral pop', 'antiviral pop', 'antiviral pop']
Boris Werner	['techno', 'house music', 'hip hop', 'techno', 'house music', 'techno', 'hip hop', 'hip hop', 'techno', 'techno']
BoyAn	['rap', 'house music', 'house music', 'techno', 'disco']
BoyAn  Fery  Diese Jungs brillieren	[]
BoyoomConnective	[]
Bradd  cafe mambo	[]
Brainstorm  ohm 10n tunnelenergych	[]
Brian Burger	['techno', 'techno', 'techno', 'disco', 'techno', 'techno']
Brian Sanhaji	['house music', 'hip hop', 'hip hop', 'hip hop', 'techno', 'techno', 'dub', 'disco']
Britta Arnold	['house music', 'deep', 'rap', 'techno', 'techno', 'disco', 'house music', 'deep', 'house music', 'deep']
BrokenEnglishManchester	[]
Bruderherz	[]
Bryan Black aka Black Asteroid	[]
Budenzauber	[]
Bugsy	['disco', 'techno', 'house music', 'techno']
Bunga Bunga	['indonesian pop', 'indonesian pop', 'indonesian pop']
Bunny Over Money	[]
Butane  alphahouse  st louis  USA	[]
Butch	['neo mellow', 'rock', 'rap', 'techno', 'house music', 'techno', 'disco', 'hip hop', 'neo mellow', 'rock', 'neo mellow', 'rock']
C Forza	[]
CARI	[]
CEZAR	['rap', 'techno', 'house music', 'techno', 'disco', 'techno']
CH	[]
CHRIS LOUD	[]
CHRISTOPHER S	[]
CITYCAT	[]
CITYFOX	[]
CLAUDIO MAURMO	[]
CLIFF	['reggae', 'reggae', 'soul', 'reggae', 'reggae', 'soul', 'reggae', 'reggae', 'soul']
CRIS ALLEGRO	[]
CYLS	[]
CYRIL LEGER	[]
Cadenza LausanneBerlin	[]
Calado	[]
Camea	['rap', 'house music', 'house music', 'rock', 'techno', 'house music', 'techno', 'disco']
Canson	['house music', 'techno', 'techno', 'house music', 'house music']
Canson  handheld  zurich  CH	[]
Cantina Brothers	[]
Carl Cox	['house music', 'techno', 'schranz', 'house music', 'techno', 'jungle', 'house music', 'house music', 'hardcore', 'house music', 'hip hop', 'hip hop', 'rap', 'hip hop', 'techno', 'techno', 'disco', 'house music', 'techno', 'schranz', 'house music', 'techno', 'house music', 'techno', 'schranz', 'house music', 'techno']
Carlos Russo	['house music']
Carola Pisaturo	[]
Caru Brown	[]
Central Rodeo	['rap', 'house music', 'techno', 'disco']
CepheÃ¬	[]
Cepheì	[]
Cessman	['uk garage', 'uk garage', 'uk garage']
Channel X	['house music', 'hardcore', 'house music', 'house music', 'hardcore', 'house music', 'house music', 'hardcore', 'house music']
Charles Bohmann	[]
Charlie Gold	[]
Chaton  plak records  geneva  CH	[]
Cheeky Choice ZÃ¼rich	[]
Cheeky Choice Zürich	[]
Cheers	['rock', 'shimmer pop', 'rock', 'shimmer pop', 'rock', 'shimmer pop']
Chez Damier	['house music', 'house music', 'house music', 'house music', 'house music', 'house music']
Chicago	['deep indie r&b', 'deep', 'escape room', 'hip hop', 'indie', 'neo soul', 'pop', 'r&b', 'rap', 'soul', 'hip hop', 'hip hop', 'urban contemporary', 'deep indie r&b', 'deep', 'escape room', 'hip hop', 'indie', 'neo soul', 'pop', 'r&b', 'rap', 'soul', 'hip hop', 'hip hop', 'urban contemporary', 'deep indie r&b', 'deep', 'escape room', 'hip hop', 'indie', 'neo soul', 'pop', 'r&b', 'rap', 'soul', 'hip hop', 'hip hop', 'urban contemporary']
Chicco Green	[]
Chien Andalou	[]
Chinny	[]
Chris Carrier	['house music', 'techno', 'rap', 'techno', 'house music', 'techno', 'disco', 'hip hop', 'hip hop', 'house music', 'techno', 'house music', 'techno']
Chris De Rebel	[]
Chris Dubflow	['ambient', 'ambient', 'ambient']
Chris Liebing	['techno', 'techno', 'schranz', 'techno', 'rap', 'hip hop', 'techno', 'techno', 'disco', 'techno', 'techno', 'schranz', 'techno', 'techno', 'techno', 'schranz', 'techno']
Chris Loud	[]
Chris Rockwell	['disco', 'techno', 'rock', 'house music', 'techno', 'rap']
Chris SchwarzwÃ¤lder	[]
Chris Schwarzwälder	[]
Chris Tietjen	['disco', 'rap']
Chris Tietjen GER  cocoonnet  Frankfurt	[]
Christian Burkhardt	['techno', 'dub', 'techno', 'techno', 'techno', 'techno']
Christian Burkhardt live	[]
Christian&Raphaël	['rap', 'house music']
Cio	[]
Circle	['alternative metal', 'alternative', 'funk', 'metal', 'post-grunge', 'rap', 'rap', 'rock', 'alternative metal', 'alternative', 'funk', 'metal', 'post-grunge', 'rap', 'rap', 'rock', 'alternative metal', 'alternative', 'funk', 'metal', 'post-grunge', 'rap', 'rap', 'rock']
Circumflux	[]
Cityfox	[]
Cityfox  ZÃ¼rich	[]
Cityfox  Zürich	[]
Clats	[]
Claudio Carrera	[]
ClekClekBoom	[]
Clem	['ambient', 'nu age', 'jungle', 'hip hop', 'disco', 'rock', 'hip hop', 'hip hop', 'rap', 'ambient', 'nu age', 'ambient', 'nu age']
Click  Click	['emo', 'neo mellow', 'pop christmas', 'pop', 'pop', 'pop', 'pop', 'punk', 'pop', 'emo', 'neo mellow', 'pop christmas', 'pop', 'pop', 'pop', 'pop', 'punk', 'pop', 'emo', 'neo mellow', 'pop christmas', 'pop', 'pop', 'pop', 'pop', 'punk', 'pop']
Click Box	['disco', 'techno', 'house music', 'techno', 'rap']
Clink	[]
Clique of Two	[]
Clv	[]
Cobeia	['rock', 'dub', 'disco', 'hip hop']
Cocoon	['chanson', 'chanson', 'chanson']
CocoonZürich	[]
Colours Audio	[]
Como Damar	[]
Corin	[]
Correspondant	[]
Cosili & Gabriel Roth	[]
Craig Richards  Fabric London	[]
Cristian Tamborrini	['house music', 'house music', 'house music', 'electronica', 'house music']
Cristian Varel	[]
Crossworld Records	[]
Crowdpleaser	['techno', 'techno', 'techno']
Crux	['oi', 'oi', 'oi']
Cubex	['house music', 'house music', 'techno']
Cutkachi	['uk garage', 'uk garage', 'uk garage']
CÃ©cile	[]
Cécile	[]
D	['alternative metal', 'alternative', 'rock', 'comic', 'heavy christmas', 'post-grunge', 'rock', 'alternative metal', 'alternative', 'rock', 'comic', 'heavy christmas', 'post-grunge', 'rock', 'alternative metal', 'alternative', 'rock', 'comic', 'heavy christmas', 'post-grunge', 'rock']
D Cosmo	[]
D Lewis	['rock', 'rap', 'techno', 'techno', 'post-disco', 'disco']
DARREN LAWS	[]
DAVE WALKER	[]
DAVID MORENO	[]
DE	['banda', 'grupera', 'norteno', 'regional mexican', 'banda', 'grupera', 'norteno', 'regional mexican', 'banda', 'grupera', 'norteno', 'regional mexican']
DEJAN	[]
DEJAN  Cityfox ZÃ¼rich	[]
DEJAN  Cityfox Zürich	[]
DEJAN cityfox zürich	[]
DELAYED PROJECT	[]
DINKY	['disco', 'ambient', 'techno', 'house music', 'techno', 'rap']
DIRTY FLAV	[]
DISCO DAVE jackpoint zürich	[]
DIncise	['abstract', 'abstract', 'abstract']
DJ	['trap', 'house music', 'trap', 'house music', 'trap', 'house music']
DJ BOOBY	[]
DJ Devcon	[]
DJ Dub	['dub']
DJ EPI	[]
DJ Fab	['techno', 'techno']
DJ Fuse	['rap', 'hip hop', 'house music', 'disco', 'hip hop', 'hip hop']
DJ Headstorm	[]
DJ Hell	['electronic rock', 'electronic rock', 'electronic rock']
DJ Hirpus	[]
DJ Jay Sanders	[]
DJ JooLs	[]
DJ Junior	[]
DJ Kev the Head	[]
DJ Koze  kompakt  germany	[]
DJ Larson	[]
DJ Le Baron	['rap', 'disco']
DJ Le Roi	['house music', 'house music', 'hip hop', 'hip hop', 'rap', 'hip hop', 'disco']
DJ Little Miss	[]
DJ Marky & XRS	['drum and bass', 'drum and bass', 'rap', 'disco', 'drum and bass', 'drum and bass', 'drum and bass', 'drum and bass']
DJ Ombres	[]
DJ PAD	[]
DJ Phil	[]
DJ QOOL MARV	[]
DJ SAM	[]
DJ Sassy J	[]
DJ Tiago CORTEZ   DJ FURITEC AKA PASCAL PROSPER	[]
DJ Tony Big	[]
DJ Yoda	['breakbeat', 'ninja', 'downtempo', 'turntablism', 'breakbeat', 'ninja', 'downtempo', 'turntablism', 'breakbeat', 'ninja', 'downtempo', 'turntablism']
DJ Zimmbi	[]
DJLINEUP	[]
DJs	['new jack swing', 'new jack swing', 'new jack swing']
DJs Chic Brown	[]
DLM	['rock', 'rock', 'rock']
DOG	['rock', 'chamber pop', 'folk christmas', 'folk', 'folk', 'rock', 'christmas', 'indie', 'indie', 'indie', 'electronic rock', 'lo-fi', 'modern blues', 'neo-psychedelic', 'new americana', 'pop', 'singer-songwriter', 'stomp and holler', 'rock', 'chamber pop', 'folk christmas', 'folk', 'folk', 'rock', 'christmas', 'indie', 'indie', 'indie', 'electronic rock', 'lo-fi', 'modern blues', 'neo-psychedelic', 'new americana', 'pop', 'singer-songwriter', 'stomp and holler', 'rock', 'chamber pop', 'folk christmas', 'folk', 'folk', 'rock', 'christmas', 'indie', 'indie', 'indie', 'electronic rock', 'lo-fi', 'modern blues', 'neo-psychedelic', 'new americana', 'pop', 'singer-songwriter', 'stomp and holler']
DVS1	['techno', 'dub', 'techno', 'techno', 'dub', 'techno', 'techno', 'dub', 'techno']
DVW & Marc Feldmann	['rap']
DVW & Marc Feldmann  Trinidad	['rap']
Dada Life	['big room', 'uk garage', 'uk garage', 'big', 'disco', 'edm', 'house music', 'trap', 'house music', 'house music', 'house music', 'house music', 'house music', 'big room', 'uk garage', 'uk garage', 'big', 'disco', 'edm', 'house music', 'trap', 'house music', 'house music', 'house music', 'house music', 'house music', 'big room', 'uk garage', 'uk garage', 'big', 'disco', 'edm', 'house music', 'trap', 'house music', 'house music', 'house music', 'house music', 'house music']
Daegon	[]
Damián Schwartz	[]
Dan Ghenacia	['rock', 'techno', 'house music', 'techno']
Dandy Jack	['disco', 'techno', 'hip hop', 'techno', 'hip hop', 'rap']
Dani Castillo algo Mas Duro Barcelone	[]
Dani Nydegger	[]
Daniel Dreier	['techno', 'disco', 'dub', 'techno', 'hip hop', 'house music', 'techno', 'hip hop', 'rap', 'techno', 'techno']
Daniel Steinberg	['disco', 'deep', 'deep', 'deep', 'minimal', 'techno', 'house music', 'rap', 'house music', 'rock', 'techno', 'house music', 'dub', 'techno', 'disco', 'disco', 'deep', 'deep', 'deep', 'minimal', 'techno', 'house music', 'disco', 'deep', 'deep', 'deep', 'minimal', 'techno', 'house music']
Danielson & Norbertto	[]
Danielson & norbertto	[]
Danielson vs norbertto	[]
Danny Coleman	[]
Danny Faber	['disco', 'techno', 'techno', 'rap']
Dantze	[]
Daparec	['techno', 'techno']
Dapayk	['house music', 'deep', 'techno', 'microhouse', 'techno', 'house music', 'rap', 'techno', 'trap', 'techno', 'disco', 'techno', 'house music', 'deep', 'techno', 'microhouse', 'techno', 'house music', 'house music', 'deep', 'techno', 'microhouse', 'techno', 'house music']
Dario DAttis	['rap', 'disco']
Dario Zenker	['techno', 'trance music', 'disco', 'techno', 'house music', 'techno', 'rap', 'techno', 'techno']
Darkening	[]
Darrien	['hardcore', 'hardcore', 'hardcore']
Das Balz	[]
Das Pferd	[]
Das Schiff	[]
Das Volca Massaker Orchester	[]
Dauwalder  NEAT	[]
Dave Gin Tonic	[]
David Armada	['disco', 'rap']
David August	['disco', 'deep', 'deep', 'house music', 'microhouse', 'techno', 'techno', 'house music', 'house music', 'disco', 'deep', 'deep', 'house music', 'microhouse', 'techno', 'techno', 'house music', 'house music', 'disco', 'deep', 'deep', 'house music', 'microhouse', 'techno', 'techno', 'house music', 'house music']
David Carbone	[]
David Delgado	['ambient', 'house music', 'hip hop', 'rap', 'hip hop', 'techno', 'disco']
David Durango	['techno', 'rap', 'rock', 'house music', 'disco', 'hip hop', 'hip hop', 'techno', 'techno']
David Eye	['house music', 'house music', 'techno', 'house music', 'techno']
David JimÃ©nez	[]
David Jiménez	[]
David Styloso	[]
David Torr	['rap', 'disco']
Davide Squillace	['techno', 'disco', 'ambient', 'techno', 'house music', 'techno', 'rap', 'techno', 'techno']
De La Maso	['rap', 'rock', 'disco']
De La Porter	[]
De La Porter Skorpionkinder Rec  Cube Resident	[]
De La Porter Skorpionkinder RecCube Resident	[]
De La Porter Skorpionkinder Records  Cube Resident  Electroradio	[]
De La PorterRoom RecSK RecCube Resident	[]
Dead Poets	[]
Deadly Avenger	['breakbeat', 'breakbeat', 'breakbeat']
DeeVerso	[]
Deecoy	[]
Deenee Muetr	[]
Deep House	[]
Deep n Dub	[]
Deepwave	[]
Deetron	['house music', 'techno', 'rap', 'techno', 'techno', 'disco', 'house music', 'techno', 'house music', 'techno']
Deetron & Petar Dundov	['rap', 'techno', 'techno', 'techno', 'techno', 'techno', 'techno', 'hip hop', 'rap', 'hip hop']
Definition	['dreamo', 'hardcore', 'screamo', 'rap', 'techno', 'house music', 'techno', 'disco', 'dreamo', 'hardcore', 'screamo', 'dreamo', 'hardcore', 'screamo']
Dejan	[]
DekmantelAmsterdam	[]
Delsin	[]
Demetrio Giannice	['house music', 'hip hop', 'dub', 'house music', 'house music']
Der Effekt	[]
Der Held	[]
Der Schuft	[]
Der Schuft aka Luca de Grandis	[]
Der hut	[]
Derick May	[]
Derrick May	['house music', 'house music', 'techno', 'techno', 'techno', 'ambient', 'house music', 'hardcore', 'rap', 'hip hop', 'techno', 'techno', 'disco', 'house music', 'house music', 'techno', 'techno', 'techno', 'house music', 'house music', 'techno', 'techno', 'techno']
Detroit	[]
Die Antwoord	['rock', 'escape room', 'electronic rock', 'rock', 'escape room', 'electronic rock', 'rock', 'escape room', 'electronic rock']
Die Grimen	[]
Die Grimen & Maty Palc	[]
Dieses Mal besucht uns ein Freund aus Berlin  Marco Effe Seine ImpressParty in Berlin spricht für sich Jeweils Mittwochs beschallt er zusammen mit diversen Künstlern aus verschiedenen Genres den weltweit bekannten Watergate Club	[]
Different Drummer	[]
Difracctive	[]
Digitaline	['techno', 'techno', 'techno', 'techno']
Digitaline  cadenza  lausanne  CH	[]
Digitalis	['dub', 'dub', 'dub']
Dimitri	['big room', 'big', 'edm', 'house music', 'house music', 'house music', 'big room', 'big', 'edm', 'house music', 'house music', 'house music', 'big room', 'big', 'edm', 'house music', 'house music', 'house music']
Dino Amas	[]
Dino Pergola & Gusto	[]
Dirty Channels	['rap', 'disco']
Dirty Doering	['house music', 'deep', 'rap', 'disco', 'hip hop', 'house music', 'deep', 'house music', 'deep']
Dirty Flav	[]
Disco	['emo', 'pop punk', 'vegas indie', 'emo', 'pop punk', 'vegas indie', 'emo', 'pop punk', 'vegas indie']
Disco & Tanzstube	[]
Disco Channel	[]
Disco HalalBerlin	[]
Disco mit Mute DrumnBass	[]
Disco mit Stil vor Talent	[]
DiscoD	[]
Diskomurder	[]
District2	[]
Divided	[]
Divinity	[]
Dixon	['soundtrack', 'house music', 'rock', 'techno', 'house music', 'breakbeat', 'techno', 'disco', 'hip hop', 'soundtrack', 'soundtrack']
Dj Alastair Electroradio  Cube	[]
Dj Anthony Vega	[]
Dj Flo	[]
Dj Guz	['techno', 'techno']
Dj Magicstorm	[]
Dj Mia Kaltes	[]
Dj Michael T Fresh	[]
Dj Never Die	['hardcore', 'rap', 'techno', 'techno', 'disco']
Dj Never Die & NICOB	['rap']
Dj Noise	[]
Dj Phil	[]
Dj Puma	[]
Dj Robr	[]
Dj Skaos	[]
Dj Tony Big	[]
Djebali	['techno', 'house music', 'house music', 'techno', 'techno']
Djeniz  WaldgeflÃ¼ster	[]
Djeniz  Waldgeflüster	[]
Djs Bob Rock	[]
Doeasy Rec	[]
Dominik Auderset Schallrausch	[]
Dominik Burkhalter  drums	[]
Dominik Eulberg	['house music', 'deep', 'techno', 'microhouse', 'techno', 'house music', 'house music', 'rap', 'hip hop', 'techno', 'techno', 'disco', 'house music', 'deep', 'techno', 'microhouse', 'techno', 'house music', 'house music', 'deep', 'techno', 'microhouse', 'techno', 'house music']
Dominik Eulberg  Cocoon	[]
Dominik Trieb  Suberplastic ag	[]
Don Dario	['house music', 'house music', 'hip hop', 'techno', 'techno', 'house music', 'disco']
Don Ramon	['argentine reggae', 'house music', 'rap', 'techno', 'techno', 'disco', 'argentine reggae', 'argentine reggae']
Don Ramon  Friedas BÃ¼xe	[]
Don Ramon  Friedas Büxe	[]
Don Tetris	[]
Don Tetris  subsTANZ be	[]
Doomwork	['techno', 'house music', 'rap', 'hip hop', 'techno', 'techno', 'techno', 'techno']
Dottore Monkey Jam  Cube	[]
Doublescore	[]
DoubtingThomas	['rap', 'techno', 'disco']
DrPsyche	[]
Dragosh	['techno', 'techno', 'techno']
Drea	[]
Dreiklang	[]
Dreksler & Haerle	[]
Dreksler&Haerle	[]
Dreksler&Haerle live  elektrostubete be	[]
Drilon	['opm', 'opm', 'opm']
Drumcode	[]
Dub Tales  Off Mind rec be	[]
DubNoir	[]
Dubfire	['disco', 'deep', 'deep', 'techno', 'house music', 'microhouse', 'techno', 'house music', 'techno', 'house music', 'rap', 'techno', 'techno', 'disco', 'disco', 'deep', 'deep', 'techno', 'house music', 'microhouse', 'techno', 'house music', 'techno', 'disco', 'deep', 'deep', 'techno', 'house music', 'microhouse', 'techno', 'house music', 'techno']
Dubokaj	[]
Dubspeeka	[]
Dubvadsion	[]
Duskid	[]
Dust 21	[]
Dustin Zahn	['techno', 'techno', 'techno']
Dynamics	[]
Dzann	[]
DÃ¼rerstuben	['house music', 'house music', 'house music']
Dürerstuben	['house music', 'house music', 'house music']
E	['pop', 'pop', 'pop']
EMERSON	['choral', 'classical', 'classical', 'classical', 'classical', 'orchestral', 'string quartet', 'violin', 'choral', 'classical', 'classical', 'classical', 'classical', 'orchestral', 'string quartet', 'violin', 'choral', 'classical', 'classical', 'classical', 'classical', 'orchestral', 'string quartet', 'violin']
Eazy M	['rap', 'house music', 'house music', 'disco', 'hip hop']
Echo 106	['house music', 'house music', 'house music']
Ed Luis	[]
Ed Luis vs Albi	[]
Edward	['chamber pop', 'pop', 'folk', 'indie', 'indie', 'indie', 'stomp and holler', 'rap', 'disco', 'chamber pop', 'pop', 'folk', 'indie', 'indie', 'indie', 'stomp and holler', 'chamber pop', 'pop', 'folk', 'indie', 'indie', 'indie', 'stomp and holler']
Edward Ean	['techno', 'house music', 'techno']
Ein wachsendes Netzwerk in Sachen Künstler elektronischer Musik Qualität vor Quantität  ein Produkt	[]
Einzelkind	['techno', 'disco', 'house music', 'techno', 'rap', 'techno', 'techno']
Einzig & Faerber	['rap']
Ekkohaus	['techno', 'techno', 'house music', 'techno', 'techno', 'techno']
El Alusinante	[]
El Grego	[]
El Rey	[]
Electrofraise	[]
Electromcfly	['disco', 'rap']
Electroradio Crew Alastair & Houserockers	[]
Elektroschneider	[]
Eli Verveine	['hip hop', 'techno', 'techno', 'disco']
Eli Verveine  scandal   switzerland	[]
Elliot Eastwick	[]
Elvis Cassetta	['house music', 'house music', 'rap', 'disco']
Emanuel Satie	['disco', 'house music', 'techno', 'house music', 'disco', 'house music', 'techno', 'house music', 'disco', 'house music', 'techno', 'house music']
Emanuele Errante	['nu age', 'warm drone', 'nu age', 'warm drone', 'nu age', 'warm drone']
Emanuele Inglese	[]
Emanuele de Raymondi	[]
Emely& Scum	[]
Emendy	['rap']
Eminor	[]
Emix	['rap', 'techno', 'techno', 'disco']
Emmanuel K	[]
England	['rock', 'mellow gold', 'rock', 'rock', 'mellow gold', 'rock', 'rock', 'mellow gold', 'rock']
Enterbt	[]
Enzo Lo Conte	[]
Enzo Siragusa	['techno', 'house music', 'techno', 'hip hop', 'jungle']
Equinox	['drumfunk', 'slavic metal', 'drumfunk', 'slavic metal', 'drumfunk', 'slavic metal']
Erase	['bay area indie', 'no wave', 'rock', 'post-punk', 'riot grrrl', 'bay area indie', 'no wave', 'rock', 'post-punk', 'riot grrrl', 'bay area indie', 'no wave', 'rock', 'post-punk', 'riot grrrl']
Erhalder	[]
Eric Borgo	['rap', 'house music', 'techno', 'house music', 'techno', 'disco']
EricP	[]
Erol Alkan	['house music', 'hip hop', 'rock', 'rap', 'hip hop', 'techno', 'techno', 'disco']
Escargot with	[]
Eskimo Live	[]
Eurokai	[]
Even Tuell	[]
Everest on TT	[]
Evolent	['hip hop']
Extrawelt	['house music', 'deep', 'techno', 'microhouse', 'techno', 'house music', 'house music', 'deep', 'techno', 'microhouse', 'techno', 'house music', 'house music', 'deep', 'techno', 'microhouse', 'techno', 'house music']
Ezikiel	['jungle', 'techno', 'rap', 'techno', 'techno', 'dub', 'disco']
Ezikiel  DekaDance	[]
Ezikiel  Unite ZÃ¼rich	[]
Ezikiel  Unite Zürich	[]
F	['baroque', 'classical', 'classical', 'romantic', 'baroque', 'classical', 'classical', 'romantic', 'baroque', 'classical', 'classical', 'romantic']
FABRI	[]
FABRI MUSIQ	[]
FABRIZIO DI SANDRO	[]
FABRi	[]
FD	['deep liquid bass', 'rap', 'techno', 'techno', 'disco', 'jungle', 'deep liquid bass', 'deep liquid bass']
FERY	[]
FLEXIBELLE bern	[]
FR	[]
FRANK SICCARDI	[]
FREAKBOUTIQUE	[]
FREAKY FUNKY BEER DOZE	[]
FRED 34m2 lausanne	[]
FREIBERG elektrostubete bern	[]
FRENCH FRIES	['bass music', 'techno', 'house music', 'bass music', 'techno', 'house music', 'bass music', 'techno', 'house music']
Fabio Alampit	[]
Fabio Dante	[]
Fabio Florido	['rap', 'house music', 'techno', 'house music', 'techno', 'disco']
Fabr	[]
Fabri	[]
Face Design	[]
Fact	[]
Falda	[]
Falling in Love EP	[]
False Friends	[]
Fat Sushi	['rap', 'house music', 'techno', 'house music', 'techno', 'disco']
Faul	['house music', 'house music', 'house music']
Feldermelder	[]
Felipe Valenzuela	['techno', 'house music', 'techno']
Felix KrÃ¶cher	['schranz', 'schranz', 'schranz']
Felix Kröcher	['schranz', 'schranz', 'schranz']
Felix Kröcher Abstract	[]
Felxibelle	[]
Feodor	['deep opera', 'deep opera', 'deep opera']
Fernando Lagreca	['dub', 'rap', 'disco', 'dub', 'dub']
Fictionizer	[]
Filewile	['rock', 'rock', 'rock']
Fingathing	['ninja', 'nu jazz', 'downtempo', 'turntablism', 'ninja', 'nu jazz', 'downtempo', 'turntablism', 'ninja', 'nu jazz', 'downtempo', 'turntablism']
Finnebassen	['disco', 'deep', 'groove room', 'house music', 'house music', 'house music', 'house music', 'hip hop', 'rap', 'disco', 'disco', 'deep', 'groove room', 'house music', 'house music', 'disco', 'deep', 'groove room', 'house music', 'house music']
Fis	['bass music', 'fluxwork', 'mandible', 'house music', 'bass music', 'fluxwork', 'mandible', 'house music', 'bass music', 'fluxwork', 'mandible', 'house music']
Fitzgerald & Rimini	[]
Five Club	['finnish pop', 'rock', 'finnish pop', 'rock', 'finnish pop', 'rock']
Flappers	[]
Flash	['hip hop', 'electro', 'rap', 'hardcore', 'hip hop', 'hip hop', 'rap', 'turntablism', 'hip hop', 'electro', 'rap', 'hardcore', 'hip hop', 'hip hop', 'rap', 'turntablism', 'hip hop', 'electro', 'rap', 'hardcore', 'hip hop', 'hip hop', 'rap', 'turntablism']
Flavio	['channel pop', 'channel pop', 'channel pop']
Flexibelle	[]
FlicFlac	['house music', 'house music', 'house music', 'house music', 'house music', 'house music']
Floor 1  Intec Digital	[]
Floor 2  Intec Digital	[]
Floor 3  clrnet	[]
Floppy Funk	[]
Fortyone Rec	[]
Francesco Ballato	[]
Francesco Parla	[]
Francis Mallo	[]
Frango	['hip hop', 'techno']
Frango sirion bern	[]
Frank Vespari	[]
Frankfurt	[]
Franky Fourfingers	[]
Fred Licci	[]
Freiberg	[]
Freiburg	['choral', 'classical', 'classical', 'classical', 'consort', 'harpsichord', 'orchestral', 'romantic', 'violin', 'choral', 'classical', 'classical', 'classical', 'consort', 'harpsichord', 'orchestral', 'romantic', 'violin', 'choral', 'classical', 'classical', 'classical', 'consort', 'harpsichord', 'orchestral', 'romantic', 'violin']
Freitag 06042012	[]
Friedas Neffe	[]
Fritz Kalkbrenner	['house music', 'deep', 'deep', 'german', 'techno', 'house music', 'house music', 'house music', 'hip hop', 'hip hop', 'rap', 'hip hop', 'techno', 'techno', 'disco', 'house music', 'deep', 'deep', 'german', 'techno', 'house music', 'house music', 'house music', 'deep', 'deep', 'german', 'techno', 'house music', 'house music']
Fritz Zander	['rap', 'techno', 'house music', 'techno', 'disco', 'hip hop']
Frohlocker	['funky breaks', 'rap', 'disco', 'funky breaks', 'funky breaks']
Frontlin	[]
Fumiya Tanaka	['techno', 'techno', 'techno', 'techno', 'techno', 'techno', 'techno', 'techno', 'techno']
Fuse  Ohm 10	[]
FussgÃ¤nger 9	[]
Fussgänger 9	[]
GForce aka Markus haZe	[]
GIUSEPPE CRUZ	[]
GL Everest	[]
GOGO	['contemporary jazz', 'jazz', 'jazz', 'contemporary jazz', 'jazz', 'jazz', 'contemporary jazz', 'jazz', 'jazz']
GOGO MUSIQ	[]
GRAND PIANORAMAX FT Black Cracker	[]
Gain Tom	[]
Galoppierende Zuversicht	[]
Garance	['techno', 'house music', 'techno', 'hip hop']
Garibovic	['disco', 'rap']
Garibovic BE  DefinitionMusic  Draft	[]
GarÃ§on	[]
Garçon	[]
Gebrüder Ritalin	[]
Germany	['post-disco', 'indie dream pop', 'indie', 'pop', 'shimmer', 'post-disco', 'indie dream pop', 'indie', 'pop', 'shimmer', 'post-disco', 'indie dream pop', 'indie', 'pop', 'shimmer']
Geronimo  Flinke Finger	[]
Get Physical	[]
GhostlyUS	[]
Giacomo Lombardo	[]
Gianni Callipari	['rap', 'disco']
Giardino Unplugged with	[]
Gimmick Rec	[]
Gin Tonic Soundsystem	[]
Giom	['rap', 'house music', 'house music', 'disco']
Girl	['mashup', 'mashup', 'mashup']
Giulia Paradiso	['hardcore']
Gleichschritt	[]
Gleischschritt	[]
Gogo	['contemporary jazz', 'jazz', 'jazz', 'contemporary jazz', 'jazz', 'jazz', 'contemporary jazz', 'jazz', 'jazz']
Golani Bros	[]
Gomorra	['techno']
Grant Nelson	['uk garage', 'house music', 'hardcore', 'house music', 'breakbeat', 'hip hop', 'rock', 'rap', 'hip hop', 'disco', 'uk garage', 'uk garage']
Gravina	['techno']
Gravina & Omar	['rap']
Gravina & omar	['rap']
Green Velvet	['disco', 'house music', 'techno', 'house music', 'techno', 'house music', 'house music', 'disco', 'house music', 'techno', 'house music', 'techno', 'disco', 'house music', 'techno', 'house music', 'techno']
Greg Beato	['house music', 'rap', 'disco', 'house music', 'house music']
Gregor Tresher	['house music', 'deep', 'deep', 'techno', 'techno', 'microhouse', 'minimal', 'techno', 'house music', 'techno', 'rap', 'disco', 'house music', 'deep', 'deep', 'techno', 'techno', 'microhouse', 'minimal', 'techno', 'house music', 'techno', 'house music', 'deep', 'deep', 'techno', 'techno', 'microhouse', 'minimal', 'techno', 'house music', 'techno']
Grndloop Agency	[]
Guts Pie Earshot	[]
Guyus	['uk garage', 'uk garage', 'uk garage', 'dub']
Guze	[]
Guzy	[]
Gynesh Bakir	[]
HANZ BEATER tanz	[]
HEIDI	['contemporary country', 'country', 'country', 'country', 'country', 'disco', 'techno', 'house music', 'techno', 'hip hop', 'rap', 'contemporary country', 'country', 'country', 'country', 'country', 'contemporary country', 'country', 'country', 'country', 'country']
HENRY Riton SMITHSON	[]
HERMANSSON & MARTINEZ	[]
HOBO	[]
HOSH	['disco', 'deep', 'deep', 'house music', 'microhouse', 'techno', 'techno', 'house music', 'disco', 'deep', 'deep', 'house music', 'microhouse', 'techno', 'techno', 'house music', 'disco', 'deep', 'deep', 'house music', 'microhouse', 'techno', 'techno', 'house music']
HOSH  Diynamic Rec	[]
HVOB	['house music', 'deep', 'techno', 'house music', 'house music', 'house music', 'deep', 'techno', 'house music', 'house music', 'house music', 'deep', 'techno', 'house music', 'house music']
Haiir	[]
Hamburg	[]
Haneef Raisani	[]
Hansim GlÃ¼ck	[]
Hansim Glück	[]
Hashman Deejay	[]
Hatti Vatti	['uk garage', 'substep', 'uk garage', 'substep', 'uk garage', 'substep']
Heartthrob  mnus  paris  F	[]
Hector	['boogaloo', 'cumbia', 'jazz christmas', 'mambo', 'merengue', 'salsa', 'tropical', 'christmas', 'rap', 'rock', 'techno', 'house music', 'techno', 'disco', 'hip hop', 'boogaloo', 'cumbia', 'jazz christmas', 'mambo', 'merengue', 'salsa', 'tropical', 'christmas', 'boogaloo', 'cumbia', 'jazz christmas', 'mambo', 'merengue', 'salsa', 'tropical', 'christmas']
Heiko	['coverchill', 'coverchill', 'coverchill']
Heiko MSO	['house music', 'disco', 'techno', 'house music', 'techno', 'rap']
Helder	['house music', 'house music', 'techno', 'techno', 'disco']
Helios & Hess	[]
Henry Clausen	[]
Henry Pass	[]
Henry Sure  Friedas BÃ¼xe ZÃ¼rich	[]
Henry Sure  Friedas Büxe Zürich	[]
Hermanez	['rap', 'techno', 'house music', 'techno', 'disco']
Herodot	['rap', 'disco']
Herr MÃ¼ller	[]
Herr Müller	[]
HerzblutEdinburgh	[]
Herzschwester	['house music', 'hip hop', 'techno', 'techno']
Herzschwester & Thom Nagy	['house music', 'rap', 'hip hop', 'techno', 'techno']
HighLive	[]
HighLive & Gravina	['rap']
Highgrade	['jump up', 'jump up', 'jump up']
Highgrade Afterparty	[]
Hinterhof	[]
Hinterhof Bar	[]
Hito	['techno', 'techno', 'hip hop']
Honoree	['house music', 'rap', 'techno', 'techno']
Horizontal  Chile	[]
Hos & Pacoco	[]
Hot Waves	[]
House	[]
House & Tech House	[]
House Rockers Electroradio  Cube	[]
Huazee	[]
Huerco S	['ambient', 'bass music', 'drone', 'techno', 'escape room', 'house music', 'fluxwork', 'fourth world', 'indie r&b', 'mandible', 'microhouse', 'minimal', 'house music', 'vaporwave', 'ambient', 'bass music', 'drone', 'techno', 'escape room', 'house music', 'fluxwork', 'fourth world', 'indie r&b', 'mandible', 'microhouse', 'minimal', 'house music', 'vaporwave', 'ambient', 'bass music', 'drone', 'techno', 'escape room', 'house music', 'fluxwork', 'fourth world', 'indie r&b', 'mandible', 'microhouse', 'minimal', 'house music', 'vaporwave']
Hug & Schiemann	[]
Human Garden Records	[]
Husky	['deep australian indie', 'house music', 'house music', 'rock', 'rap', 'disco', 'deep australian indie', 'deep australian indie']
Hyrez	['disco', 'rap']
I	['hip hop', 'rap', 'hardcore', 'hip hop', 'hip hop', 'pop', 'rap', 'hip hop', 'trap', 'hip hop', 'rap', 'hardcore', 'hip hop', 'hip hop', 'pop', 'rap', 'hip hop', 'trap', 'hip hop', 'rap', 'hardcore', 'hip hop', 'hip hop', 'pop', 'rap', 'hip hop', 'trap']
IDLE HANDSBRISTOL	[]
IT	['crunk', 'rap', 'trap', 'rap', 'rap', 'rap', 'hip hop', 'trap', 'hip hop', 'crunk', 'rap', 'trap', 'rap', 'rap', 'rap', 'hip hop', 'trap', 'hip hop', 'crunk', 'rap', 'trap', 'rap', 'rap', 'rap', 'hip hop', 'trap', 'hip hop']
ITALY	[]
Ich & Du	[]
Ill Dubio	[]
Ingo Boss	['disco', 'dub', 'house music', 'hip hop', 'rap']
Ink	['pop', 'trap', 'hip hop', 'pop', 'pop', 'r&b', 'rap', 'hip hop', 'trap', 'pop', 'trap', 'hip hop', 'pop', 'pop', 'r&b', 'rap', 'hip hop', 'trap', 'pop', 'trap', 'hip hop', 'pop', 'pop', 'r&b', 'rap', 'hip hop', 'trap']
Ink aka Nik	[]
Installations and guided tours through the botanic garden by	[]
Italien	[]
Italy	[]
Ivan Alvarez	[]
JAMES MC HALLE tanzkarrusell bern	[]
JAUSS  CRASH DELAY	[]
JAVI MUNOZ	[]
JD	['funk', 'jump blues', 'blues', 'new americana', 'rock', 'rockabilly', 'soul', 'funk', 'jump blues', 'blues', 'new americana', 'rock', 'rockabilly', 'soul', 'funk', 'jump blues', 'blues', 'new americana', 'rock', 'rockabilly', 'soul']
JEAN BAPTISTE	['baroque', 'classical', 'early music', 'renaissance', 'baroque', 'classical', 'early music', 'renaissance', 'baroque', 'classical', 'early music', 'renaissance']
JEUDI Records	[]
JOHN PLAYER 7b zürich	[]
JP Chronic Ibiza	[]
JUNKSOUND MOVEMENT	[]
JWalk	[]
Jack Jenson	[]
Jack Norris	[]
Jackathon  London	[]
Jacqui  MiniShake Music  Sion	[]
Jael	[]
Jam Janiro	[]
James Lavelle	['electronic rock', 'hip hop', 'hip hop', 'disco']
James Mc Hale	[]
James Mc Hale b2b Mia	[]
James Taylor	['adult standards', 'rock', 'folk', 'folk', 'folk', 'mellow gold', 'rock', 'rock', 'rock', 'singer-songwriter', 'rock', 'folk', 'adult standards', 'rock', 'folk', 'folk', 'folk', 'mellow gold', 'rock', 'rock', 'rock', 'singer-songwriter', 'rock', 'folk', 'adult standards', 'rock', 'folk', 'folk', 'folk', 'mellow gold', 'rock', 'rock', 'rock', 'singer-songwriter', 'rock', 'folk']
Jamie Shar	['house music', 'techno', 'techno']
Jan Penarrubia	['rap', 'techno', 'techno', 'disco']
Jan Penarrubia BE  Off Mind	[]
Jaser Mushkolaj	[]
Jauss	[]
Jax	['house music', 'house music', 'house music', 'house music', 'house music', 'house music', 'house music', 'house music', 'house music']
Jaxon	[]
Jay Joe	[]
JayJo	[]
Jazz T	['hip hop', 'hip hop', 'hip hop']
Jeem Collins	['techno', 'house music', 'techno', 'disco']
Jeem Collins Feection	[]
Jeff Mills	['house music', 'hardcore', 'rock', 'rap', 'techno', 'techno', 'disco']
Jehst	['uk garage', 'uk garage', 'hip hop', 'uk garage', 'uk garage', 'hip hop', 'uk garage', 'uk garage', 'hip hop']
Jen Morris	[]
Jennifer Cardini	['microhouse', 'techno', 'techno', 'disco', 'disco', 'downtempo', 'hip hop', 'microhouse', 'microhouse']
Jeremy De Koste	['house music', 'rap', 'disco', 'house music', 'house music']
Jeremy P Caulfield pres UNIT  dumb unit	[]
Jerry Joxx	[]
Jessica Diaz	[]
Jim Rivers	['house music', 'house music', 'rock', 'rap', 'hip hop', 'techno', 'techno', 'disco']
Jimi Jules	['rap', 'disco']
Joachim Pastor	['house music', 'deep', 'deep', 'techno', 'house music', 'disco', 'house music', 'deep', 'deep', 'techno', 'house music', 'house music', 'deep', 'deep', 'techno', 'house music']
Joe Feretti	[]
Joe T Vannelli STAR DJ	[]
Joel Brites	[]
Joel Mull	['techno', 'rap', 'techno', 'techno', 'disco', 'techno', 'techno']
Joel Ruck	[]
John Clats	[]
John Daly	[]
John Deere	['house music', 'house music', 'hip hop']
John Dimas	['rap', 'house music', 'techno', 'disco']
John Haden	[]
John Power	[]
Johnny Haway	[]
Jon Donson	['disco', 'techno', 'techno']
Jon Donson burgdorf	[]
Jon Rundell	['house music', 'rap', 'techno', 'techno']
Jonn Melchiat	['rap']
Joop Junior	['rock', 'rap', 'hip hop', 'techno', 'techno', 'disco']
Joram	['disco']
Jose De Divina	[]
Josh Wink	['house music', 'techno', 'techno', 'house music', 'techno', 'rap', 'techno', 'downtempo', 'techno', 'techno', 'house music', 'techno', 'techno', 'house music', 'techno', 'house music', 'techno', 'techno', 'house music', 'techno']
JosÃ¨ Parra	['cante flamenco', 'flamenco', 'cante flamenco', 'flamenco', 'cante flamenco', 'flamenco']
Josè Parra	['cante flamenco', 'flamenco', 'cante flamenco', 'flamenco', 'cante flamenco', 'flamenco']
Joèl Ruck	[]
Jubairo	[]
Juen	[]
Julian Jeweil	['techno', 'techno', 'techno', 'house music', 'techno', 'house music', 'techno', 'techno', 'techno', 'techno', 'techno', 'techno', 'house music', 'techno', 'house music', 'techno', 'techno', 'techno', 'techno', 'house music', 'techno', 'house music', 'techno']
Juliano Lopez	['rap', 'disco']
Julius Abel	['house music', 'house music', 'house music']
JuniorC	[]
Junksound live	[]
Justice Rivah feat Iyah Ranx	[]
Justin Robertson	['house music', 'rock', 'rap', 'hip hop', 'electronica', 'disco']
Jutzi	[]
Jutzi  subsTANZ be	[]
Jutzi & Don Tetris	[]
Juzz	['rap', 'disco']
Jyx	[]
KKToy	[]
KRamba	[]
KW32	[]
Ka & Ge	[]
Kadebostan & Laolu	['rap']
Kahuna	['breakbeat', 'breakbeat', 'electronic', 'downtempo', 'breakbeat', 'breakbeat', 'electronic', 'downtempo', 'breakbeat', 'breakbeat', 'electronic', 'downtempo']
Kalabrese	['house music', 'microhouse', 'house music', 'microhouse', 'house music', 'microhouse']
Kalabrese  stattmusik  switzerland	[]
Kalabrese perlon zürich	[]
Kamil Pawel	[]
Kantarik	['hip hop']
Karan Shah	['techno', 'techno']
Karl Gustav	[]
Karl Tonschänder	[]
Karotte	['techno', 'techno', 'house music', 'techno', 'techno', 'house music', 'techno', 'techno', 'house music']
Kassem Mosse	['bass music', 'techno', 'techno', 'house music', 'fluxwork', 'mandible', 'microhouse', 'dub', 'techno', 'house music', 'techno', 'bass music', 'techno', 'techno', 'house music', 'fluxwork', 'mandible', 'microhouse', 'dub', 'techno', 'house music', 'techno', 'bass music', 'techno', 'techno', 'house music', 'fluxwork', 'mandible', 'microhouse', 'dub', 'techno', 'house music', 'techno']
Katermukke	[]
KatermukkeBerlin	[]
Kaylee	[]
Keen	['alternative country', 'country', 'country', 'country', 'folk', 'folk', 'new americana', 'country', 'rock', 'rock', 'texas', 'country', 'alternative country', 'country', 'country', 'country', 'folk', 'folk', 'new americana', 'country', 'rock', 'rock', 'texas', 'country', 'alternative country', 'country', 'country', 'country', 'folk', 'folk', 'new americana', 'country', 'rock', 'rock', 'texas', 'country']
Keinemusik	[]
Kellerkind	['disco', 'deep', 'deep', 'house music', 'house music', 'house music', 'house music', 'techno', 'techno', 'disco', 'disco', 'deep', 'deep', 'house music', 'disco', 'deep', 'deep', 'house music']
Kellerkind  stil vor talent  bern	[]
Ken Wan	['rap', 'house music', 'house music', 'disco']
Kenny Ground	['rap', 'house music', 'rock', 'house music', 'techno', 'disco']
Kenny Larkin	['house music', 'house music', 'techno', 'electro', 'techno', 'techno', 'ambient', 'house music', 'rap', 'techno', 'techno', 'house music', 'disco', 'house music', 'house music', 'techno', 'electro', 'techno', 'techno', 'house music', 'house music', 'techno', 'electro', 'techno', 'techno']
Ketchup	[]
Kev the Head	[]
Khainz	['progressive psytrance', 'disco', 'hip hop', 'rap', 'progressive psytrance', 'progressive psytrance']
Kim Prevedello	['rap', 'house music', 'disco', 'hip hop', 'hip hop']
Kittie	['alternative metal', 'metal', 'metal', 'industrial music', 'industrial music', 'melodic metalcore', 'metalcore', 'metal', 'rap', 'rap', 'alternative metal', 'metal', 'metal', 'industrial music', 'industrial music', 'melodic metalcore', 'metalcore', 'metal', 'rap', 'rap', 'alternative metal', 'metal', 'metal', 'industrial music', 'industrial music', 'melodic metalcore', 'metalcore', 'metal', 'rap', 'rap']
Klang	['disco', 'rap']
Klangkosmetiker	['rock', 'rap', 'disco']
Klangwelt  Geneve	[]
Klaudia Gawlas Abstract	[]
Klockwork	['electronic rock', 'electronic rock', 'electronic rock']
Kms	['techno', 'techno', 'techno', 'techno', 'techno', 'techno']
KnÃ¤ckebrÃ¶d	[]
Knäckebröd	[]
Koko Chanel	[]
Kolbe	[]
Kollektiv Turmstrasse	['disco', 'deep', 'deep', 'techno', 'microhouse', 'techno', 'techno', 'house music', 'house music', 'house music', 'downtempo', 'hip hop', 'rap', 'hip hop', 'techno', 'electronica', 'techno', 'disco', 'disco', 'deep', 'deep', 'techno', 'microhouse', 'techno', 'techno', 'house music', 'house music', 'disco', 'deep', 'deep', 'techno', 'microhouse', 'techno', 'techno', 'house music', 'house music']
KompaktSão Paulo	[]
Komplex Klub	[]
Kong Rec	[]
Konverter	[]
Kopenhagen	[]
Kornél Kovács	['balearic', 'house music', 'fluxwork', 'microhouse', 'house music', 'balearic', 'house music', 'fluxwork', 'microhouse', 'house music', 'balearic', 'house music', 'fluxwork', 'microhouse', 'house music']
Kortex	[]
Kowton	['bass music', 'house music', 'fluxwork', 'uk garage', 'house music', 'rap', 'disco', 'bass music', 'house music', 'fluxwork', 'uk garage', 'house music', 'bass music', 'house music', 'fluxwork', 'uk garage', 'house music']
Krafty Kuts	['breakbeat', 'breakbeat', 'breakbeat', 'hip hop', 'hip hop', 'rap', 'hip hop', 'techno', 'techno', 'disco', 'breakbeat', 'breakbeat', 'breakbeat', 'breakbeat', 'breakbeat', 'breakbeat']
Kruse & NÃ¼rnberg	[]
Kruse & Nürnberg	[]
Kultig	[]
Kyrill & Redford	['groove room', 'groove room', 'groove room']
KÃ¥re Kyl	[]
KÃ¶nig Balthasar	[]
Kåre Kyl	[]
König Balthasar	[]
LA LUCIOLE	[]
LABO M	[]
LAD	['rap', 'disco', 'hardcore', 'electronica']
LAIN  techno merveilleuse	[]
LCAW	['house music', 'house music', 'house music']
LIME	['disco', 'freestyle', 'post-disco', 'disco', 'freestyle', 'post-disco', 'disco', 'freestyle', 'post-disco']
LIVE	['christian christmas', 'world worship', 'worship', 'christian christmas', 'world worship', 'worship', 'christian christmas', 'world worship', 'worship']
LOKD  Basel	[]
LONE	['acoustic pop', 'deep new americana', 'pop', 'folk', 'indiecoustica', 'new', 'stomp and holler', 'rap', 'disco', 'acoustic pop', 'deep new americana', 'pop', 'folk', 'indiecoustica', 'new', 'stomp and holler', 'acoustic pop', 'deep new americana', 'pop', 'folk', 'indiecoustica', 'new', 'stomp and holler']
LOUH	[]
LS & Massuro Takashi	[]
LUCA BERTO	[]
La Vitamina	[]
Lain	[]
Lampert	[]
Laolu	['rap', 'techno', 'house music', 'techno', 'disco']
Laps and more	[]
Lara Valentina	[]
Laris Alexander	[]
Larry	['banda', 'deep cumbia sonidera', 'deep', 'duranguense', 'grupera', 'norteno', 'regional', 'regional', 'banda', 'deep cumbia sonidera', 'deep', 'duranguense', 'grupera', 'norteno', 'regional', 'regional', 'banda', 'deep cumbia sonidera', 'deep', 'duranguense', 'grupera', 'norteno', 'regional', 'regional']
Larzo & Sebus	[]
Lauren Lo Sung	[]
Lcp	[]
Le BÃ©rger	[]
Le Bérger	[]
Le Roi	[]
Le Slap	[]
Lee	['contemporary country', 'country', 'country', 'country', 'contemporary country', 'country', 'country', 'country', 'contemporary country', 'country', 'country', 'country']
Lee Burridge	['house music', 'house music', 'house music', 'disco', 'house music', 'breakbeat', 'house music', 'techno', 'hip hop', 'house music', 'house music', 'house music', 'house music', 'house music']
Lee Curtis	['brill building pop', 'doo-wop', 'rock', 'brill building pop', 'doo-wop', 'rock', 'brill building pop', 'doo-wop', 'rock']
Lee Curtiss	['disco', 'techno', 'house music', 'house music', 'rap', 'techno', 'techno', 'disco', 'disco', 'techno', 'disco', 'techno']
Lee Van Dowski	['techno', 'techno', 'house music', 'rap', 'rock', 'techno', 'ambient', 'techno', 'disco', 'hip hop', 'hip hop', 'techno', 'techno', 'house music', 'techno', 'techno', 'house music']
Lefty	['country gospel', 'country', 'cowboy western', 'nashville sound', 'country', 'country', 'traditional', 'western', 'country gospel', 'country', 'cowboy western', 'nashville sound', 'country', 'country', 'traditional', 'western', 'country gospel', 'country', 'cowboy western', 'nashville sound', 'country', 'country', 'traditional', 'western']
Lehar	['classical', 'romantic', 'rap', 'disco', 'classical', 'romantic', 'classical', 'romantic']
Leo Tardin  piano	[]
Leon	['rock', 'rock', 'indie pop', 'indie', 'neo mellow', 'rock', 'disco', 'techno', 'hip hop', 'house music', 'techno', 'rap', 'house music', 'rock', 'rock', 'indie pop', 'indie', 'neo mellow', 'rock', 'rock', 'rock', 'indie pop', 'indie', 'neo mellow', 'rock']
Lesnicar	[]
Levi	['broadway', 'show tunes', 'broadway', 'show tunes', 'broadway', 'show tunes']
Lexer	['house music', 'deep', 'groove room', 'house music', 'rap', 'disco', 'house music', 'deep', 'groove room', 'house music', 'house music', 'deep', 'groove room', 'house music']
Lexx	['rap', 'disco']
LiWell Project Ruum Records	[]
Liebkind	[]
Lil Gee	[]
Lilith	['spanish punk', 'rap', 'house music', 'techno', 'house music', 'techno', 'disco', 'hip hop', 'spanish punk', 'spanish punk']
Lionel Stephan D aka Little	[]
Little Jacob	[]
Little Lu	[]
Little MIss	[]
Little Miss	[]
Liv Stone	['disco', 'rock', 'techno', 'rap']
Live	['christian christmas', 'world worship', 'worship', 'christian christmas', 'world worship', 'worship', 'christian christmas', 'world worship', 'worship']
Live Elekfantz	[]
Live Gui Boratto	[]
Live Lcio	[]
Live Nick Dow	[]
Live Tape Five	[]
Live Umami	[]
Live Visuals by BildstÃ¶rung	[]
Live Visuals by Bildstörung	[]
Live Visuals by Blauton	[]
Live areage	[]
Live countdown by The SugaZz & Sacha Unger	[]
Lo mid High	[]
Lobe Records	[]
Loco & Jam	['techno', 'house music', 'techno', 'house music', 'techno', 'house music']
Lolo & Romeo	[]
London	['classical', 'classical', 'orchestral', 'soundtrack', 'classical', 'classical', 'orchestral', 'soundtrack', 'classical', 'classical', 'orchestral', 'soundtrack']
Lou Bellucci	[]
Lounge	[]
Lounge Mo Kitchen & Mo Bar	[]
Low Tales	['house music', 'house music', 'techno', 'house music']
Lowris	['techno', 'hip hop']
Lp	[]
Luca Agnelli	['house music', 'rap', 'disco']
Luca Castagna	[]
Luca Leiser	[]
Luca Morris	['techno', 'rap', 'disco', 'techno', 'techno']
Luca Torre	['house music', 'disco', 'downtempo', 'ambient', 'techno', 'house music', 'techno', 'techno', 'hip hop', 'rap']
Luca de Grandis	[]
Lucas Aliu	['house music', 'techno', 'techno']
Luciano b2b Carl Craig	[]
Lucky	['rap', 'rap', 'rap', 'rap', 'rap', 'rap']
Ludal	[]
Luigi Afterhour	[]
Lukas Kleesattel	['house music', 'techno', 'techno']
Lukas Kleesattel bern zÃ¼ri	[]
Lukas Kleesattel bern züri	[]
Luke Redford	[]
Luke Slater	['house music', 'techno', 'techno', 'electro', 'house music', 'microhouse', 'dub', 'techno', 'house music', 'techno', 'house music', 'techno', 'techno', 'electro', 'house music', 'microhouse', 'dub', 'techno', 'house music', 'techno', 'house music', 'techno', 'techno', 'electro', 'house music', 'microhouse', 'dub', 'techno', 'house music', 'techno']
Lux Rec  Schwyz	[]
LÄUFT	[]
MANDY	['pop', 'europop', 'hollywood', 'movie tunes', 'neo mellow', 'pop', 'pop', 'pop', 'pop', 'disco', 'techno', 'house music', 'techno', 'hip hop', 'rap', 'pop', 'europop', 'hollywood', 'movie tunes', 'neo mellow', 'pop', 'pop', 'pop', 'pop', 'pop', 'europop', 'hollywood', 'movie tunes', 'neo mellow', 'pop', 'pop', 'pop', 'pop']
MANON desolat züri	[]
MARCO TEMESTA	[]
MARLON	[]
MASSIMO GERARDI	[]
MASTRA mit TRAUMADUO bern	[]
MATT SMOOTH	[]
MATT TRIGGS	[]
MDMO	[]
MELON	['alternative metal', 'alternative', 'rock', 'rock', 'funk', 'rock', 'grunge', 'jam band', 'rock', 'grunge', 'rock', 'rock', 'disco', 'rap', 'alternative metal', 'alternative', 'rock', 'rock', 'funk', 'rock', 'grunge', 'jam band', 'rock', 'grunge', 'rock', 'rock', 'alternative metal', 'alternative', 'rock', 'rock', 'funk', 'rock', 'grunge', 'jam band', 'rock', 'grunge', 'rock', 'rock']
MGness	['house music', 'hip hop', 'techno', 'techno']
MIA MILANO	[]
MIA tanzkarrusell mulhouse	[]
MIGUEL	['pop', 'deep pop r&b', 'hip hop', 'hip hop', 'r&b', 'pop', 'pop', 'r&b', 'rap', 'hip hop', 'trap', 'urban contemporary', 'house music', 'rap', 'disco', 'pop', 'deep pop r&b', 'hip hop', 'hip hop', 'r&b', 'pop', 'pop', 'r&b', 'rap', 'hip hop', 'trap', 'urban contemporary', 'pop', 'deep pop r&b', 'hip hop', 'hip hop', 'r&b', 'pop', 'pop', 'r&b', 'rap', 'hip hop', 'trap', 'urban contemporary']
MIKE FATAL & NIKA NIKITA	[]
MIKE TEIXIERA	[]
MIKE VÃTH  Gon Records zh	[]
MIKE VÄTH  Gon Records zh	[]
MILK RESIDENTS	[]
MIO zÃ¼ri	[]
MIO züri	[]
MISS DUCKIN	[]
MONOTEQUE zÃ¼ri	[]
MONOTEQUE züri	[]
MONTREAL	['electronic rock', 'rock', 'anti-folk', 'athens indie', 'chamber pop', 'post-disco', 'electronic rock', 'pop', 'e6fi', 'folk', 'folk', 'folk', 'indie', 'indie', 'indie', 'indie', 'electronic rock', 'lo-fi', 'neo-psychedelic', 'electronic rock', 'pop', 'pop', 'stomp and holler', 'electronic rock', 'electronic rock', 'rock', 'anti-folk', 'athens indie', 'chamber pop', 'post-disco', 'electronic rock', 'pop', 'e6fi', 'folk', 'folk', 'folk', 'indie', 'indie', 'indie', 'indie', 'electronic rock', 'lo-fi', 'neo-psychedelic', 'electronic rock', 'pop', 'pop', 'stomp and holler', 'electronic rock', 'electronic rock', 'rock', 'anti-folk', 'athens indie', 'chamber pop', 'post-disco', 'electronic rock', 'pop', 'e6fi', 'folk', 'folk', 'folk', 'indie', 'indie', 'indie', 'indie', 'electronic rock', 'lo-fi', 'neo-psychedelic', 'electronic rock', 'pop', 'pop', 'stomp and holler', 'electronic rock']
MORE TBA	[]
MR LOATHING	[]
MTDF	['house music']
MaMe	[]
Maalva Cruz	[]
Mad Resident	[]
Madnax	['techno', 'house music', 'techno']
Madteo	['dub', 'house music', 'rap', 'disco', 'dub', 'house music', 'dub', 'house music']
Maho	[]
Maickel Esse	[]
Mainfloor	[]
Makam	[]
Make the Girl Dance	['electrofox', 'rock', 'hip hop', 'hip hop', 'electrofox', 'electrofox']
Malente	['breakbeat', 'breakbeat', 'disco', 'techno', 'rock', 'house music', 'techno', 'rap', 'breakbeat', 'breakbeat', 'breakbeat', 'breakbeat']
Malicious Joy	[]
Manaré	['techno', 'house music', 'techno', 'house music', 'techno', 'house music']
Mandar aka Lazare Hoche	[]
Mannheim	['christmas', 'christmas', 'christmas']
Manon	['house music', 'hip hop', 'rap', 'techno', 'techno', 'disco']
Manual  Terminus	[]
Manuel Fischer	[]
Manuel Moreno	[]
Marc DArrigo	['house music', 'house music', 'techno', 'electronica', 'techno']
Marc Houle	['techno', 'techno', 'microhouse', 'techno', 'house music', 'techno', 'disco', 'techno', 'hip hop', 'techno', 'rap', 'techno', 'techno', 'microhouse', 'techno', 'house music', 'techno', 'techno', 'techno', 'microhouse', 'techno', 'house music', 'techno']
Marc Romboy	['disco', 'deep', 'deep', 'techno', 'house music', 'microhouse', 'techno', 'techno', 'house music', 'techno', 'house music', 'rap', 'disco', 'disco', 'deep', 'deep', 'techno', 'house music', 'microhouse', 'techno', 'techno', 'house music', 'techno', 'disco', 'deep', 'deep', 'techno', 'house music', 'microhouse', 'techno', 'techno', 'house music', 'techno']
Marcism	[]
Marco Basso	[]
Marco Capone	[]
Marco Carola	['techno', 'house music', 'techno', 'rap', 'techno', 'techno', 'disco', 'techno', 'house music', 'techno', 'techno', 'house music', 'techno']
Marco Da Mata	[]
Marco Damata	[]
Marco De Rosa	['house music', 'house music', 'rap', 'techno', 'techno', 'house music', 'disco']
Marco Effe	['techno', 'hip hop']
Marco Navarro	[]
Marco Trinkler	[]
Marco Zenker	['dub', 'dub', 'dub']
Marcow	[]
Marcus Intalex	['drum and bass', 'drumfunk', 'jungle', 'drum and bass', 'drum and bass', 'rap', 'disco', 'drum and bass', 'drumfunk', 'jungle', 'drum and bass', 'drum and bass', 'drum and bass', 'drumfunk', 'jungle', 'drum and bass', 'drum and bass']
Marcus Meinhardt	['house music', 'house music', 'house music']
Margaret Dygas	['dub']
Margaret Dygas  underlne  london  UK	[]
Mario Tamasi	['dub']
Mark Faermont	['rap', 'disco']
Mark Henning	['techno', 'techno', 'house music', 'techno', 'techno', 'techno']
Markus Homm & Mihai Popoviciu	['electro music', 'rap', 'house music', 'house music', 'techno', 'house music', 'house music', 'techno', 'house music', 'house music', 'techno', 'house music']
Markus Kenel	['house music', 'rock', 'rap', 'disco', 'house music', 'house music']
Markus Lindner	['disco', 'techno', 'house music', 'techno', 'rap']
Markus Lindner  Cityfox	[]
Markus haZe  save the vynil	[]
Markus haZe BE	[]
Marlon	[]
Marocco	[]
Martelli	['channel pop', 'channel pop', 'channel pop']
Martin Baur Index  Underdog Luzern	[]
Martyn	['rock', 'british folk', 'chamber pop', 'folk', 'folk', 'rock', 'singer-songwriter', 'folk', 'ambient', 'techno', 'uk garage', 'rap', 'techno', 'techno', 'dub', 'disco', 'rock', 'british folk', 'chamber pop', 'folk', 'folk', 'rock', 'singer-songwriter', 'folk', 'rock', 'british folk', 'chamber pop', 'folk', 'folk', 'rock', 'singer-songwriter', 'folk']
Marvin & Guy	['rap']
Masters of Disaster	['schranz', 'schranz', 'schranz']
Mastra	['deep', 'deep', 'deep']
Mathew Square	[]
Mathias Kaden	['techno', 'techno', 'techno', 'house music', 'rap', 'dub', 'disco', 'hip hop', 'techno', 'techno', 'techno', 'house music', 'techno', 'techno', 'techno', 'house music']
Matija	[]
Matrixxman	['house music', 'dub', 'house music', 'rap', 'techno', 'techno', 'disco', 'house music', 'dub', 'house music', 'house music', 'dub', 'house music']
Matt Manik	[]
Matteo Arcucci	['techno', 'house music', 'techno']
Matthew Styles	['disco', 'house music', 'house music', 'rap']
Matthias Tanzmann	['techno', 'microhouse', 'techno', 'techno', 'house music', 'house music', 'disco', 'house music', 'techno', 'rap', 'post-disco', 'techno', 'microhouse', 'techno', 'techno', 'house music', 'techno', 'microhouse', 'techno', 'techno', 'house music']
Mattoo	['rock', 'house music', 'dub', 'techno', 'disco']
Matu	['rock', 'rock', 'rock']
Maty Palc	[]
Mauro Venice	[]
Mauy	[]
Maya Jane Coles  hypercolour  mobilee  London	[]
Meienberg	[]
Meikel	['rap', 'techno', 'techno']
Mekas0	[]
Memoria  Belgium	[]
Mental Groove	[]
Mercury	['rock', 'house music', 'house music', 'rock', 'rap', 'disco', 'rock', 'rock']
Merz Feat Julian Sartorius	[]
Mescene	[]
Messiah	['reggaeton flow', 'reggaeton flow', 'reggaeton flow']
Meta Marie Louise	[]
Mia Kaltes	[]
Miajica	['rap', 'disco']
Michael Canzian	[]
Michael Schwarz	['techno', 'rap', 'techno', 'techno', 'disco', 'techno', 'techno']
Michael T fresh  0800 till end	[]
Mick Wills	['house music', 'techno', 'techno', 'disco']
Mickey Morris	[]
Miguel	['pop', 'deep pop r&b', 'hip hop', 'hip hop', 'r&b', 'pop', 'pop', 'r&b', 'rap', 'hip hop', 'trap', 'urban contemporary', 'disco', 'house music', 'rap', 'pop', 'deep pop r&b', 'hip hop', 'hip hop', 'r&b', 'pop', 'pop', 'r&b', 'rap', 'hip hop', 'trap', 'urban contemporary', 'pop', 'deep pop r&b', 'hip hop', 'hip hop', 'r&b', 'pop', 'pop', 'r&b', 'rap', 'hip hop', 'trap', 'urban contemporary']
Mihael Simic	[]
Mik Maroo	[]
Mike Machine	[]
Mike Shannon  CYNOSURE	[]
Mike Shannon  cynosure  valencia  ES	[]
Mike Teixeira	[]
Mike Teixeira bern	[]
Mike Vamp	[]
Mike VÃ¤th  Audionatica  Dreksler & Haerle  Dub Tales	[]
Mike Väth  Audionatica  Dreksler & Haerle  Dub Tales	[]
Mikee	['house music', 'drum and bass']
Milk Klub resident  Geneva	[]
Milo Häfliger	[]
Min	['pop', 'k-pop', 'pop', 'pop', 'k-pop', 'pop', 'pop', 'k-pop', 'pop']
Minidetail	[]
Mio Martini	['disco', 'rap']
Mira	['classical', 'rap', 'hip hop', 'techno', 'techno', 'disco', 'classical', 'classical']
Mirco Esposito	[]
Mirco Mendosta	[]
Mirk Oh	[]
Mirko Loko	['techno', 'techno', 'techno']
Mirkovich  minimouse Rec NE	[]
Miskate  unfound  usa	[]
Mismo Konzum  Hive  Minirampe  ZH	[]
Miss Fitz  circus company  israel	[]
Mistakes Music	[]
Mit dabei sind die talentierten Locals Francesco Parla	[]
Mobilee	[]
Mobylette	[]
Modeselektor	['electronic rock', 'electronic', 'electronic rock', 'microhouse', 'techno', 'electronic rock', 'downtempo', 'jungle', 'house music', 'house music', 'uk garage', 'hip hop', 'hip hop', 'rap', 'hip hop', 'techno', 'techno', 'uk garage', 'dub', 'disco', 'electronic rock', 'electronic', 'electronic rock', 'microhouse', 'techno', 'electronic rock', 'downtempo', 'electronic rock', 'electronic', 'electronic rock', 'microhouse', 'techno', 'electronic rock', 'downtempo']
Modular Club	[]
MoirÃ©	[]
Moiré	[]
Moldavius	[]
Monika Kruse	['house music', 'deep', 'techno', 'techno', 'house music', 'techno', 'house music', 'house music', 'hip hop', 'hip hop', 'rap', 'hip hop', 'techno', 'techno', 'disco', 'house music', 'deep', 'techno', 'techno', 'house music', 'techno', 'house music', 'deep', 'techno', 'techno', 'house music', 'techno']
Monoloc	['dub', 'techno', 'techno', 'house music', 'rock', 'hip hop', 'techno', 'techno', 'dub', 'techno', 'techno', 'dub', 'techno', 'techno']
Moon	['folk-pop', 'pop', 'indie', 'electronic rock', 'neo mellow', 'pop', 'pop', 'pop', 'house music', 'disco', 'house music', 'techno', 'rap', 'folk-pop', 'pop', 'indie', 'electronic rock', 'neo mellow', 'pop', 'pop', 'pop', 'folk-pop', 'pop', 'indie', 'electronic rock', 'neo mellow', 'pop', 'pop', 'pop']
Morb	[]
Moscoman	['house music', 'house music', 'house music']
Mother	['canadian indie', 'indie', 'indie', 'indie', 'canadian indie', 'indie', 'indie', 'indie', 'canadian indie', 'indie', 'indie', 'indie']
Motoguzzi	[]
Mr Scruff	['downtempo', 'breakbeat', 'breakbeat', 'house music', 'downtempo', 'electro music', 'electronic', 'ninja', 'nu jazz', 'downtempo', 'turntablism', 'hip hop', 'hip hop', 'hip hop', 'techno', 'techno', 'downtempo', 'breakbeat', 'breakbeat', 'house music', 'downtempo', 'electro music', 'electronic', 'ninja', 'nu jazz', 'downtempo', 'turntablism', 'downtempo', 'breakbeat', 'breakbeat', 'house music', 'downtempo', 'electro music', 'electronic', 'ninja', 'nu jazz', 'downtempo', 'turntablism']
Mr Thing	['scratch', 'scratch', 'scratch']
Mubarek	[]
Mucho Stylez	['rap', 'techno', 'techno', 'disco']
Multitask	[]
Murciano	['rap', 'house music', 'house music', 'techno', 'disco', 'electronica']
My My	['emo', 'pop punk', 'post-grunge', 'punk', 'rap', 'techno', 'house music', 'techno', 'disco', 'techno', 'hip hop', 'emo', 'pop punk', 'post-grunge', 'punk', 'emo', 'pop punk', 'post-grunge', 'punk']
MyNightlifeFM FLOOR	[]
MÃ¶we	['house music', 'deep', 'house music', 'house music', 'deep', 'house music', 'house music', 'deep', 'house music']
Möwe	['house music', 'deep', 'house music', 'house music', 'deep', 'house music', 'house music', 'deep', 'house music']
München	[]
NADER  Party Garantie ZÃ¼rich	[]
NADER  Party Garantie Zürich	[]
NED O NEAL	[]
NEMO	['neo-progressive', 'progressive', 'rock', 'neo-progressive', 'progressive', 'rock', 'neo-progressive', 'progressive', 'rock']
NEWCOM B2B Guyus	[]
NICO MASSA	[]
NUKEM	['rock', 'house music', 'disco']
Na Noon	[]
Nader	['rap', 'techno', 'idm', 'techno', 'disco']
Nadja Stoller	[]
Nahste Oner	[]
Nakadia	['techno']
Naked lunch Bosphorus	[]
Namito	['techno', 'house music', 'techno', 'house music', 'techno', 'house music']
Naomi Bowler	[]
Ned ONeal	[]
Neferiel	[]
Nekow	['disco']
Nelson De Jesus	[]
Nemo  All Night Long	[]
Nemo and Friends	[]
Nenad J	[]
Neo Mds	[]
Neto	['regional mexican pop', 'regional mexican pop', 'regional mexican pop']
Neverdogs	['jungle', 'house music', 'rock', 'rap', 'techno', 'dub', 'disco']
Newfact Music	[]
Niall Redmond	['hip hop', 'rap', 'dub', 'disco']
Nice Nine	[]
Nici Faerber	['hip hop']
Nick Nasty	['disco', 'house music', 'house music', 'rap', 'house music']
Nick Nasty bern	[]
Nico Lahs	['disco', 'deep', 'techno', 'disco', 'rap', 'disco', 'deep', 'techno', 'disco', 'deep', 'techno']
Nico Stojan bar25 berlin	[]
Nico Sun	[]
Nicola Kazimir	['rap', 'disco']
Nicola Koch	['house music', 'techno', 'hip hop', 'house music', 'techno', 'hip hop']
Nicolaj	[]
Nicolas Duvoisin	['disco', 'rap']
Nik	['rock', 'rock', 'europop', 'new romantic', 'new', 'new', 'rock', 'electronic rock', 'rock', 'rock', 'europop', 'new romantic', 'new', 'new', 'rock', 'electronic rock', 'rock', 'rock', 'europop', 'new romantic', 'new', 'new', 'rock', 'electronic rock']
Nik Frankenberg	[]
Niko Schwind	['house music', 'deep', 'deep', 'rap', 'techno', 'house music', 'techno', 'disco', 'house music', 'deep', 'deep', 'house music', 'deep', 'deep']
Nikola Kotevski	[]
Nikola Kotevski& Patrick Podage	[]
Nils Fraser	[]
Nima Gorji	['techno', 'rap', 'techno', 'house music', 'techno', 'disco', 'techno', 'techno']
Nimmersatt	[]
Nixon & Blackbird	[]
Noir Music	[]
Noir MusicOslo	[]
Nole	[]
Nolé	[]
NonSenseCorporation aka Mikall Svender & Alan Lector	[]
Norbertto	[]
Nordstern	[]
NoÃ© Weigl	[]
Noé Weigl	[]
Nukem	['rock', 'house music', 'disco']
OCTOBER RUST	[]
ORGANIC STUFF	[]
OSI	['jazz metal', 'neo-progressive', 'progressive', 'progressive', 'jazz metal', 'neo-progressive', 'progressive', 'progressive', 'jazz metal', 'neo-progressive', 'progressive', 'progressive']
Oase & Sainte Harare aka Foupoudav	[]
Ohm 10	[]
Ohm10	[]
Oliver Aden & Luis Cruz	[]
Oliver K	['re:techno', 'hip hop', 'house music', 'techno', 'hip hop', 'hip hop', 're:techno', 're:techno']
Oliver Koletzki	['house music', 'deep', 'techno', 'microhouse', 'techno', 'house music', 'house music', 'rap', 'techno', 'house music', 'techno', 'disco', 'electronica', 'techno', 'house music', 'deep', 'techno', 'microhouse', 'techno', 'house music', 'house music', 'house music', 'deep', 'techno', 'microhouse', 'techno', 'house music', 'house music']
Oliver van der Miescher	[]
Omar	['reggaeton', 'tropical', 'reggaeton', 'tropical', 'reggaeton', 'tropical']
Ona rec	[]
Ongaku	[]
Opuswerk	['techno', 'disco', 'dub', 'drum and bass', 'techno', 'rap', 'techno', 'techno']
Opuswerk  techno prÃ©natale	[]
Opuswerk  techno prénatale	[]
Oram Modular	[]
Oscar Niczzo	[]
Ostwind	[]
Osymyso	['mashup', 'mashup', 'mashup']
Otist Riddim	[]
Ovski	[]
Ovum	[]
Oxia	['house music', 'deep', 'microhouse', 'techno', 'techno', 'house music', 'techno', 'rap', 'techno', 'house music', 'techno', 'disco', 'downtempo', 'hip hop', 'house music', 'deep', 'microhouse', 'techno', 'techno', 'house music', 'techno', 'house music', 'deep', 'microhouse', 'techno', 'techno', 'house music', 'techno']
Oxide and Neutrino	['uk garage', 'uk garage', 'uk garage', 'uk garage', 'uk garage', 'uk garage', 'uk garage', 'uk garage', 'uk garage']
PASCAL TOKAR	[]
PASCI zÃ¼ri	[]
PASCI züri	[]
PAT A  PROVINZMUSIK	[]
PBell	[]
PETER SZANTO  mischkultur	[]
PK Squared	[]
PLASTIC FM	[]
PRISMA live biel	[]
PRIVARFESTLI	[]
PROJEKTIL VISUAL EFFECTS	[]
PROJEKTIL Visuals	[]
PTess	[]
Pablo Anastasia	[]
Pablo Einzig	['techno', 'techno']
Pablo Einzig & Nici Faerber	['rap']
Paco Osuna	['techno', 'techno', 'house music', 'techno', 'disco', 'techno', 'techno', 'rap', 'techno', 'techno', 'house music', 'techno', 'techno', 'techno', 'house music', 'techno']
PajÃ¶rn  2Takt	[]
Pajörn  2Takt	[]
PanPot	[]
Pandour	[]
Panorama Bar	[]
Panoramabar  Berlin	[]
Paolo Trovato	[]
Paraklang	[]
Paris	['uk garage', 'drum and bass', 'uk garage', 'uk garage', 'edm', 'house music', 'uk garage', 'vapor twitch', 'zapstep', 'uk garage', 'drum and bass', 'uk garage', 'uk garage', 'edm', 'house music', 'uk garage', 'vapor twitch', 'zapstep', 'uk garage', 'drum and bass', 'uk garage', 'uk garage', 'edm', 'house music', 'uk garage', 'vapor twitch', 'zapstep']
Pascal Inc	[]
Pascal Tokar	[]
Pasci	[]
Passion2Elements	[]
Paste 20	[]
Patife	[]
Patrick Podage	['groove room', 'disco', 'groove room', 'groove room']
Patrick Podage & Nikola Kotevski	['rap']
Paul C & Paolo Martini	['rap']
Paul Eg	['house music', 'techno', 'techno', 'disco']
Paul Lomax  Deepflight Ibiza	[]
Paul Mad	['techno']
Pawlikowski	['classic polish pop', 'classic polish pop', 'classic polish pop']
Pazkal	['house music', 'house music', 'hip hop', 'rap', 'techno', 'techno']
Peak	[]
Pender Street Steppers	[]
Perc	['dub', 'techno', 'rap', 'techno', 'techno', 'disco', 'dub', 'techno', 'dub', 'techno']
Performances by Life is a Bitch Crew	[]
Peter D	['rap', 'techno', 'techno', 'disco', 'hip hop']
Peter Szanto	[]
Petitjean	[]
Phantom Project	[]
Phantom Project l Minimal	[]
Phil Cole	['rap', 'disco']
Phil Garner	['house music', 'house music', 'rock', 'techno', 'techno']
Phil Garner What Else	[]
Phil Riss & Ali C	[]
Philipp Weibel	[]
Phrex	[]
Physical	[]
Pig & Dan	['house music', 'house music', 'microhouse', 'techno', 'techno', 'house music', 'techno', 'house music', 'house music', 'microhouse', 'techno', 'techno', 'house music', 'techno', 'house music', 'house music', 'microhouse', 'techno', 'techno', 'house music', 'techno']
Pikaya	['disco', 'house music', 'dub', 'downtempo', 'techno', 'rock', 'hip hop', 'house music', 'techno', 'hip hop', 'rap', 'electronica']
Pilocka Krach	['rap', 'disco']
Pinch	['uk garage', 'dub']
Piratenkind	[]
Pisa	[]
PistolPete	['hip hop', 'hip hop', 'rap', 'hip hop', 'disco']
Pièrick	[]
Plastikman	['house music', 'techno', 'techno', 'techno', 'electronic', 'idm', 'intelligent dance music', 'microhouse', 'techno', 'house music', 'techno', 'house music', 'techno', 'techno', 'techno', 'electronic', 'idm', 'intelligent dance music', 'microhouse', 'techno', 'house music', 'techno', 'house music', 'techno', 'techno', 'techno', 'electronic', 'idm', 'intelligent dance music', 'microhouse', 'techno', 'house music', 'techno']
Play it Loud	[]
Playlove	['jungle', 'house music', 'hip hop', 'rock', 'downtempo', 'techno', 'techno']
Pleasurekraft	['disco', 'deep', 'deep', 'techno', 'house music', 'techno', 'house music', 'rap', 'techno', 'techno', 'disco', 'disco', 'deep', 'deep', 'techno', 'house music', 'techno', 'house music', 'disco', 'deep', 'deep', 'techno', 'house music', 'techno', 'house music']
Plus many more TBC	[]
Pochatz	[]
Pointillisme Musique	[]
Pokerflat	[]
Pokerphl	[]
Princess P	[]
Profondo	[]
Progamode	[]
Progressiv minimal minimalhouse Techhouse	[]
Proudly People	['rap', 'techno', 'house music', 'techno']
Putah Wild	[]
PÃºrpura	[]
Púrpura	[]
Question & Exclamaton Mark	[]
Quitim	[]
RAOUL murg	[]
RATIO  AMSTERDAM	[]
RICHARD HECTORJONES	[]
RINA LOU	[]
RINO	['rap', 'dirty', 'rap', 'rap', 'dirty', 'rap', 'rap', 'dirty', 'rap']
RINO  Cityfox ZÃ¼rich	[]
RINO  Cityfox Zürich	[]
RINO cityfox züri	[]
RINO zÃ¼ri	[]
RINO züri	[]
ROB BRIGHT	['electro jazz', 'electro jazz', 'electro jazz']
ROGER M	[]
ROLF IMHOF	[]
Racker	[]
Radi Tabasco	[]
Raf Daddy	[]
Ragaz Inc	[]
Ralf 10100	[]
Ralph Good	['techno', 'disco', 'rock', 'house music', 'rap', 'techno', 'techno']
Ramon Tapia	['house music', 'techno', 'rock', 'techno', 'hip hop', 'house music', 'house music']
Raphael Raban	[]
Raphaello	[]
Rapu	[]
Rapu & Nekow	[]
Raw Operators	[]
ReUP	[]
ReYou	['disco', 'deep', 'disco', 'deep', 'disco', 'deep']
Reben	[]
Rekids  Berlin	[]
Reloading	[]
Renato Broccini	['idm']
Rene Bourgeois	['house music', 'rap', 'disco', 'house music', 'house music']
Rene S	[]
Rennie RÃ¸yma	[]
Rennie Røyma	[]
Resident  De La Porter  Skorpionkinder Records  Cube Resident	[]
Reto Ardour	['house music', 'techno', 'techno']
Retrocyclique	[]
Return	['acoustic pop', 'pop', 'pop', 'folk', 'indie', 'indie', 'indie', 'neo mellow', 'pop', 'stomp and holler', 'stomp', 'house music', 'techno', 'house music', 'techno', 'hip hop', 'hip hop', 'acoustic pop', 'pop', 'pop', 'folk', 'indie', 'indie', 'indie', 'neo mellow', 'pop', 'stomp and holler', 'stomp', 'acoustic pop', 'pop', 'pop', 'folk', 'indie', 'indie', 'indie', 'neo mellow', 'pop', 'stomp and holler', 'stomp']
Return b2b Patrischa	[]
Rich Braker	[]
Richard Dorfmeister	['downtempo', 'nu jazz', 'downtempo', 'disco', 'trance music', 'house music', 'house music', 'rap', 'downtempo', 'nu jazz', 'downtempo', 'downtempo', 'nu jazz', 'downtempo']
Richard Earnshaw	['house music', 'disco', 'house music', 'house music', 'disco', 'house music', 'house music', 'disco', 'house music']
Richi Spielmann	[]
Rico Loco	[]
Rico Rausch	[]
Rino	['rap', 'dirty', 'rap', 'rap', 'dirty', 'rap', 'rap', 'dirty', 'rap']
Riot School	[]
River Ist Böse	[]
River ist Böse	[]
River ist böse	[]
Rob Birch	[]
Robbie	['boy band', 'pop', 'europop', 'neo mellow', 'pop', 'pop', 'boy band', 'pop', 'europop', 'neo mellow', 'pop', 'pop', 'boy band', 'pop', 'europop', 'neo mellow', 'pop', 'pop']
Robel	[]
Robert Babicz	['disco', 'deep', 'deep', 'techno', 'microhouse', 'techno', 'techno', 'house music', 'techno', 'hip hop', 'rock', 'rap', 'techno', 'techno', 'techno', 'disco', 'deep', 'deep', 'techno', 'microhouse', 'techno', 'techno', 'house music', 'techno', 'disco', 'deep', 'deep', 'techno', 'microhouse', 'techno', 'techno', 'house music', 'techno']
Robert Dietz	['techno', 'techno', 'house music', 'hip hop', 'rap', 'hip hop', 'techno', 'drum and bass', 'techno', 'disco', 'techno', 'techno', 'techno', 'techno']
Robert Johnson	['acoustic blues', 'blues', 'blues', 'blues', 'rock', 'blues', 'blues', 'blues', 'blues', 'blues', 'blues', 'blues', 'rock', 'soul', 'soul', 'blues', 'blues', 'acoustic blues', 'blues', 'blues', 'blues', 'rock', 'blues', 'blues', 'blues', 'blues', 'blues', 'blues', 'blues', 'rock', 'soul', 'soul', 'blues', 'blues', 'acoustic blues', 'blues', 'blues', 'blues', 'rock', 'blues', 'blues', 'blues', 'blues', 'blues', 'blues', 'blues', 'rock', 'soul', 'soul', 'blues', 'blues']
Robert Owens	['house music', 'house music', 'house music', 'house music', 'house music', 'house music', 'house music', 'house music', 'house music', 'house music', 'house music', 'house music']
Robin Schulz	['house music', 'edm', 'pop', 'house music', 'house music', 'house music', 'rap', 'techno', 'house music', 'house music', 'edm', 'pop', 'house music', 'house music', 'edm', 'pop', 'house music']
Robin Sukroso	['techno']
Rodri  audiotheque  bern	[]
Rodriguez Jr	['disco', 'deep', 'deep', 'house music', 'microhouse', 'techno', 'techno', 'house music', 'rap', 'techno', 'house music', 'techno', 'disco', 'hip hop', 'electronica', 'disco', 'deep', 'deep', 'house music', 'microhouse', 'techno', 'techno', 'house music', 'disco', 'deep', 'deep', 'house music', 'microhouse', 'techno', 'techno', 'house music']
Rogi	[]
Rolf Imhof	[]
Rollende Beats	[]
Roman Klinger	[]
Romano Alfieri	['rap', 'techno', 'house music', 'techno', 'disco']
Romano Rapeso	['techno', 'techno']
Romano Rapeso Teknologik Rec	[]
Romeo	['bachata', 'tropical', 'house music', 'house music', 'disco', 'bachata', 'tropical', 'bachata', 'tropical']
Ron Morelli	['mandible', 'house music', 'mandible', 'house music', 'mandible', 'house music']
Ronald Grauer	[]
Ronny Vergara	['rap', 'techno', 'trap', 'techno', 'disco']
Ross Allan	[]
Rotkeller	['rap', 'disco']
Rotterdam	[]
Round Table Knights	['rap', 'house music', 'house music', 'disco', 'hip hop', 'hip hop']
RoyGreen & Protone	[]
Rozzo	['techno', 'techno', 'techno']
Rumlaut	[]
Rusconi	[]
Ryan Crosson	['techno', 'house music', 'hip hop', 'rap', 'trap', 'hip hop', 'techno', 'electronica', 'techno', 'disco', 'techno', 'techno']
Ryan K	[]
Rynecologist	['techno', 'techno', 'techno']
RÃ¦ve	['house music', 'house music', 'house music', 'house music', 'house music', 'house music']
RÃ¸dhÃ¥d	['techno', 'dub', 'techno', 'techno', 'techno', 'dub', 'techno', 'techno', 'techno', 'dub', 'techno', 'techno']
Ræve	['house music', 'house music', 'house music', 'house music', 'house music', 'house music']
Rødhåd	['techno', 'dub', 'techno', 'techno', 'techno', 'dub', 'techno', 'techno', 'techno', 'dub', 'techno', 'techno']
S A M & Malin GÃ©nie	[]
S A M & Malin Génie	[]
SBTRKT	['electronic rock', 'post-disco', 'deep indie r&b', 'electronic', 'escape room', 'uk garage', 'indie', 'electronic rock', 'electronic rock', 'house music', 'uk garage', 'electronic rock', 'post-disco', 'deep indie r&b', 'electronic', 'escape room', 'uk garage', 'indie', 'electronic rock', 'electronic rock', 'house music', 'uk garage', 'electronic rock', 'post-disco', 'deep indie r&b', 'electronic', 'escape room', 'uk garage', 'indie', 'electronic rock', 'electronic rock', 'house music', 'uk garage']
SCHEINIZZL	['house music', 'house music', 'house music']
SCNTST	['techno', 'techno', 'techno']
SCP Dance Project	[]
SENOMA	[]
SHABBA luzern	[]
SKay	[]
SO  Private Sams  Ohm10	[]
SOLOK	[]
Sadar Bahar	[]
Safari & Zielony	['rap', 'techno', 'techno']
Sampayo	[]
Samsara	['neo-psychedelic', 'psychedelic', 'retro metal', 'electronic rock', 'metal', 'stoner', 'neo-psychedelic', 'psychedelic', 'retro metal', 'electronic rock', 'metal', 'stoner', 'neo-psychedelic', 'psychedelic', 'retro metal', 'electronic rock', 'metal', 'stoner']
Samstag 07042012	[]
Samuel Gfeller	[]
Samuele Angelo	[]
Samy Boulbrima	[]
San Marco	['deep orchestral', 'deep orchestral', 'deep orchestral']
San Proper	['techno', 'house music', 'techno']
Sandro Kuhne	[]
Sandro Kuhne Official	[]
Sandro KÃ¼hne	[]
Sandro Kühne	[]
Santacruz	['banda', 'deep regional mexican', 'norteno', 'regional', 'regional', 'house music', 'house music', 'rap', 'techno', 'disco', 'banda', 'deep regional mexican', 'norteno', 'regional', 'regional', 'banda', 'deep regional mexican', 'norteno', 'regional', 'regional']
Santis	['rap', 'techno', 'techno', 'hip hop']
Santoro & Blair	[]
Sarah Main  Jade residents	[]
Sascha Braemer	['house music', 'deep', 'techno', 'house music', 'house music', 'house music', 'deep', 'techno', 'house music', 'house music', 'house music', 'deep', 'techno', 'house music', 'house music']
Sascha Cawa	['house music', 'rap', 'disco', 'house music', 'house music']
Sascha Dive	['techno', 'house music', 'disco', 'house music', 'dub', 'techno', 'rock', 'hip hop', 'house music', 'techno', 'techno', 'hip hop', 'rap', 'techno', 'techno']
Sascha Stohler	[]
Sassy J	['fake', 'fake', 'fake']
Saul & Murphy	[]
Saxo	['romantico', 'romantico', 'romantico']
Schiffsbauch	[]
Schnauz & Brot	['rap', 'hip hop', 'video game music']
Scum	['horrorcore', 'horrorcore', 'horrorcore']
Seb Blake	['disco']
Seb Zito	['rap', 'techno', 'house music', 'techno', 'disco']
Sebastien C	[]
Sebo K	['techno', 'techno', 'techno', 'house music', 'rap', 'breakbeat', 'disco', 'techno', 'techno', 'techno', 'house music', 'techno', 'techno', 'techno', 'house music']
Sepp	['rap', 'disco']
Serafin cadenza zürich	[]
Sergio Jimenez	[]
Sergio Mesa	[]
Sergio Trillini	[]
Serioes & Legendaer	[]
Sese	[]
Seth Troxler	['disco', 'microhouse', 'techno', 'techno', 'house music', 'hip hop', 'disco', 'microhouse', 'techno', 'techno', 'house music', 'disco', 'microhouse', 'techno', 'techno', 'house music']
Several Definitions	['house music', 'rap', 'disco', 'house music', 'house music']
Sexomodular live	[]
Shaf Raisi	[]
Shaka	['banda', 'grupera', 'norteno', 'regional mexican', 'regional', 'house music', 'techno', 'rap', 'hip hop', 'techno', 'techno', 'disco', 'banda', 'grupera', 'norteno', 'regional mexican', 'regional', 'banda', 'grupera', 'norteno', 'regional mexican', 'regional']
Shaun Reeves	['rap', 'techno', 'house music', 'techno', 'disco', 'techno', 'hip hop']
She DJ Kaylee	[]
Shed	['britpop', 'madchester', 'britpop', 'madchester', 'britpop', 'madchester']
Silky Raven	[]
Silo Disko	[]
Simi3001	[]
Simian	['electronic rock', 'electronic rock', 'electronic rock', 'electronic rock', 'electronic rock', 'electronic rock', 'electronic rock', 'electronic rock', 'electronic rock', 'electronic rock', 'electronic rock', 'electronic rock']
Simon Lemont	[]
Simon Stokes	['house music', 'rap', 'techno', 'techno', 'disco']
Sinden	['house music', 'jungle', 'house music', 'house music', 'hip hop', 'rap', 'techno', 'techno', 'disco', 'house music', 'house music']
Sinner DC	['rap', 'rock', 'techno', 'techno', 'disco', 'electronica']
Sirion	['progressive psytrance', 'progressive psytrance', 'progressive psytrance']
Skail Master M	['rap', 'techno', 'house music', 'techno', 'disco']
Skankin Lion Tribe	[]
Skaos	['euroska', 'ska', 'ska', 'euroska', 'ska', 'ska', 'euroska', 'ska', 'ska']
Skinnerbox	['ska punk', 'ska', 'rap', 'techno', 'techno', 'disco', 'hip hop', 'ska punk', 'ska', 'ska punk', 'ska']
Slam	['house music', 'house music', 'techno', 'techno', 'house music', 'techno', 'rap', 'techno', 'techno', 'house music', 'house music', 'techno', 'techno', 'house music', 'techno', 'house music', 'house music', 'techno', 'techno', 'house music', 'techno']
Slou & Sam Pharell  MM rec	[]
Smalltown Collective  Miguel	[]
Smirre	[]
So Solid Crew	['uk garage', 'uk garage', 'uk garage']
SoivÃ©	[]
Soivé	[]
Solomun	['disco', 'deep', 'deep', 'techno', 'house music', 'microhouse', 'techno', 'house music', 'house music', 'disco', 'deep', 'deep', 'techno', 'house music', 'microhouse', 'techno', 'house music', 'house music', 'disco', 'deep', 'deep', 'techno', 'house music', 'microhouse', 'techno', 'house music', 'house music']
Someone Else	['techno', 'electronic rock', 'house music', 'disco', 'techno', 'rock', 'house music', 'techno', 'techno', 'rap', 'techno', 'techno']
Somnambulance	[]
Sonja Moonear	[]
Sonja Moonear  karat  switzerland	[]
Sonntag 08042012	[]
Sonny Dima	[]
Soukie & Windish	['house music', 'deep', 'house music', 'deep', 'house music', 'deep']
Soulstar Syndicate	[]
Soult	[]
Souvenir Music	[]
Soweto	['world', 'world', 'world']
Specimen	['electronic rock', 'rock', 'electronic rock', 'rock', 'electronic rock', 'rock']
Spencer Parker	['techno', 'disco', 'techno', 'house music', 'techno', 'techno', 'techno']
Spoony Talker	['house music', 'deep', 'house music', 'deep', 'house music', 'deep']
Spor	[]
Squep	['house music', 'house music', 'techno', 'techno']
Squirrel	['jazz christmas', 'swing', 'jazz christmas', 'swing', 'jazz christmas', 'swing']
Stacey Pullen	['techno', 'house music', 'techno', 'house music', 'hip hop', 'techno', 'house music', 'breakbeat', 'techno', 'hip hop', 'hip hop', 'techno', 'house music', 'techno', 'techno', 'house music', 'techno']
Stadtpark	[]
Stadtpark Wien	[]
Stasis Recordings	[]
Stefan Biniak	[]
Stefan Nolic	[]
Stefano Tropeano	['techno', 'techno', 'techno']
Steffen Sonnenschein	['rap', 'disco']
Steffi	['rock', 'rap', 'hip hop', 'disco']
Stephane Jusserand Alfonso Reyes	[]
Stephane Lando	['house music', 'house music', 'hip hop', 'hip hop', 'techno', 'disco']
Stereo tension	[]
Steve Cole	['smooth jazz', 'rap', 'rock', 'techno', 'house music', 'dub', 'techno', 'disco', 'smooth jazz', 'smooth jazz']
Steve Taylor	['christian metal', 'christian', 'house music', 'house music', 'rap', 'christian metal', 'christian', 'christian metal', 'christian']
Steven Stone	[]
Steven Wallace	[]
Stevie Ray Monkey Jam  Cube	[]
Stil & Taktvoll	[]
Stil vor Talent Hamburg	[]
Stil vor TalentBerlin	[]
Stil&Taktvoll	[]
Strassenmajor	[]
Strb	[]
Strobetech	[]
Strotter Inst & Flo Kaufmann	[]
Studer TM l Freistil	[]
Styro2000	[]
Sub Bros	[]
Subban	[]
Suddenly Neighbours	[]
Sulux	[]
Sundance	[]
Suol	[]
Super Flu	['disco', 'deep', 'deep', 'house music', 'microhouse', 'techno', 'techno', 'house music', 'house music', 'disco', 'deep', 'deep', 'house music', 'microhouse', 'techno', 'techno', 'house music', 'house music', 'disco', 'deep', 'deep', 'house music', 'microhouse', 'techno', 'techno', 'house music', 'house music']
Superdisco	[]
Supermarket	[]
Supernature  Barcelona	[]
Support DJs	[]
Support Princess P & JSanders	[]
Support Squep	[]
Supsect One	[]
Suspect One	[]
Sven The Freak	[]
Sven VÃ¤th	['techno', 'techno', 'techno', 'house music', 'techno', 'techno', 'techno', 'techno', 'house music', 'techno', 'techno', 'techno', 'techno', 'house music', 'techno']
Sven Väth	['techno', 'techno', 'techno', 'house music', 'techno', 'techno', 'techno', 'techno', 'house music', 'techno', 'techno', 'techno', 'techno', 'house music', 'techno']
Sven Wegner	['rap', 'house music', 'disco']
Sven Weisemann	['techno', 'house music', 'house music', 'techno', 'techno']
SwamThing	[]
Symbiostic	[]
Symoh Sares	[]
Syntec	['ebm', 'industrial music', 'electronic rock', 'disco', 'techno', 'techno', 'rap', 'ebm', 'industrial music', 'electronic rock', 'ebm', 'industrial music', 'electronic rock']
Sébastien Léger	[]
Sören Klanken	[]
T0DO	[]
TBA	['techno']
THE KOLETZKIS LIVE	[]
THE NUDGE AND MC KWASI	[]
TITTO LA ROCKA	[]
TOM WINEGARD plasurelap biel	[]
TON IN TON	[]
TSHEPITO	[]
Taborka	[]
Tadeo Doberska	['house music']
Tadeo Doberska bern	[]
Tagedeep	[]
TagtrÃ¤umerÂ²	[]
Tagträumer²	[]
Tale Of Us	['disco', 'deep', 'house music', 'microhouse', 'techno', 'techno', 'house music', 'techno', 'rock', 'techno', 'house music', 'techno', 'disco', 'disco', 'deep', 'house music', 'microhouse', 'techno', 'techno', 'house music', 'techno', 'disco', 'deep', 'house music', 'microhouse', 'techno', 'techno', 'house music', 'techno']
Tanzstube mit Mad Katz Techno	[]
Tanzstube mit Schwerelos	[]
Tanzsubstanz	[]
Tarik	['rap', 'hip hop', 'rock', 'hip hop', 'disco', 'rap', 'rap']
Task Horizon	['drum and bass', 'drum and bass', 'drum and bass']
Tech House	[]
Techhouse	[]
Techrifice	[]
Tectonic  Berlin	[]
Tee Moe	[]
Tension Festival	[]
Terzini Bros	[]
Terzini Bros  0500 till 0800	[]
Terzini Bros  Perkussiv & positive music Sebian	[]
The Advent	['techno', 'schranz', 'techno', 'hip hop', 'hip hop', 'techno', 'techno', 'techno', 'schranz', 'techno', 'techno', 'schranz', 'techno']
The Bassment	[]
The Bees	['britpop', 'britpop', 'britpop']
The CSC	[]
The Checkup	['house music', 'house music', 'rock']
The Cruzaders	['rock', 'rap', 'disco']
The Knife	['electronic rock', 'chamber pop', 'electronic rock', 'electronic rock', 'electronic', 'escape room', 'indie r&b', 'electronic rock', 'electronic rock', 'electronic rock', 'electronic rock', 'downtempo', 'house music', 'rap', 'techno', 'techno', 'disco', 'electronic rock', 'chamber pop', 'electronic rock', 'electronic rock', 'electronic', 'escape room', 'indie r&b', 'electronic rock', 'electronic rock', 'electronic rock', 'electronic rock', 'downtempo', 'electronic rock', 'chamber pop', 'electronic rock', 'electronic rock', 'electronic', 'escape room', 'indie r&b', 'electronic rock', 'electronic rock', 'electronic rock', 'electronic rock', 'downtempo']
The Martinez Brothers	['disco', 'house music', 'techno', 'techno', 'house music', 'disco', 'house music', 'techno', 'techno', 'house music', 'disco', 'house music', 'techno', 'techno', 'house music']
The Nextmen	['breakbeat', 'turntablism', 'breakbeat', 'turntablism', 'breakbeat', 'turntablism']
The Oh Nos	['chicago indie', 'chicago indie', 'chicago indie']
The Parallax	['electro', 'electro', 'electro']
The Phat Crew	['electro trash', 'electro trash', 'electro trash']
Thereal Demonti aka Samy Demonti	[]
Thom Nagy	[]
Thomas Melchior	[]
Thomas Zopf	[]
Thugfucker	['disco', 'rap', 'disco', 'hip hop', 'disco', 'disco']
Tigerskin	['house music', 'techno', 'techno', 'techno', 'house music', 'house music', 'techno', 'techno', 'techno', 'house music', 'house music', 'techno', 'techno', 'techno', 'house music']
Till von Sein	['techno', 'rap', 'techno', 'house music', 'dub', 'techno', 'disco', 'hip hop', 'techno', 'techno']
Tim & Puma Mimi	['rap']
Tim Engelhardt	['house music', 'house music', 'house music']
Tim Xavier	['hip hop']
Timnah Sommerfeldt	[]
Timo Maas	['breakbeat', 'breakbeat', 'electronic', 'house music', 'rap', 'disco', 'breakbeat', 'breakbeat', 'electronic', 'breakbeat', 'breakbeat', 'electronic']
Timoteo	['brega', 'sertanejo tradicional', 'velha guarda', 'brega', 'sertanejo tradicional', 'velha guarda', 'brega', 'sertanejo tradicional', 'velha guarda']
Timoteo & Fabri	['rap']
Tini	['house music', 'house music', 'hip hop', 'hip hop', 'rap', 'hip hop', 'techno', 'techno']
Tino Kaufholz	[]
Tino Kaufholz b2b Benjamin	[]
Tobi Neumann	['house music']
Toffee	['uk garage', 'substep', 'uk garage', 'substep', 'uk garage', 'substep']
Tom Bombadil	[]
Tom Burclay	['house music', 'disco', 'house music', 'breakbeat', 'house music', 'techno', 'hip hop']
Tom Nightowl Subtunes	[]
Tom Sun	[]
Tom Wineman	[]
Tommy Four Seven	['dub', 'schranz', 'rap', 'hip hop', 'techno', 'techno', 'disco', 'dub', 'schranz', 'dub', 'schranz']
Tommy J Gren	['house music', 'rap', 'disco']
Tomy Gips	[]
TonTon	[]
Toni Smash FX vs Hands Solo	[]
Tonic	['rock', 'neo mellow', 'rock', 'post-grunge', 'rock', 'neo mellow', 'rock', 'post-grunge', 'rock', 'neo mellow', 'rock', 'post-grunge']
Tonic  FreshnLoud	[]
Tonka	['deep new americana', 'new', 'stomp and holler', 'rap', 'house music', 'hip hop', 'rock', 'techno', 'house music', 'house music', 'breakbeat', 'disco', 'techno', 'disco', 'hip hop', 'hip hop', 'deep new americana', 'new', 'stomp and holler', 'deep new americana', 'new', 'stomp and holler']
Tonknecht	[]
Tony Nocera	[]
Tony Smash FX	[]
Topick  Jordan Hayes	[]
Traffic Light	['hi-nrg', 'hi-nrg', 'hi-nrg']
Transmat  USA	[]
Trashy Basstards	['electro trash', 'electro trash', 'electro trash']
Tre Rose	[]
Tremendo  Mad Attitude	[]
Trentemoller	['electronic rock', 'danish pop', 'electronic', 'electronic rock', 'microhouse', 'techno', 'electronic rock', 'electronic rock', 'house music', 'downtempo', 'electronic rock', 'danish pop', 'electronic', 'electronic rock', 'microhouse', 'techno', 'electronic rock', 'electronic rock', 'house music', 'downtempo', 'electronic rock', 'danish pop', 'electronic', 'electronic rock', 'microhouse', 'techno', 'electronic rock', 'electronic rock', 'house music', 'downtempo']
Trinidad	['crunk', 'rap', 'trap', 'rap', 'hip hop', 'rap', 'rap', 'hip hop', 'trap', 'hip hop', 'house music', 'rap', 'hip hop', 'techno', 'techno', 'disco', 'crunk', 'rap', 'trap', 'rap', 'hip hop', 'rap', 'rap', 'hip hop', 'trap', 'hip hop', 'crunk', 'rap', 'trap', 'rap', 'hip hop', 'rap', 'rap', 'hip hop', 'trap', 'hip hop']
Troy Pierce  MNUS	[]
Tryal	[]
Tube & Berger	['disco', 'deep', 'deep', 'deep', 'disco', 'techno', 'groove room', 'house music', 'house music', 'house music', 'disco', 'deep', 'deep', 'deep', 'disco', 'techno', 'groove room', 'house music', 'house music', 'house music', 'disco', 'deep', 'deep', 'deep', 'disco', 'techno', 'groove room', 'house music', 'house music', 'house music']
Tucatz	[]
Tuccillo	['house music', 'house music', 'rap', 'hip hop', 'techno', 'techno', 'disco']
Tujamo	['trap', 'big room', 'big', 'edm', 'house music', 'house music', 'house music', 'house music', 'trap', 'big room', 'big', 'edm', 'house music', 'house music', 'house music', 'house music', 'trap', 'big room', 'big', 'edm', 'house music', 'house music', 'house music', 'house music']
Tuncay Celik	['rap', 'hip hop']
Tunnelenergy ch	[]
Two Jeys and O	[]
Two Suspects	[]
UK	['zapstep', 'zapstep', 'zapstep']
UNKLE Sounds DecksnEffects	[]
USA	[]
Ulli & Maesoo	[]
Umut	[]
Underground Connection	[]
Understand	[]
Uner	['techno', 'rap', 'techno', 'disco', 'techno', 'techno']
Unite	[]
Unite Family	[]
Unter Freunden	[]
Uto Karem	['techno', 'house music', 'disco', 'techno', 'techno', 'rap', 'techno', 'house music', 'techno', 'house music']
VANITA	['rap', 'disco']
VID	[]
VIDAL RODRIGUEZ	[]
VISUALS by DARIO DESIENA	[]
VITO LONERO	[]
VJ Sophie le Meillour	[]
VKawumski	[]
VOLKAN OCAK	[]
VS	['rock', 'pixie', 'pop', 'pop', 'punk', 'rock', 'pixie', 'pop', 'pop', 'punk', 'rock', 'pixie', 'pop', 'pop', 'punk']
Valance Drakes	['idm', 'idm', 'idm']
Valentin Bösch	[]
Valentin Jahn	[]
Valentino	['pop', 'deep pop r&b', 'rap', 'hip hop', 'neo soul', 'new jack swing', 'pop', 'r&b', 'rap', 'hip hop', 'trap', 'urban contemporary', 'pop', 'deep pop r&b', 'rap', 'hip hop', 'neo soul', 'new jack swing', 'pop', 'r&b', 'rap', 'hip hop', 'trap', 'urban contemporary', 'pop', 'deep pop r&b', 'rap', 'hip hop', 'neo soul', 'new jack swing', 'pop', 'r&b', 'rap', 'hip hop', 'trap', 'urban contemporary']
Valetino	[]
Van Nutt	[]
Vanita	['rap', 'disco']
Vanita & Low Tales	['rap']
Vario Volinski	['house music', 'house music', 'house music', 'house music', 'house music', 'house music']
Vegetative Wachstumsphase	[]
Vera	['deep australian indie', 'house music', 'hip hop', 'rap', 'techno', 'techno', 'disco', 'deep australian indie', 'deep australian indie']
Verliebt in Musik	[]
Vid aka Egal3	[]
Violett	['disco', 'ambient', 'techno', 'house music', 'techno', 'hip hop', 'rap']
Virginia	['disco']
Visionquest	['rock', 'techno', 'house music', 'techno']
Visuals by Bildstoerung	[]
Visuals by Van Nutt & Kuka	[]
Vitalic	['electronic rock', 'breakbeat', 'electronic rock', 'house music', 'electronic rock', 'electronic', 'house music', 'electronic rock', 'electronic rock', 'electronic rock', 'disco', 'ambient', 'techno', 'rock', 'house music', 'techno', 'rap', 'electronica', 'electronic rock', 'breakbeat', 'electronic rock', 'house music', 'electronic rock', 'electronic', 'house music', 'electronic rock', 'electronic rock', 'electronic rock', 'electronic rock', 'breakbeat', 'electronic rock', 'house music', 'electronic rock', 'electronic', 'house music', 'electronic rock', 'electronic rock', 'electronic rock']
Vitek	[]
Vitek  Happy Bday	[]
Vitek BE	[]
Vlnolam Kawumski	[]
Vocalist Lele Margot	[]
Volkshaus	[]
Voodookid	[]
Voyage Direct	[]
WAGON REPAIR  GENEVA	[]
WE KILLED THE JUKEBOX	[]
WWWDJSAMCOM	[]
Wall music	[]
Wandler	['disco', 'techno', 'techno', 'techno', 'rap']
Wandler  Cityfox ZÃ¼rich	[]
Wandler  Cityfox Zürich	[]
Wandler  MOTOGUZZI	[]
Wankelmut	['house music', 'house music', 'house music', 'trance music', 'hip hop', 'house music', 'house music', 'house music', 'house music', 'house music', 'house music']
Wareika	['rap', 'techno', 'techno', 'disco']
Warmupper  Alex T  Rauch Club	[]
We Are	['anthem worship', 'ccm', 'anthem worship', 'ccm', 'anthem worship', 'ccm']
We Reset	[]
Weedz	[]
Werner Hasler	[]
Wien	[]
Will Bankhead	[]
Wonnow	[]
Worakls	['house music', 'deep', 'deep', 'deep', 'techno', 'house music', 'house music', 'house music', 'deep', 'deep', 'deep', 'techno', 'house music', 'house music', 'house music', 'deep', 'deep', 'deep', 'techno', 'house music', 'house music']
Xela	['ambient', 'electronica', 'ambient', 'electronica', 'ambient', 'electronica']
Xenocracy DJs	[]
Xfm SPECIAL GUESTS Claire Sturgess	[]
YETTI MEISSNER	[]
Yannick Barman	[]
Yoni Banks & Yan Ka	[]
Yuksek	['electronic rock', 'house music', 'electrofox', 'house music', 'electronic rock', 'disco', 'disco', 'rap', 'electronic rock', 'house music', 'electrofox', 'house music', 'electronic rock', 'disco', 'electronic rock', 'house music', 'electrofox', 'house music', 'electronic rock', 'disco']
ZH	[]
Zapoff	[]
Zavatta	[]
ZerOKilled Music	[]
Zero	['downtempo', 'downtempo', 'electronic', 'nu jazz', 'downtempo', 'downtempo', 'downtempo', 'electronic', 'nu jazz', 'downtempo', 'downtempo', 'downtempo', 'electronic', 'nu jazz', 'downtempo']
Zoe Xenia	['house music', 'techno', 'techno']
Zurich	[]
Zustra	[]
Zweitraum	[]
ZÃ¼rich	[]
ZÜRICH	[]
Zürich	[]
adriano aka adi	[]
africaines	[]
afro psyché rock	[]
alli musikante chÃ¶mit us frÃ¶id und lust am ganze es herzlichs dankeschÃ¶n a alli	[]
alli musikante chömit us fröid und lust am ganze es herzlichs dankeschön a alli	[]
alongside MC DRS	[]
and friends	[]
and moore	['deep texas country', 'deep texas country', 'deep texas country']
apfall wieder mitnÃ¤ u entsorge	[]
apfall wieder mitnä u entsorge	[]
as to the manner born	[]
be	['rock', 'anti-folk', 'comic', 'rock', 'rock', 'indie christmas', 'permanent wave', 'christmas', 'pop', 'zolo', 'rock', 'anti-folk', 'comic', 'rock', 'rock', 'indie christmas', 'permanent wave', 'christmas', 'pop', 'zolo', 'rock', 'anti-folk', 'comic', 'rock', 'rock', 'indie christmas', 'permanent wave', 'christmas', 'pop', 'zolo']
being ed  uk	[]
berner oberland	['british brass band', 'british brass band', 'british brass band']
bertel gee	[]
bescheren das Nachtleben jedoch mit hoch qualitativen Musikproduktionen und legen dazu sehr viel Wert auf solide Soundauswahl für ihre	[]
bleepsequence	[]
bold zh	[]
bonsoir  bern	[]
boogie	['trap', 'rap', 'trap', 'trap', 'rap', 'trap', 'trap', 'rap', 'trap']
buraq	[]
by Cycle Opérant	[]
chica and the folder  monika enterprise  germany  chile	[]
chicago house Cobeia	[]
chillout	[]
chris de rebel	[]
chrÃ¶sch	[]
chrösch	[]
cio  spezialmaterial  switzerland	[]
classics	['brill building pop', 'pop', 'rock', 'merseybeat', 'rock', 'brill building pop', 'pop', 'rock', 'merseybeat', 'rock', 'brill building pop', 'pop', 'rock', 'merseybeat', 'rock']
comfortnoise	[]
cutkachi	['uk garage', 'uk garage', 'uk garage']
dOP	['techno', 'rap', 'hip hop', 'disco', 'techno', 'techno']
dan from illinoise	[]
dan vo irgendwo & steffi sowieso	[]
deco & visuals	[]
deep	['alternative emo', 'emo', 'emo', 'pixie', 'pop punk', 'screamo', 'alternative emo', 'emo', 'emo', 'pixie', 'pop punk', 'screamo', 'alternative emo', 'emo', 'emo', 'pixie', 'pop punk', 'screamo']
deep medi	[]
deepless records	[]
deguds	[]
destr  arm  switzerland	[]
detroit	[]
dickelauscher	[]
disco	['emo', 'pop punk', 'vegas indie', 'emo', 'pop punk', 'vegas indie', 'emo', 'pop punk', 'vegas indie']
disco funk	[]
div	['hip hop', 'rap', 'rap', 'hip hop', 'hip hop', 'rap', 'rap', 'hip hop', 'hip hop', 'rap', 'rap', 'hip hop']
diverse	[]
dj lynn Jordan	[]
djs	['new jack swing', 'new jack swing', 'new jack swing']
doma musique	[]
dominic	['k-pop', 'pop', 'k-pop', 'pop', 'k-pop', 'pop']
doubleare	[]
drompojke	['techno', 'techno', 'disco']
druffnik & jacques horn	[]
dxm soundsystem	[]
eine vo mine lieblinge vo zÃ¼ri aus special	[]
eine vo mine lieblinge vo züri aus special	[]
entropie	[]
ez raidler	[]
fabien	[]
flexibelle	[]
freiberg	[]
funk	[]
fÃ¼rs liecht isch der timowood verantortlich	[]
fürs liecht isch der timowood verantortlich	[]
gallopierende zuversicht  bruckstuecke  switzerland	[]
garage	['alternative country', 'columbus ohio indie', 'rock', 'alternative country', 'columbus ohio indie', 'rock', 'alternative country', 'columbus ohio indie', 'rock']
geneva	['grave wave', 'grave wave', 'grave wave']
hebet sorg zur umwÃ¤ut	[]
hebet sorg zur umwäut	[]
house	[]
httpswwwfacebookcomClubSupermarket	[]
httpwwwfacebookcomcircumflux	[]
iDeep	[]
infos naturapurach	[]
jacqui	['jazz christmas', 'jazz', 'rap', 'hip hop', 'techno', 'techno', 'disco', 'jazz christmas', 'jazz', 'jazz christmas', 'jazz']
jon donson	['techno', 'techno', 'disco']
klangpunkt rec	[]
lexx  drumpoet  switzerland	[]
line up	[]
litle lu	[]
live	['christian christmas', 'world worship', 'worship', 'christian christmas', 'world worship', 'worship', 'christian christmas', 'world worship', 'worship']
liveacts	[]
llian Tape  Buenos Aires	[]
loki	[]
los refrescos  Dandy Jack  perlon  chile & Argenis Brito  senor coconut  venezuela	[]
luc tonnerre  zurich  CH	[]
manon	['disco', 'techno', 'house music', 'techno', 'hip hop', 'rap']
marco repetto  inzec  bern  CH	[]
mia	['pop', 'escape room', 'hip hop', 'indie r&b', 'electronic rock', 'pop', 'electronic rock', 'pop', 'escape room', 'hip hop', 'indie r&b', 'electronic rock', 'pop', 'electronic rock', 'pop', 'escape room', 'hip hop', 'indie r&b', 'electronic rock', 'pop', 'electronic rock']
miniCLUB Timnah Sommerfeldt & Dubois	[]
miniCLUB X HWSD Max Vaahs & Cedric Dekowski all night long	[]
miniCLUB X LaMain	[]
mit	['a cappella', 'cappella', 'a cappella', 'cappella', 'a cappella', 'cappella']
mit Manon	[]
monolith Rec	[]
more TBA	[]
musiques caribéennes	[]
nachtwelt  imploz  geneva  CH	[]
nachtwelt  imploz  switzerland	[]
nat  scandal   zurich  CH	[]
nekÐ¯oBo  loungecore	[]
nekЯoBo  loungecore	[]
nhar  plak records  nantes  F	[]
nick nasty	['house music', 'house music', 'house music', 'rap', 'disco']
nico bodbaiz	[]
noe weigl	[]
oO	[]
ohm 10	[]
ohni barbetrieb	[]
packende Vibes  BORN & das SupiTeam verwöhnt seine Gäste mit Musik der Extraklasse  DER HouseLaden in Zürich Nicht umsonst steht im Supermarket eine der besten Soundsysteme  Kv2 Audio rundet das Hörerlebnis perfekt ab	[]
peter stoffel  geneva  CH	[]
peter stoffel  switzerland	[]
planet mu	[]
pompelmossap  plak  switzerland	[]
profondo	[]
raoul	[]
reggae	['reggae', 'reggae', 'reggae', 'reggae', 'reggae', 'reggae']
restomas  switzerland	[]
rino	['rap', 'dirty', 'rap', 'rap', 'dirty', 'rap', 'rap', 'dirty', 'rap']
roberto  monokrak  geneva  CH	[]
roberto  monokraknet  switzerland	[]
savannah ibiza	[]
see u at dancefloor	[]
sinneswandel	[]
socialmedia	[]
soul	['hip hop', 'rap', 'escape room', 'rap', 'hip hop', 'indie r&b', 'rap', 'rap', 'hip hop', 'trap', 'hip hop', 'hip hop', 'rap', 'escape room', 'rap', 'hip hop', 'indie r&b', 'rap', 'rap', 'hip hop', 'trap', 'hip hop', 'hip hop', 'rap', 'escape room', 'rap', 'hip hop', 'indie r&b', 'rap', 'rap', 'hip hop', 'trap', 'hip hop']
special guest Chris Liebing	[]
support Nik vjs Suffix	[]
swamp81 bristol uk	[]
t	['pop', 'rap', 'trap', 'rap', 'hip hop', 'hip hop', 'pop', 'pop', 'r&b', 'rap', 'hip hop', 'trap', 'urban contemporary', 'pop', 'rap', 'trap', 'rap', 'hip hop', 'hip hop', 'pop', 'pop', 'r&b', 'rap', 'hip hop', 'trap', 'urban contemporary', 'pop', 'rap', 'trap', 'rap', 'hip hop', 'hip hop', 'pop', 'pop', 'r&b', 'rap', 'hip hop', 'trap', 'urban contemporary']
t t	['pop', 'rap', 'trap', 'rap', 'hip hop', 'hip hop', 'pop', 'pop', 'r&b', 'rap', 'hip hop', 'trap', 'urban contemporary', 'pop', 'rap', 'trap', 'rap', 'hip hop', 'hip hop', 'pop', 'pop', 'r&b', 'rap', 'hip hop', 'trap', 'urban contemporary', 'pop', 'rap', 'trap', 'rap', 'hip hop', 'hip hop', 'pop', 'pop', 'r&b', 'rap', 'hip hop', 'trap', 'urban contemporary']
tadeo doberska	['house music']
taiken	[]
tba	['techno']
tech house	[]
technical knockout	[]
triggerch  switzerland	[]
udossonmredit	[]
und  trapez  torino  I	[]
und als DJs	[]
ursprung	[]
uvm	[]
valerio spoletini  switzerland	[]
van nutt  switzerland	[]
vannutt  vannutt  zurich  CH	[]
vo dir und fÃ¼r di	[]
vo dir und für di	[]
welches genau zu beobachten ist Hier tauschen sich Künstler untereinander aus und unterstützen sich gegenseitig in Sachen Musikproduktionen und Kooperationen	[]
whatever	[]
wo genau dÃ¶rt nÃ¤he sigriswil	[]
wo genau dört nähe sigriswil	[]
wortkarg	[]
zerO	['downtempo', 'downtempo', 'electronic', 'nu jazz', 'downtempo', 'downtempo', 'downtempo', 'electronic', 'nu jazz', 'downtempo', 'downtempo', 'downtempo', 'electronic', 'nu jazz', 'downtempo']
zh	[]
zip  perlon  germany	[]
Âme Live	[]
Ãme Live	[]
ÐÐ¾ÑÐ½Ð¾Ð¹ Ð´Ð¾Ð·Ð¾Ñ	[]
ÜNSAL KAPTAN sbar luzern	[]
Ночной дозор	[]
