& MORE TBC	None
&ME	pixie
00h00 Ã  00h45  Bak XIII	None
00h00 Ã  00h45  The Atomic Bitchwax	None
00h00 à 00h45  Bak XIII	None
00h00 à 00h45  The Atomic Bitchwax	None
1204 GenÃ¨ve	None
1204 Genève	None
14h00 Ã  14h45  Danila	None
14h00 Ã  14h45  Floyd Beaumont & The Arkadelphians	None
14h00 à 14h45  Danila	None
14h00 à 14h45  Floyd Beaumont & The Arkadelphians	None
15h00 Ã  15h45  Max der Zinger	None
15h00 Ã  15h45  Six Months Of Sun	None
15h00 à 15h45  Max der Zinger	None
15h00 à 15h45  Six Months Of Sun	None
16h00 Ã  16h45  Hollyhock	None
16h00 Ã  16h45  M Fallan	None
16h00 à 16h45  Hollyhock	None
16h00 à 16h45  M Fallan	None
17h00 Ã  17h45  The Savonnettes	None
17h00 Ã  17h45  Voice Of Ruin	None
17h00 à 17h45  The Savonnettes	None
17h00 à 17h45  Voice Of Ruin	None
18h00 Ã  18h45  Colossus Fall	None
18h00 Ã  18h45  The Chikitas	None
18h00 à 18h45  Colossus Fall	None
18h00 à 18h45  The Chikitas	None
19h00 Ã  19h45  Ca Va Chier	None
19h00 Ã  19h45  Wardhill	None
19h00 à 19h45  Ca Va Chier	None
19h00 à 19h45  Wardhill	None
20 minutes live Szene	None
20h00 Ã  20h45  Gaz	None
20h00 Ã  20h45  Mumakil	None
20h00 Ã  20h45  Vuyvr	None
20h00 à 20h45  Gaz	None
20h00 à 20h45  Mumakil	None
20h00 à 20h45  Vuyvr	None
21h00 Ã  21h45  IncrÃ¼st	None
21h00 Ã  21h45  KessKhtak	None
21h00 à 21h45  Incrüst	None
21h00 à 21h45  KessKhtak	None
22h00 Ã  22h45  Elizabeth	None
22h00 Ã  22h45  Promethee	None
22h00 à 22h45  Elizabeth	None
22h00 à 22h45  Promethee	None
22h2h	None
23h00 Ã  23h45  Faute de Frappe	None
23h00 Ã  23h45  SolarFlar VS Rocrar	None
23h00 à 23h45  Faute de Frappe	None
23h00 à 23h45  SolarFlar VS Rocrar	None
2409	None
2509	None
5 h Set	None
60s70s brazilian grooves	None
900000Y	None
A Bordo	None
ABSÃRDA	None
ABSÜRDA	None
AEED LIVE	None
AFROBEAT NIGHT	None
AKA AKA	house music
AKN & Ditek	None
AKN and Ditek	None
AN JA	None
ANDROMEDA CIRCUS	None
ARNIKA	None
ARTISAN	None
AT	vegas indie
ATA	house music
Aaah Club	None
Abordo	None
Adam Port	disco
Adrian Martin	disco
Adriatique	techno
Aftergrauer	None
AgnÃ¨s	indie folk
Agnès	ambient
Agonis	None
Ajja	dark psytrance
Ajja vs Cosmosis	None
Aktarus	None
Albruic	None
Alci	salsa
Alekk & Twitch Jacob	None
Alekk & Twitch Jakob	None
Alex Dallas	None
Alex Price	techno
Alex Schulz	house music
Alle Farben	deep
Aloan	None
Alphajet	None
Altius	None
Alva Noto	drone
Am Khamsaa	None
Amazon	None
Amsterdam	None
Ananas Symphonie	None
Ananas Symphony	None
Andrea Oliva	techno
Andreas Ramos	disco
Andres Marcos	trap
Andy Stott	microhouse
Angelica Fravi	None
Angy Dee	None
Animal Trainer	deep
Animal Trainer CH	None
Antik	None
Antipods	None
Apron Records  USA	None
Araabmuzik	trap
Ariane	None
Arival	None
Ark	vapor soul
Arnstroem	None
Artamis	None
ArtmaillÃ©	None
ArtmaillÃ© b2b Alan Bolumar	None
Artmaillé	None
Artmaillé b2b Alan Bolumar	None
Asmara	None
Ast	None
Atila	None
Audionatica	techno
Av Skardi	house music
Aya Waska	dub
AÃ¯sha Devi	fluxwork
Aïsha Devi	escape room
BAUCHAMP	None
BEN MANSON	None
BERBER & PASTA	None
BERNARDO & LOZANO	None
BISCARDONG	None
BLAIR	house music
BOY8BIT	None
BRUT  DE	None
Babo	None
Bang Goes	None
BangFreaky UndersoundDE	None
Barcelona	dreamo
Bardo & Salazar	None
Barem	techno
Barnt	house music
BassbÃ¼ro	None
Bassbüro	None
Basses Terres	None
Bauchamp	None
Baumeister	None
Bbphoque	None
Beatis & Basshead	None
Beda	disco
Beda  2nd Floor Mastra	None
Beez & Simo	None
Ben Ashton xa0	None
Benja	None
Berber & Pasta	None
Berlin	house music
Bernoise	None
Bibio	electronic rock
Billy Dalessandro	techno
Bird	indie
Bird aka Pat Muvembe	None
BitTuner	None
Bitsculpter	techno
Black Zone Myth Chant	mandible
BlackStrobe	electronic rock
Blair	house music
BlueSofa	None
Bobmo	techno
Bojan Milenkovic	rap
Bonaventure	disco
Bonny & Clyde	None
Boris Brejcha	techno
Boris Werner b2b Lauhaus	None
Boris Why	house music
Boston Bun B2B Busy P	None
Boy 8 Bit	house music
Brian Sanhaji Live	None
Britta Arnold	deep
Brokapella	None
Bunte Bummler	deep
Buoyancy	None
Burt Cobain	None
Buzz  T	None
CH	None
CHATEAU CHEPERE ALL STAR	None
CMYK	None
CPLAYDEJAVUCH	None
Cadenza	None
Cadenza Music	None
Caillou	None
Call Super	house music
Calvo	deep
Camea	house music
Canson	house music
Carl Craig	techno
Casimir von Oettingen	house music
Casserolband	None
Cesare vs Disorder	techno
Chapkmace	None
Charles Meyer	disco
Charles Meyer  LIMMATBEATZCH	None
Charles Meyer and JosÃ¨ Parra	None
Charles Meyer and Josè Parra	None
Cherosa	None
Chopstick & Johnjon	deep
Chris Ahn	techno
Chris Milla	techno
Chris Tietjen	rap
Christian Schiemann	disco
Christopher Christopher CH	None
Christopher Power ALL NIGHT LONG	None
Cirkus	downtempo
Clem	hip hop
Club Cheval	rap
CoMini  Betty&Ford	None
Cobeia	hip hop
Cocktail Garden	None
Concert et djs	None
Conxion	None
Coolcat	None
Coolcat et Simon Mozer 2000	None
Cooly G	bass music
Cosmo Color	None
Cosmosis	dark psytrance
Coyu	house music
Craft Spells	pop
Craiova	manele
Cris P	None
Cristan	None
Crowdpleaser	techno
D	rock
DAS	kirtan
DAVID LA MINE	None
DAVID LAMON	None
DAndy et TRony	None
DB	None
DBM	None
DE	banda
DELANO	pop
DENNIS KRUISSEN	house music
DIMITRI STAPFER	None
DISCOTECARIO DOCA	None
DJ Alexio	None
DJ Bolumar	None
DJ Dub	dub
DJ HEra	None
DJ Jonny B	None
DJ Le Roi	hip hop
DJ Les Filles Affranchies	None
DJ Lineup	None
DJ MARABOUT	None
DJ Madskillz	house music
DJ OEL & KAMA	None
DJ REAS	None
DJ Rescue	hip hop
DJ Reverend P	hip hop
DJ Rocca	downtempo
DJ SAM	None
DJ Sam	None
DJ Sets	None
DJ Tennis	house music
DJ Vany and more	None
DJ Volta	None
DJ Voltec	house music
DJ Voltec & DJ Flavius Tadeus	house music
DJ Wld	None
DJ Zest	None
DJERRY C	None
DJs  Acts	None
DJs OEl & Kama	None
DLP	disco
DON 1208	None
DSER	None
DUBNIUM	None
DaTO b2b Senoo	None
Dachkantine	None
Daedelus	idm
Damiano Pappada	None
Damon Irving	None
Dan Andrei	None
Dan NoÃ«l	None
Dan Noël	None
Dandy & Trony	house music
Dandy Jack	hip hop
Dani Greco aka DKI	None
Daniel Avery B2B Roman FlÃ¼gel	None
Daniel Avery B2B Roman Flügel	None
Daniel Broesecke	None
Daniel DB	house music
Danse Noire	None
Danse Noire DJs	None
Dario DAttis	rap
Dario Friberg  Voltec  Flavius Tadeus	None
Dario La Mazza	None
Darius D	None
Darrien	hardcore
Das Drehmoment	None
Das Hutwerk	techno
Das Hutwerk CH	None
Dave Dalux	None
Dave Lozano	None
Dave Pasquale	None
David Carretta	electronic rock
David Fraka	None
David K	house music
David Lozano	None
David Suivez	None
De	banda
De Hofnar	house music
De La Maso	rap
Dean Blunt	fluxwork
Debora Ipekel aka Night Nurse	None
Dee Nelli	None
DeeJay Q	None
DeeNelli	None
DeeVerso	None
Deepend	house music
Deepn Dub	None
Dejan	None
Demented Are Go	rockabilly
Demir	turkish
Deneha	house music
Derek	hip hop
Detroit	None
Detroit Swindle	house music
Diego Indigo	None
Digitaline	techno
Digitalo Enterprises  NO	None
Dilusso	None
Dim	christian
Dimitri	house music
Dino	turbo folk
Dirty Channels	rap
Disco 45 Londres	None
Disco Dave	disco
Dj Fil from 10pm to 2am	None
Dj Gaspard	None
Dj La Luna	None
Dj Myah	None
Dj Nick Harvey	None
Dj Niki	dubsteppe
Dj PorCus	None
Dj Reas & Massimiliano M	None
Dj Sam	None
Djazzy	rap
Djerry C	None
Dominik Eulberg	techno
Double You	hi-nrg
Dracula Lewis	None
Drauf & Dran	house music
Dreems	house music
Dubfunk	house music
Ducks on Repeat	techno
Dymons	ambient
Dynamite MC	jungle
E	pop
EMMA MYLAN  FIREDOLL	None
Ectocasmic	None
Edgar Jack	techno
Edu Imbernon	house music
EgoPhunk	house music
Ehrlich & Redlich	None
Einmusik	techno
Einzig & Faerber	rap
El Alusinante	None
El Jesus & ACDJ	None
Elc	None
Elk  Rhino	None
Elkee	None
Elle RÃªve	None
Elle Rêve	None
Ellen Allien	techno
Elrino	None
Elvis Cassetta	house music
Em & Em	pagode
Emil Berliner	deep
Emmat	techno
Endgame	None
Enzo Lo Conte	None
Enzo lo Conte	None
Eric A  Simple & Sans PrÃ©tention  CH  House	None
Eric A  Simple & Sans Prétention  CH  House	None
Ertu Denil	None
Et Vous	None
Everstone	house music
Exos	techno
Explosion de caca CH	None
Ezikiel	techno
FAB	rock
FABRI	None
FABRi	None
FELIX FOSSIL	None
FICHTRE  Feldermelder	None
FIMO feat MANOLO	None
FR	None
FRYK	None
Fabio Florido	house music
Fat Acid	None
Feadz	house music
Feldermelder	None
Felon	house music
Fez Momo	None
Fichtre	None
Finefood records  Fribourg	None
Fis	bass music
Flavio	channel pop
Flavio Reinhardt	None
Flavius Tadeus	None
Fleeting Wax  Berlin	None
Flink	None
Floating Points	house music
Flooting Grooves	didgeridoo
Florian Kunicke	None
Flying Lotus	hip hop
Foupoudav	None
Francesco De Bellis	None
Francis Mallo	None
Franco Bianco	techno
Frango	techno
Frank Storm	None
Frankfurt	None
FranÃ§ois K	house music
François K	house music
Freaky Charly	None
Fred V & Grafix	drum and bass
Freddy Verano	house music
FreiburgDE	None
Freshmint	None
Friends	emo
Fritz Kalkbrenner	house music
GE	gospel
GENER8ION	escape room
GIL live	None
GINO  Special 3 h Christmas Intro Set	None
GL Everest	None
GL Everest and guest	None
GOGO	jazz
GREG & FREAZA aka THE HEAVYHITTERZ	None
Gaiser	techno
Gamper & Dadoni	house music
Garance	techno
Garance & diSoul	techno
GarÃ§on	None
GarÃ§on Sauvage	None
Garçon	None
Garçon Sauvage	None
Geneva	grave wave
Georg Gatsas	None
George Morel	rap
Germany	pop
Gernot Modeselektor	None
Gertude Tuning	None
Ghetto Po	None
Ghetto Po 237CH	None
Ghoster	None
Giacomo Lombardo	None
Gianni	None
Gianni Callipari	disco
Gibbz	vapor soul
GirlManon	None
Gotan Project ARG	None
Gramatik	downtempo
Grande ScÃ¨ne	None
Grande Scène	None
Gray Gravity	None
Greg Beato	house music
Greg Shepherd	None
Gregorythme	techno
Gregrythme	None
Guy Joshua	None
HERMANSSON & MARTINEZ	None
HERR LIEBE & LEATHERETTE	None
Habibi Funk	None
Haelg & Gerosa	None
Hanne & Lore	house music
Harry Klein Networks	None
Havanna Sound	None
Hector	merengue
Helder	house music
Helder Costa b2b Lee Low	None
Henrik Schwarz	techno
Herkul	None
Herman	tin pan alley
Hermann	None
Herr MÃ¼ller	None
Herr Müller	None
Herr Vogel	None
Honoree	techno
Horasse	None
Horatio	techno
Hot Waves	None
Hraach	house music
Hrdvsion	disco
Huazee	None
Hug & Schiemann	None
Hugel	None
Hula Honeys	hawaiian
I	hip hop
IGGY	pop
IL	opera
INFX	None
INMIND	None
Iggy	pop
Iker Muruaga	None
Ikke	house music
Imox	None
In Flagranti	disco
Intro by ATA	None
Isolated Lines	techno
Izia  The Chase	None
J ROCC	turntablism
J Velez aka Professor Genius	None
JKin	None
JNPLSRC	None
JOHAN MÃVE	None
JOHAN MÖVE	None
JOHAN NOVACEK	None
JOHNNY B	None
JONES b2b LEFTHAND	None
Jack & Jus	None
Jacqui	jazz christmas
Jacqui & RÃ©ne Dachner	rap
Jacqui & Réne Dachner	rap
Jam City	uk garage
James Mc Hale	None
Jamie Jones	techno
Jan Penarrubia	techno
Janiz	None
Javi Pena	hip hop
Javi PeÃ±a	None
Javi Peña	None
Jaxon & Emre Bektas	None
Jaxson Owens	None
Jecko Kay	None
Jeff Swing	techno
Jeff Swing  Dan Lagardere  Ken Wan  Little  Big T	None
Jeff Swing b2b Cosmokolor all night long	None
Jens Bond	techno
Jessie	pop
Jestics	None
Jimi Jules	disco
Joe Galen	None
John Morales	rap
Jokari	disco
Jonny Rock	rock
Joram	disco
Jose Maria Ramon	techno
Jose Parra	flamenco
JosÃ¨ Parra	flamenco
JosÃ© Parra	flamenco
Josè Parra	flamenco
José Parra	flamenco
Js  Acts	None
Judaah	None
Juen & Bach	None
Juicy Lucy	blues
Juliano Lopez	disco
Julien	indie
Julien Aubert	None
Julien Gremaud	None
Julius Abel	house music
Jurassic FightClub	None
JusEd	None
KALEID feat Electrosexual & DORIAN E	None
KENHOBIZ	None
KONPIUTA	None
Kali	indie
Kap Bambino	electronic rock
Kassem Mosse	techno
Katermukke	None
Katermukke  Berlin	None
Kim Prevedello	hip hop
KlanggÃ¤rtner	None
Klanggärtner	None
Kollektiv Ost	house music
KombÃ©	None
Kombé	None
Komsomol	None
Koreless	uk garage
Kowton	house music
Krankbrother	None
Krizzli	disco
Krono	house music
Kurilian Kratz	None
Kyrill & Redford	groove room
LAD	hardcore
LAWilliams DJAXUPKUMBA RECUSA	None
LOUISAHHH	techno
LUCA GEROSA	None
LUCKY PAUL	disco
LUKE SANTOS	None
LVNDSCAPE	house music
LVis 1990	None
La fine Ã©quipe	None
La fine équipe	None
La soirÃ©e aura lieu au parc des Bastions	None
La soirée aura lieu au parc des Bastions	None
Lara Valentina	None
Larytta	hip hop
Laurel Halo	house music
Laurent Charbon	hip hop
Le Peuple de lHerbe	dub
Lee Gamble	techno
Lefthand	None
Lega 237RU	None
Leipzig	classical
Lemka	None
Lemonick	disco
Leo	house music
LeonÃ¡rd Bywa	rap
Leonárd Bywa	rap
Les Puppetmastaz	None
Les Round Table Knights	None
Les petits pilous	house music
Licht im Dunkel	None
Liebkind	None
Limic aka Lio M	None
Limmatbeatz	None
Little	pop
Littlehouse	None
Liv Stone	rap
Looft	None
Loscil	drone
Louh	None
Louis Brown	None
Lovers	preverb
Low Jack	house music
Low Tales	house music
LowTales	house music
Luca Fari	None
Luca Gerosa	None
Lucas MonÃ¨me	None
Lucas Monème	None
Lucerne	None
Lukas Kleesattel	techno
Lukino	rap
MADIA SABIROWA	None
MALBEC	None
MALEKOS BEUTEL	None
MARC FUHRMANN PANTHERA RECILLUSIONROOMCH	None
MARCO P  TURNING WEEL RECCH	None
MARIE PRIEUX	None
MATIJA	None
MATT MANIK	None
MAURO VILLAREALE	None
MAXIM MAILLET	None
MBAH	None
MBP	None
MC Annie Jaklin	None
METRIK	drum and bass
MIKE MUFF	None
MONSIEUR MELANGE b2b KORNY	None
MONSIEUR P & MADFUNK	None
MOON	pop
MaMe	None
Maceo Plex	house music
Maceo Plex  Tale Of Us  Mano Le Tough  DJ Tennis  Mark Henning  Markus Lindner  Canson	None
Macromism	techno
Maetrik	techno
Magic Mixers	None
Mahi	trance music
Mainfloor Sven VÃ¤th	None
Mainfloor Sven Väth	None
Malekos Beutel	None
Mambo Chick	None
Maniezzl	None
Mannheim	christmas
Mano Le Tough	techno
Manon	techno
Manon CH	None
Manuell	hip hop
Marc DArrigo	house music
Marc Romboy	techno
Marcel Dettmann	techno
Marco Berto	disco
Marco Capone	None
Marco Falkone	None
Marco Smacchia	None
Marco Tegui	None
Marco Trinkler	None
Marcosis	None
Mario Zar	None
Mark Henning	techno
Mark Lemigton	None
Mark Lemington  DB  Voltec  Flavius Tadeus	None
Markus Lindner	techno
Markus haZe	None
Marlon	None
Martin Buttrich	techno
Martin Eyerer	techno
Martin Waslewski	house music
Massive Jay	None
Master Margherita	world fusion
Mastra & Beda	None
Matija	None
Matjia	None
Matt Kay	house music
Matt Tolfrey	techno
Matteo Arcucci	techno
Matteo Arcuccit	None
Matthias Tanzmann	techno
Mauro Muratti	None
Max Tundra	None
Mehmet Aslan	disco
Meikel	techno
Mendo	house music
MiSÃ¹mo	None
MiSùmo	None
Mia Kaltes	None
Michael Deep	house music
Michael Gull	None
Michael Schulte	pop
Michael Seelenruhig	None
Michael Taschinski	None
Michal Zietara	None
Miguel	hip hop
Mike Teixeira	None
MinimalistiXProject	None
Mirco Caruso	hip hop
Mirco Niemeier	house music
Mirko Caruso	None
Mirko Loko CH	None
Mirkovich	None
Miss Flora	house music
Miss Jools	techno
Missill	None
Mitsutek	techno
Mixhell	techno
Mme Trash	None
Mobilee	None
Moderat	electronic rock
Modis Chrisha	None
Mon Mec & Jean Charles de Monte Carlo	None
Money B	None
Monoloc	techno
Monome	rap
Monoplage & ECO	rap
Monpetitponey	None
Monte	None
Mosaic	christian uplift
Mount Kimbie	electronic rock
Mountain People	techno
Mouseen & Dejan	None
Mr Jonk	None
Mumdance	fluxwork
MÃ¶we	house music
Möwe	house music
NAHSTER ONER	None
NGOC LAN	vietnamese pop
NIK BÃRTSCH	dark jazz
NIK BÄRTSCH	dark jazz
NUKEM	house music
Nader	techno
Nathan Fake	techno
Nathanael	None
Naughty Neigbours	None
Navi Playful	None
Naxxos	house music
Ngly	house music
Ngoc Lan  CH  HipHop	None
Nguzunguzu	uk garage
Nick Curly	house music
Nico Pusch	house music
Nicola S	None
Nicolas Duvoisin & tsacK	house music
Nicolas Haelg	house music
Niels	dutch pop
Nik	rock
Nik & Baumeister	None
Nik dj	None
Nikolas Haelg	None
Nils Fraser	None
Nils Hoffmann	deep
Nina Kraviz	techno
Ninja Tune	None
Nkisi	None
Noir Music	None
Nori	techno
Noromal	disco
Nous mettre feu Ã  Usine On reprend la vieille Ã©quipe et on rajoute du poivre et du piment dans la vodka Paf  SoirÃ©e bien corsÃ©e en perspective pour les fans de drumnbass avec le rebelle pirate DJ Das	None
Nous mettre feu à Usine On reprend la vieille équipe et on rajoute du poivre et du piment dans la vodka Paf  Soirée bien corsée en perspective pour les fans de drumnbass avec le rebelle pirate DJ Das	None
Nybass	None
NÃ´ze	microhouse
Nôze	microhouse
ODESZA	electronic rock
OGOUN FERRAILLE	None
Oli	None
Oliver Hafenbauer	rap
Oliver Hafenbauer & MANY MORE	house music
Oliver Markreich	house music
Olivier Kolly	disco
One Records	None
Opuswerk	techno
Osba	None
Oscar Nicczo	None
Otavio	None
Otto Von Schirach feat Notorious Nastie	None
Oy	hip hop
Ozien	None
PARIS	uk garage
PASCAL PROSPER  TANZNATURBOLLWERKCH	None
PASCI	None
PLACID	house music
PLAY TECHNOODESSA  UA	None
POSSA	None
PULSAAR	deep liquid
Paco Osuna	techno
PacoVolume FRA	None
Padrino	None
Pakalolo	None
Palms Trax	house music
Pandallougi & MontCoco	techno
Panteros666	techno
Pantha Du Prince	electronic rock
Para One B2B Curses	None
Pascal Tokar	None
Pasci	None
Patrick Chardronnet	house music
Patrischa	house music
Patt & Mandibula	None
Paul Eg	techno
Paul Kalkbrenner	techno
Paulo Polizzi	None
Pazkal	house music
Peak b2b Marc DArrigo	None
Pearson Sound	house music
Perel	None
Permanent Triangle	None
Pete Rock	hip hop
Peter D	techno
Pets  Berlin	None
Phil Parnell	None
Philipp Aregger	None
Philippe Dunst	None
Philippe Petit	techno
Piano Club BEL	None
Piasa	None
Pierre Raboud	None
Placebo GBR	None
Plastik Funk	house music
Polonium 88 b2b Tonga aka Toyboys	None
Pour celles et ceux qui dÃ©barquent	None
Pour celles et ceux qui débarquent	None
Pretty Pink	rap
Primr	None
Programme	None
PrÃ©locations sur Ã  Sounds Records	None
Prélocations sur à Sounds Records	None
Publicist	disco
Qebeq	None
Quarion	techno
Quentin Mosimann	None
Quitim	None
RAPU & Nekow	None
RAS MALI	None
RAY HERLITZ	None
RE	None
REK	None
RINGO MOON	None
RINGO MOON  LIMMATBEATZCH	None
ROHSTOFFLAGER	None
Radiorifle	None
Ragesh Nair	techno
Raime	drone
Ramiro Lopez	techno
Rare Movement	house music
Ray Douglas	None
Reas	house music
Reber	house music
Rebolledo	deep cumbia sonidera
Records	indie
ReeFlex	None
Renato Broccini	idm
Reto Ardour	techno
Reznik	house music
Rice&Beans	None
Ringo Moon	None
Rino	rap
Ripperton	soul
Robel	None
Robert Babicz	techno
Robert Dietz	techno
Robin	house music
Rock Machine  Berlin	None
Rodri	None
Roger Sanchez	house music
Rolf Imhof	None
Romano Ciccone	None
Romano Rapeso	techno
Romeo	bachata
Round Table Knights	house music
Rozzo	techno
Rumlaut	None
Ruslan Mays TOUCHED PHOBIQ RECORDSKAZANTIP KISS FM	None
Russ Liquid	idm
Ruta 5	None
Ryan Crosson b2b Cesar Merveille	None
Ryan Hawkin	techno
SCHAED	None
SEXOMODULAR	None
SOMEAIR	None
SOMI	vocal jazz
SPOR	None
SSSS	disco
SUNSUN live	None
SUPERMAFIA VJS	None
SUPERMARKET	None
SWEET DBROTHERHOOD	None
SWIT HONEY	None
SYLK POLETTI	None
Sabb	deep
Salzburg	None
Sam	country
Sam Feldt	house music
San Jack OFFICAL KONSUL KAZANTIPKISS FMUA	None
San Marco	deep orchestral
Sandro Aguello	None
Sandro Kuhne	None
Sandro KÃ¼hne	None
Sandro KÃ¼hne b2b Marco Trinkler	None
Sandro Kühne	None
Sandro Kühne b2b Marco Trinkler	None
Sascha Stohler	None
Schaed	None
Schaed all night long	None
Schmerol	None
Schnautzi	None
SciTec	None
Scout Klas	None
Scuba	uk garage
ScÃ¨ne du Casino	None
Scène du Casino	None
Sean Amini	None
Seb Blake b2b Albi	None
Sebas O Verde	techno
Sebastian	banda
Sebastian Eduardo	None
Sebastien	classical
Sebatien B	None
Selim & Armin	None
Serio	rap
Session Victim	house music
Seteve	None
Sevdaliza	indie
Seymen	None
Shackleton	fluxwork
Shades	techno
SheDj Meenakshi	None
SheDj Naima	None
SheDj Sabi	None
Sheila She Loves You CH	None
Shore Bar Axel	None
Shows & Performances	None
Simon Effect	None
Simon Effect ARCHIPELCH	None
Simon Li	techno
Simple & Sans	rap
Sinner DC & Volt Face	techno
Skaos	ska
SkatebÃ¥rd	balearic
Skatebård	balearic
Skiing	None
Skyd	None
Slow Magic	electronic rock
Smalltown Collective	techno
Somi	vocal jazz
Sonny Vice	None
Sound of Neptune	None
Space Factory	None
Spanks	None
Special Guest	None
StPaul	None
Stacey Pullen	techno
Starsand	None
Stefano	ambient
Stereo Express	house music
Steve Cole	smooth jazz
Steve Supreme	None
Steven Fox	None
Steven Traffic	None
Sticka	None
Structure and VJing by Maak	None
Studio 41	None
Styro2000	None
SuMan & Placebo	house music
Suara	j-dance
Sub Bros	None
Suffix support	None
Suffix visuals	None
Super Flu	house music
Supermarket Zurich	None
Superpoze	disco
Support	None
Support Dramaqueen & Capitain Elaine	None
Support by Haelg & Gerosa and Guests	None
Susie Star	None
Sven Tasnadi	house music
Sweely	disco
SweetnCandy	None
Swithoney	None
Swosch	None
TBC	None
TEKNOLOGIK Present	None
TESTOSTERONE CLUB	None
THE Juan Maclean	electronic rock
THE TOYBOYS	None
THIS LINEUP WILL BE FREE OF CHARGES ON PLACE DE LEUROPE	None
TIMOWOODTV	None
TIMOWOODTV  Visuals & Deko	None
TIMWOODTV	None
TIVE	house music
TOBIAS BIENZ KostÃ¼m & Ausstattung HENRIETTE HERM Musik DJ Ray CITO Video & Visuals BENJAMIN BURGER Kommunikation KAJA EGGENSCHWILER	None
TOBIAS BIENZ Kostüm & Ausstattung HENRIETTE HERM Musik DJ Ray CITO Video & Visuals BENJAMIN BURGER Kommunikation KAJA EGGENSCHWILER	None
TOLYA SUHAR NOVOTECHKAZANTIPKISS FMUA	None
TOYBOYS	None
TV Rocks	None
Tableturner duo	None
Tagtra3umer	None
TagtrÃ¤umerÂ²	None
Tagträumer²	None
Tale Of Us	techno
Tba	techno
Techrifice	None
TeheranBerlin	None
Terzini Bros	None
Tha Tuga	None
The Cruzaders	disco
The Csc	None
The Peaking Goddess Collective Outro Concert	None
The Pilotwings	None
The Rah	None
The Sons of the Desert	deep contemporary country
The Toyboys	None
Theo Parrish	house music
Think Tank	rap
Think Tank DJs	None
Thomas Schumacher	techno
TillTape & Gray Chalk	None
Tim Exile LIVE	None
Timmo	techno
Timnah Sommerfeldt	None
Timoteo	sertanejo tradicional
TimowoodTV	None
Tinush	house music
Tissu	None
Todo	regional mexican pop
Tom Pusch	None
Tom Trago	house music
Topic	house music
Tough Love	house music
Tre Rose Bros	None
Tremendo	house music
TriDeuces	None
Trinidad	rap
Tuncay Celik	rap
Two Suspect	None
Two Suspectt	None
UK	zapstep
USA	None
Uebel & GefÃ¤hrlich  Hamburg	None
Uebel & Gefährlich  Hamburg	None
Ugly Kids	None
Uglyfunker	None
Unite Family	None
V Stax	None
VISIONS OF TREES	grave wave
VJ Le Chat	None
VJing Performance by Kreutzfeld & JJJakkob	None
VVVWIndeed	None
Vaghe Stelle	dub
Van Hai	techno
Vanita	rap
Victor L	None
Visionist	bass music
Visuals Pizz	None
Visuals by Aaawesome Colors	None
Visuals by Dario DeSiena	None
Visuals by Sophie Le Meillour	None
Visuals vom TimowoodTV	None
Visuels et performances	None
Vitek	None
Voltec	None
Von und mit BENJAMIN BURGER	None
WITH	pop
WTF & Bonus Beats	None
Walls	None
Wandervogel	None
Wandler	techno
West D	techno
Wide Soul	None
Winter in Deutschland	None
Wolfskind	None
Woolfy vs PROJECTIONS	balearic
XV Killist & Rocco	None
YOSKO	None
YabYum	None
Yall	None
Yan Luong	hip hop
YanKa	None
Yannick MÃ¼ller	None
Yannick Müller	None
Yare	None
Yaya	techno
ZH	None
Zest	techno
Zimon	None
Zombie Disco Squad	house music
Zomby	techno
Zurich	None
Zwette	house music
and many more	None
and more	deep freestyle
aprÃ¨s plusieurs apparitions tÃ©lÃ©visuelles	None
après plusieurs apparitions télévisuelles	None
beatbrothers	None
bossa	None
chicago house et plus si affinitÃ©s	None
chicago house et plus si affinités	None
comme cerise sur le pÃ¢tÃ©	None
comme cerise sur le pâté	None
cosmos uk & fresh 80s  dj	None
diSoul	techno
disco	vegas indie
dj	trap
dj Lynn Jordan	None
dj little	None
drompojke	techno
dÃ©barque Ã  PTR  FormÃ© en 1996	None
débarque à PTR  Formé en 1996	None
enregistrent leur premier album  Creature funk  en 2003 Alors que leur second  Creature Shock Radio  obtient un franc succÃ¨s et les Ã©lÃ¨ve Ã  un niveau supÃ©rieur	None
enregistrent leur premier album  Creature funk  en 2003 Alors que leur second  Creature Shock Radio  obtient un franc succès et les élève à un niveau supérieur	None
et pour cette Ã©dition	None
et pour cette édition	None
friends	emo
glasraum	None
guest	electronic rock
httpsoundcloudcomschaed	None
httpswwwfacebookcomTIMOWOODtvfrefts	None
ils construisent alors un vaisseau spatial et partent dans le cosmos Ã  la recherche de signes nouveaux et de valeurs Ã  transmettre Ã  lhumanitÃ© AprÃ¨s un long pÃ©riple riche en aventures	None
ils construisent alors un vaisseau spatial et partent dans le cosmos à la recherche de signes nouveaux et de valeurs à transmettre à lhumanité Après un long périple riche en aventures	None
ils tentent de bÃ¢tir un nouvel ordre mondial	None
ils tentent de bâtir un nouvel ordre mondial	None
imaginez un mix entre le Muppet Show et le WuTang Clan Le seul  groupe de jouets  sur Terre	None
just only club listed here in Geneva near the venue	None
le cerf de la jungle DJ Dser	None
le cotÃ© obscur de DJ Kenhobiz	None
le coté obscur de DJ Kenhobiz	None
leur nouvel album  Revolve and Step up  sortira le 26 mars prochain  De quoi faire remuer vos corps de grosses marionnettes	None
live	christian christmas
live KMK	None
mimetic	industrial music
miniCLUB Raise & Morard	None
miniCLUB X Alma Negra	None
plus juste pour toutes les marionnettes et crÃ©atures Malheureusement	None
plus juste pour toutes les marionnettes et créatures Malheureusement	None
post dubstep	None
reedits	None
rien ne change et les Puppetmastaz tombent en dÃ©pression Avec laide de leur psychanalyste Ziggy Scandalous et lappui financier de Sneakerboots	None
rien ne change et les Puppetmastaz tombent en dépression Avec laide de leur psychanalyste Ziggy Scandalous et lappui financier de Sneakerboots	None
sCs  Studio 41  Montreux Jazz Festival	None
sdanke	None
surf and exotica	None
tINI	hip hop
treibhouse	None
tropicalia  dj	None
tuningbox	None
undergroundproject	None
une spÃ©cialitÃ© venant directement de Londres	None
une spécialité venant directement de Londres	None
uvm	None
visuals by Pizz	None
xa0Anna Ullrich	None
yAn	techno
трип  ISL	None
