	None
0130 Klaus Frauenholz	None
0300 Juan Veloz	None
2130 Jazz T	None
2300 PeeKay	None
2400 Romanesko	None
2nd Floor	None
AGENT	punk
AL SENTO	None
Aalbou	None
Abstract	None
Adam Winston	None
Adolpho & Franky	None
Adriano Mirabile	dub
Ajele Naturklang	None
Alci	salsa
Alex Anderst	None
Amine Edge & DANCE	house music
Andreas Ramos Baked ZH	None
Andrew	indie
Andrew The Grand	None
Andrés Marcos	None
Angelo B	None
Antislash	house music
Archie Hamilton	techno
Ari Onni	None
Armonica	None
Arutani	None
Avem	None
Azimute aka Quenum & Cesare vs Disorder	None
BP Zulauf	None
Barac	disco
Benjamin Fehr  Catenaccio  Foundsound  Finefood Records  Berlin	None
Betolicious	None
Bfly	None
Bfly Steiner	house music
Boris Why	house music
CH	None
CUT	electronic rock
Central Rodeo	house music
Chic Miniature aka Guillaume & The CoutuDumonts & Ernesto Ferreyra	None
Chris de Luca vs Phono	None
Christian & Raphaël	house music
Cipmo	None
Claude Laurier	None
Clem	hip hop
Club Q	None
Contexterrior	None
Copains Sauvages	None
Cosi Dee	None
Crosstown RebelsFR	None
DAndy vs TRony	None
DJ Ass	None
DJ Bazooka	None
DJ Deenasty	None
DJ Jamie Lewis	None
DJ Tray	None
DK13	None
Dachshund	techno
Dacid	None
Daley Padley	None
Dalibox	hip hop
Dan Farserelli	deep
Dan Welton	house music
Dan Welton and Edgar Jack	None
Dani Casarano	techno
Daria	techno
Darko Stronqvist	None
David Armada	disco
David Durango	techno
David Torr	disco
Dead As Disco	None
Deep n Dub	None
Desolat	None
Diego Indigo	None
Dinan	None
Dineo	None
Divided Rec	None
Dj Kulturshock	None
Don Vincent	None
DoubtingThomas	techno
Dr FadR	None
DuoRhythm	None
EXTRASTUNDEN JONATHAN SOLO	None
Eddie Thoneick	house music
Edgar Jack	techno
Edgar Jack and Marrocco	None
Edivad	None
Eli Verveine	techno
Elrino	None
Enzo di Caprio	None
Eric Borgo	house music
Extrastunden	None
FLINKE FINGER	None
Fabio Tamborrini	disco
Fantastic Friends  Highgrade  Metroline Limited	None
Federico Molinari	techno
Finnebassen	house music
Flavio Sunday Breakfast	None
Floor 1  Shrubbn	None
Floor 2  Miss Flora	None
Fourth Kind	None
Franck C	None
Franco Bianco	techno
Franky Fourfingers	None
G Work	None
GD	k-pop
GHETTO PO	None
GL Everest	None
Georg Stuby	None
Georg Stuby Naturklang	None
GetBuzz	None
Ghetto Po	None
Gleichschritt	None
Goldfinger Brothers	hip hop
Greg Brockmann Half Baked	None
Greg la Brelle	None
Gregorythme	techno
Gunnar Guess Naturklang	None
Gypsis	None
Heimat	hip hop
HiGY	None
Housemeister	techno
Huazee	None
Hug & Schiemann	None
Ian F Colours	None
Instant Rave	None
Intro by Rocca & Dineo	None
JD Hakulinen	None
JOHNNY QUEST	kc indie
James Mc Hale	None
James Mc Hale Sunday Breakfast	None
Jamie Jones	techno
Jamie Lewis	house music
Janina	concert piano
Jaso LIVE	None
Jay Mas	None
Jibone	None
Joe Claussell	hip hop
Joyce Muniz	vienna indie
Juliano Lopez	disco
JuniorB	None
KONPIUTALIVE	None
KiYota	None
Konpiuta	None
Kufanya	None
König Balthasar	None
LA MINE EXPRESS	None
LEE  O	None
Laurent Charbon	hip hop
Lazare Hoche & SAM & Malin Genie	house music
Le Citadin	None
Le Noir	azontobeats
Lehar	romantic
Leke da Loco	None
Leo	house music
Lino Loud	None
Los Wenamigos	None
Luca F	None
Luca de Grandis	None
Lui Young	techno
Lukie Wyniger aka UNCLE PENG PENG	None
Lukie Wyniger aka Uncle Peng Peng	None
Léonard de Léonard	None
MANDY  Patrick	None
MARC BENZ	None
MAX CELLI	None
MC Jay	None
Main Floor	None
Mandar	None
Marco da Mata	None
Marcos	house music
Marosh Kopp	None
Marque Aurel	None
Marrocco	None
Martelli	channel pop
Marvin J	None
Masa Saji	None
Masaya	hip hop
Matthias Tanzmann	techno
Mattoo	dub
Memnok	techno
Mia Kaltes  Finefood Records  Switzerland	None
Michael Fate	None
Miguel	hip hop
Mihigh	techno
Mike Shannon	techno
Mirax	None
Monkey Safari	house music
Moonharbour	None
Morard	None
Morgan Tomas	techno
Mucho Stylez	techno
Music P	hardcore
NUKEM	house music
Nabin	None
Nekow Newfact Music	None
Nelson De Jesus	None
Nico Morano	disco
Nico Pusch	house music
Nicola Kazimir	disco
Nicolas Duvoisin	disco
Nik Frankenberg	None
Nikos Voutsas	None
Noir	hip hop
Nôze	microhouse
Oli Allen	None
Oram Modular	None
Oslo	orchestral
OstGut TonEdinburgh	None
Osunlade	house music
Oxia	techno
PR3SNT	techno
Pawlikowski	classic polish pop
Perry Pierce & Doncivico	None
Petre Inspirescu	None
Philippe	classical christmas
Praslea arpiar	None
Prosumer	house music
RAPU B2B Nekow	None
Ramon Lorenzo	None
Raresh	None
Reloading rec	None
Residents	rock
Rhadoo arpiar	None
Rozzo	techno
Ryan Hawkin	techno
Ryan Hawkin & Konpiuta	rap
S Rubinfeld Live Act & Vinyl only	None
SIMON EFFECT	None
SNARDI	None
Salzunpepper	None
Sam Bangura Half Baked	None
Sammy Dee	hip hop
Sascha Braemer	house music
Sayan Sobuth	rap
Schwebekasten	None
Scott Bradford	house music
Seb Blake	disco
Sebastian Wojkowski	None
Servet Argin	None
Shabba	reggae
Shonky	techno
Silencio	rock
Skaos	ska
Skizofred	None
Stealth RecordsUK	None
Steiner	soundtrack
Stimming	techno
Stipé	None
Strassenmajor	None
Supersonic Sound	None
Swit Honey	None
Symphonix LIVE	None
System RecSUI	None
TBird	None
TIVE	house music
The Cruzaders	rock
The Cube Guys	house music
Tiari	hip hop
Timbee Rec	None
TimbeeSUI	None
Timoteo LET	None
Timoteo Les Enfants Terribles	None
Tonic	rock
Twisted FrequencySUI	None
Tyrone B Nelson	hip hop
USA	None
Undercatt	house music
Vario Volinski	house music
Vlnolam Kawumski	None
Woody	blues
XOSE	None
Xose	None
Yan & Dan	rap
Yare	None
ZOO	None
ieva	None
ruffPack international	None
