0030  0230 La Fée Verte	None
00h0002h00 Emmat	None
00h30  02h30 Dandy & Trony	None
01h0003h00 Bruno Pronsato	None
0230  0500 Valentino	None
02h0004h45 Franco Cinelli	None
02h30  05h00 Pasci	None
03h0004h45 Jacqui	None
1300  1400 TBA	None
1400  1430 Betty & Ford	None
1400  1500 Kyrill & Redford	None
1430  1500 James Mc Hale	None
1500  1700 Adriatique	None
1500  1700 Sascha Braemer & Niconé	None
1700  1900 Adana Twins	None
1700  1900 Monkey Safari	None
1900  2100 Oliver Koletzki	None
1900  2100 TBA	None
2100  2300 Animal Trainer	None
2100  2300 Nina Kraviz	None
2200  0030 Max Nero	None
22h00  00h30 Mia Kaltes	None
22h0000h00 Pandallougi	None
22h0001h00 Felipe Acevedo	None
2300  0000 David August	None
2300  0000 Kollektiv Turmstrasse	None
2Dirty	house music
ALON LEVI	None
ANDERSEN	None
Alci	salsa
Alek Sys	None
Amilcare	classical
Andri	house music
Animal Trainer	house music
BE	rock
BOUNCER aka Marcosis	None
Bang Goes	None
Barnt	house music
Baschgi Schuub	None
Beats On Demand	None
Beckers	None
Beda	rap
Benja	None
Bruno Pronsato	None
CH	None
Charles Tone	dub
Chaton	None
Chris Ahn	techno
Chris Air	None
Chris Bailey	None
Chris Bailey Ultimate Groove	None
Chris Bailey all night long	None
Chris Bailley	None
Chris Hoever	None
Clem	nu age
Click Click kassette records BERLIN	None
Cosmic  Bern	None
Craig Richards	house music
Crowdpleaser	techno
D Cosmo	None
DAVID FRAKA	None
DAndy & J Rony	rap
DEJAN	None
DJ Lynn Jordan	None
DJ Sixxxx	techno
DJ ZEST	None
DJs	new jack swing
DMT Synth	None
DVW	disco
DZANIN	None
Dadive	None
Dalibox	disco
Dalibox & Sandro Falletta	rap
Dandy & Trony	rap
Daniel DB	disco
Dave Dalux	None
David Armada	rap
DekaDance	None
Diego Hostettler	techno
Diego Indigo	None
Dj Soulgear	None
Dj Zest	None
Djebali	techno
Dominik Auderset	house music
Don Ramon	argentine reggae
Don Tetris	None
Donato Capozzi	techno
Doppel Dipp	None
Dualism	progressive psytrance
Duff	pop
Dänemark	None
EMETERIA	None
EMOK	progressive psytrance
EMRE	turkish
Echoes	environmental
Electribe	None
Emmat	techno
Ezikiel	techno
FRANK BECKERS	None
FREITAG & FREINACHT	None
Fabien	None
Fine selection of tartineurs	None
Floriano Albertini	None
FranG and Bee Lincoln	None
Francesco Ballato	None
Franco Bianco	techno
Freiberg	None
Freshmint	None
Friedas Büxe	None
GE	praise
GL Everest	None
GLITTER	rap
Gelivan	downtempo
Gelivan & Yan Sebastian	rap
Gepe Tuzzo	None
Germany	pop
Girl	mashup
Gleichschritt esance  grundton ZURICH	None
Gregore Konstantine	house music
Guti	disco
Herr Müller	None
Herzschwester	techno
Hive Audio	None
Hive Audio showcase with	None
INSTINCT	hardcore
ITee	None
Iori Wakasa	techno
Italy	None
JOHN CATALANO	None
Jean Meyer	None
Julian Jeweil	techno
Jutzi	None
KaraMaehl	None
Kenjiro Ultramagnetic	None
Kev the Head	None
Khainz	progressive psytrance
Kid Silly	None
Kinky Beats	None
LA BAAZ	progressive psytrance
LARA feat Babag&Cholon	None
LIVE	world worship
Labaaz	techno
Laurent Charbon Hummingbird  Lausanne	None
Lausanne	None
Le Petit Lutin	None
LeLe	None
Lee Burridge	house music
Live	world worship
LoMidHigh	None
Los Cruzeiros	rap
Lovebirds	disco
MANON	techno
MAPUSA MAPUSA	None
MAY KAY pincode  minimalmood BELLINZONA	None
MIK MAROO kumquat ZURICH	None
Maceo Plex	house music
Magic Mixers	None
Manon	techno
Marc DArrigo	house music
Marco Repetto	None
Margaret Dygas	dub
Martin Huergo	techno
Mary Jane	funk
Mat Kay	None
Mathew Jonson	techno
Membrane	covertrance
Mercury	rock
Metanoize	None
Miguel Campbell	disco
Mike & Nika	None
Mirk Oh	None
Miss Peel	None
Mokic	None
Monkey Safari	house music
Moosfiebr	techno
Motel Campo	None
Mr Pablo & guests	None
MrLucky	house music
NOIA Italy	None
Nahoma	None
Nastia	None
Neil Landstrumm vs Bill Youngman	None
Nemo	progressive
Nik	rock
Nora Bora	None
Nuuktal Rec CH	None
P Bell	None
PERFECT STRANGER Live	None
Parra Soundsystem	None
Pat Patrisha	None
Paul Chambers	jazz
Pepperpot	techno
Perfect Stranger	progressive psytrance
Peter D	techno
Pfrequency	None
Piatto	techno
Playlove	techno
Premiesku	house music
Rainer Desolat  Barcelone	None
Reto Ardour	techno
Ricardo Villalobos	techno
Robert James	disco
Rock Artisti	None
Ryan Hawkin	techno
SANKT	dark jazz
SBiene	None
Salidamusic	None
Sandro Falletta	techno
Schaermoments	None
Scody live	None
Sevenstyler	rap
Simian Keiser	None
Sins	None
Slapdance & Sandy Pants	None
Soleyu	None
Sonja Moonear	None
Space Rangerz	None
StatedLife	None
Stereoclip	house music
Stil vor Talent	None
Styro 2000	None
Sven Väth	techno
TBA	techno
THOMAS WOOD	None
TOILET ACOUSTIC	None
TSBIN aka TSN and SBI	None
Technik	None
The Cruzaders	rap
The Proxy	None
The Siegfrieds & Toys	None
Tini B	None
TonyP	None
Tuncay Celik	rap
Uhuruku	None
VD	None
Villa Bosso	hip hop
VisionE	None
Yan Ka	None
Yuli	None
ZH	None
ZerO	downtempo
Zest halfhours	None
Zodiak	None
aka Seb & GaLaBar	None
and Guest	None
berneoptimistallstarz	None
daniele zaccone	None
danielson & norbertto	None
deep bros	None
dj Zest	None
dj lynn jordan	None
djs Biodan	None
djs tiniberneoptimist	None
duble	rock
elex morano & sandro s	None
girl	mashup
ladybruce und monair	None
marco k	None
minitek	None
pasci	None
reverse	rap
soleyu	None
tanzsubstanz	None
techno machine	None
thomonn	None
tom tek	None
wwwmyspacecomdjmanon	None
wwwmyspacecomdjs2dirty	None
wwwmyspacecomibogaemok	None
wwwmyspacecommapusamapusa	None
wwwmyspacecommoosfiebr	None
wwwmyspacecompiatto	None
